Version 1/151216 of Roiling Random Text by Andrew Schultz begins here.

[
anc.py checks anagrams.
pch.pl checks punctuation.
]

volume megachatter table

table of megachatter [tmc] [these are general rules that must take precedence]
mytab	eturn	curidx	maxidx	go-ahead	whichreg	descr	prefix	suffix	lasties	maxbeforepause	done-once	init-order	table-size	reps
table of empty command rejects	false	0	20	you-said-nothing rule	Meta Team	"Responses to an empty command"	--	""	"Go for it or I GTFO! (this is the last blank response and an empty threat to boot.)"	--	false	0	0	1
table of undo rejects	false	0	30	undo-rej rule	Meta Team	"Undo rejects"	--	""	"'Do-over overdo.'"
table of undo allows	false	0	30	undo-ok rule	Meta Team	"Successful undo responses"	--	""	"'Do? Er, re-do.' (Last one. Stale? NO.)"
table of noage	false	0	20	am-noing rule	Meta Team	"Rejects for saying no"	--	""	"You're so down, yow. Sour. DONE."
table of yessage	false	0	20	am-yessing rule	Meta Team	"Rejects for saying yes"	--	""	"A rote ego too eager!"
table of singing rejects	false	0	20	is-singing rule	Meta Team	"Rejects for singing"	--	""	"Sing-ings! Sing-ings!"
table of wait responses	false	0	20	you-waited rule	Meta Team	"Wait/Z messages"	--	""	"A gag? La, la. A lag gala.[no line break]"
table of cussing rejects	false	0	20	you-cussed rule	Meta Team	"How the game blocks profanity, mild or obscene"	--	""	"Screed on, [bracket]CENSORED[close bracket].[no line break]"
table of nonviolence messages	false	0	20	you-attacked rule	Meta Team	"How the game blocks ATTACK"	--	""	"Ill touch? Chill out till...ouch!"
table of death messages	false	0	0	bzzt rule	Meta Team	"Death notices"	--	""

table of megachatter (continued) [this is organized by region then by alphabet, well, roughly]
mytab	eturn	curidx	maxidx	go-ahead	whichreg	descr	prefix	suffix	lasties	maxbeforepause	done-once	init-order	table-size	reps
table of random books	false	0	30	read-books rule	Ordeal Reload	"All the books in your bookshelf"	"[i]"	"[r]"	"your own aborted autobiography. You're embarrassed by what's there and how little is there. It was buried at the back.[paragraph break]Whew, that's everything. The only thing less exciting than re-reading all the titles would be to stare at a computer screen for a few hours."	--	--	--	--	1 [p]
table of ad slogans	true	0	30	blurby rule	Ordeal Reload	"All the ads in the Dope Op-Ed"	--	""	"HANKER! HARKEN! And with that general ad, it's back to the start."
table of mob chants	false	0	30	mob-chanting rule	Ordeal Reload	"Mob chants (LISTEN post-Gunter in manor)"	"[one of]Shouty youths. Long-[a-word] slogans. [or]Bam-o! A mob! [stopping]"	"[pre-lb]"	"'Accursed cue-cards!' you hear. They're silent a bit, probably getting ready to re-start."
table of idiotic babbler points	true	0	15	babbler-point rule	stores	"Cruelest Lectures advice[if tokers are off-stage or nestor is off-stage] (STORE N/STORE K mini-puzzle)[else if Cruelest Lectures is unvisited] (way high highway in Strip of Profits)[end if]"	"The blabber babbler "	" [ted-die]"	"The blabber babbler flips back to the start of [his-her] keystone keynotes, resuming [his-her] ol['] mongo monolog.[pre-brk]"	20
table of overdone movies	true	0	15	name-movie rule	stores	"Cruelest Lectures movies[if tokers are off-stage or nestor is off-stage] (STORE N/STORE K mini-puzzle)[else if Cruelest Lectures is unvisited] (way high highway in Strip of Profits)[end if]"	"The blabber babbler "	""	"The blabber babbler reminds the crowd [i]Dosing Doings[r] remains the universal classic.[pre-brk]"	20
table of sicko movies	false	0	50	movie-over-ad rule	stores	"Store C videos (parental advisory)"	"You peruse the movies: "	""	--	--	false	0	0	5
table of store c competitors	false	0	10	compet-over-ad rule	stores	"Store C competitors"	"You're promised better prices and service than "	"."	"Finally, there's a put-down of Twisted Twit Ed's."
table of store c ads	false	0	10	read-c rule	stores	"Store C advertisements (parental advisory)"	--	""	"'Wanker? Ew, rank!' someone hisses at you. Yup, you've been reading a while."
table of tokers nonsense	true	0	30	ohai-tokers rule	stores	"The tokers['] chat[if tokers are off-stage and nestor is off-stage] (flip STORE K and STORE N in Strip of Profits)[end if]"	--	""	"'No weed? We done!' but they find some more, ready to repeat. You may wish to HUSH them to zone them out as they zone out.[pre-brk]"
table of moralizers	false	0	30	read-pious-1 rule	routes	"Moralizers[c-c-u]"	--	""	--
table of mantle laments	false	0	30	read-pious-2 rule	routes	"Rev. Ali's hot takes[c-c-u]"	--	"[randexc]"	"wait, no, an epilogue hand-written in: [i]sad, rash [if censor-minor is true](mean name)[else]hardass[end if][r], which is refreshing." [p]
table of horbert musings	true	0	30	horby rule	routes	"Brother Horbert's musings[c-c-u]"	"Brother Horbert mumbles something to himself... [i]"	"[r]"	"Brother Horbert mumbles [i]Ah, even heaven...[r] A pause. His thoughts may loop again--like people's wanderings in the mesa.[pre-brk]"	40
table of horbert farewells	false	0	20	horb-bye rule	routes	"Brother Horbert's blessings[c-c-u]"	"Brother Horbert speaks as you leave: [i]"	"[r][pre-brk]"	"Brother Horbert's face shows neat, epic patience as you leave, again.[pre-brk]"	40
table of missing deli foods	false	0	20	ask-deli rule	routes	"Non-foods at the Idle Deli[indic of routes]"	--	""	"'Not even spoiled old pies...'"
table of sked items	false	0	20	read-tec rule	troves	"Desk-Sked to-dos[indic of troves]"	--	""	"Wow! That's a lot to do. You need to sit and think and build up to believing you can do it all. And quickly."
table of DIVORCES articles	false	0	30	read-divorces rule	troves	"'Fascinating' DIVORCES articles[indic of troves]"	--	""	"an interview with an influential mayor who knows what's what: Ah, Mr. Harm![paragraph break]Well, they saved the worst for last. You could reread if you want." [p]
table of iffy advice	false	0	20	read-eths rule	troves	"Advice from Pa, Egg, Pea[pep-clue]"	"[one of]There is some blurb about how REAL CHANGE COMES FROM WITHIN and how you shouldn't look to change a clover into Velcro or any such nonsense. Also how this book is better than [i][twiddle of table of self-help bestsellers and 3][r][paragraph break][or][stopping]You pore over a random 'thought-improving' passage of Peg A. Page: "	""	"You've reached the end, filled with [crap]piest tips recap. Rereading may or may not be less painful the second time through."
table of gritty dialogue	true	0	20	say-gritty rule	troves	"Gritty Spoiloplis dialogue[indic of troves]"	"Gritty sounds come, then go, from [one of]your testers, the tersest[or]the[stopping] streets: "	""	"Tense silence replaces the gritty sounds, which will probably return and cycle. People making the same mistakes they did before. But you are bound for better things--or, with that book, you'd better be.[pre-brk]"
table of non-skeds	false	0	20	desk-look rule	troves	"Cark Rack alternatives[if Upscale Capsule is unvisited] (Troves)[end if]"	--	"Slick-Tech Checklist, which is rapidly catching up"
table of posh dialogue	true	0	20	say-posh rule	troves	"Posh Spoiloplis dialogue[indic of troves]"	"Upper-class concerns: "	""	"A low, snide 'Old is new, wild ones.' Cue repetition.[pre-brk]"
table of posse bosses	false	0	20	in-lot-or-ruin rule	troves	"Bustle Sublet bad guys[indic of troves]"	"maybe "	""	"not Mean Roy Maroney, anymore--he's the last of them" [p]
table of prestigious bums	false	0	20	read-deal rule	troves	"'Inspirational' Yorpwaldians in [i]DEAL[r][indic of troves]"	--	""	"Aliver Elvira, in case anyone forgot" [p]
table of real estate ads	false	0	20	read-see-dir rule	troves	"See Dir locations[indic of troves]"	"It's got a sample of places Si Reed recommends. One page header blares [i]Home's so Meh? "	"[r]"	"Secretcester! OWN NOW! Well, that's the last and loudest listing."
table of Leo-Rand chitchat	true	0	15	chitchat-over-idols rule	presto	"Leo and Rand's chatter[if rand is fightin] (STORE P)[end if]"	--	""	"'Heya.' / 'Yeah?' An awkward silence follows.[paragraph break]They've run out of conversation, but fortunately (for them,) they forgot it all, so they can just restart."
table of Leo-Rand idols	true	0	15	Leo-Rand-cry rule	presto	"Leo and Rand's idols[if rand is fightin] (STORE P)[end if]"	"[one of]Leo and Rand[or]Rand and Leo[at random] sadly admit they're no "	"."
table of catechism pages	false	0	10	catechism-over-research rule	presto	"Hacks['] shack catechism entries[indic of presto]"	--	""	"After the final 'Ok, worn? Work on or know,' only a nixed-pap Appendix is left. You could flip through for more research topics or brainy types, but you've done enough. I appoint you a rarest raster starer. Have an, er, star."
table of research topics	false	0	10	research-over-doctors rule	presto	"[one of]Some[or]More[stopping] explanation of research by Arch Rees:[indic of presto]"	"Arch Rees[one of][or] further[stopping] explaining research on "	"."
table of smartypants	false	0	10	read-docs rule	presto	"Ph. D. researchers"	"The highly technical yet useful research of "	"." [p]
table of bedding brands	false	0	20	read-futon rule	presto	"Sleep aide brands"	--	""	"Smartest Mattress, hopefully cleaner than the one you remember from The Ol['] Hotel in the Metros behind Store M."
table of bar dialogue	true	0	15	bar-over-comp rule	oyster	"Posh Hops Shop action[indic of oyster]"	"[one of]Whew. Rough talk and action here. [or]More rough talk and action. [or][stopping]" 	""	"You've seen it all. Time to take decisive action(s) of your own.[pre-brk]"
table of competing bars	true	0	15	in-bar rule	oyster	"Posh Hops Shop competitors[indic of oyster]"	"Someone says the Posh Hops Shop [one of]has nothing on[or]sure beats[at random] "	"."	"Everyone agrees Soph Pho's is a total rip-off of, well, here. You can't imagine any more bars being discussed.[pre-brk]"
table of Casper mumbles	false	0	20	casper-talk rule	oyster	"Casper's mumblings[indic of oyster]"	""	""	"'[if player is male]Rhett Weir[else]Teri Werth[end if], the writer? Eh, err...TWIT!' Casper suddenly flips back to the start of his notes. Perhaps he feels you are not good enough to hear any more of his original thoughts."
table of fish fries	true	0	15	insult-over-girls rule	oyster	"Carps/pikes trout-bullying [if Anger Range is visited]in Anger Range[else](STORE Y)[end if]"	--	""	"The bullies call him 'A soft fatso so fat.' They're out of ideas and claim it's the trout's fault for not being interesting enough. The ratters restart samer smear-reams.[pre-brk]"
table of unpopular girls	true	0	15	ohai-bullies rule	oyster	"Unpopular girls carps/pikes mention[indic of oyster]"	"The bullies insinuate the trout [one of]likes[or]isn't good enough for[cycling] "	"."	"Zina is the last, and utterly wrongest, girl they accuse the trout of liking (she's actually pretty nice, but...innuendo.) When you sink that low, you've obviously run out of ideas.[pre-brk]"
table of tuna gossip	true	0	15	gossip-over-chatter rule	oyster	"Aunt Tuna's gossip[indic of oyster]"	"Aunt Tuna gossips: "	""	"'Edda Dade. Dead. Cleo's Close. Dorithy--Thyroid. Halle's a shell. All she... Heather's Heart. She... diabetes, die, beast!' Aunt Tuna pauses, head in hands. That was the final thing she'd been repressing.[pre-brk]"
table of aunt tuna chatter	true	0	15	ohai-tuna rule	oyster	"Aunt Tuna's complaints[indic of oyster]"	"[one of]'Oh, dear! Do hear!' / 'D'oh...are...' Aunt Tuna cuts you off and[or]Aunt Tuna[stopping] "	""	"Aunt Tuna, as her nags snag, restarts her prattle platter of how she is BEYOND done-by...[pre-brk]"
table of theses	false	0	30	screed-read rule	oyster	"Theses Sheets notes[indic of oyster]"	""	""	"Life Conks Nice Folks![paragraph break]Well, that's probably enough proof you're dealing with bad guys, here."
table of rodney bluster	true	0	20	rodney-here rule	towers	"Rodney's bluster[indic of towers]"	"Rodney [if here-picaros is 7]informs his gang[else if here-picaros > 3]yells at his remaining troops[else if here-picaros is 2]yells to his remaining companion[else]mutters to himself[end if] about "	"."	"Rodney warns about repeating, then inept rage and a petering.[pre-lb]"
table of gizmo parts	false	0	20	examining-gizmo rule	towers	"Parts of the I ZOMG GIZMO[indic of towers]"	--	""	"Ulti-Util, the most powerful, confusing and hidden of all the gizmo parts" [p]
table of ideas aides squabbles	true	0	20	inclosure-talk rule	otters	"Elmer and Merle's chat"	--	""	"[e-m] blurts out 'EXACTLY!' His friend has no response. What is there to say? But they're all out of ideas, now, so they start over.[pre-lb]"
table of Elvira battle cries	false	0	20	last-battle rule	otters	"Elvira's battle cries"	--	""	""
table of Elvira machines	false	0	20	bzzt rule	otters	"Elvira's machines"	--	""	""
table of Elvira taunts	false	0	20	Elvira-taunt rule	otters	"Elvira's taunts"	--	""	"'Stellar staller!' Dang, the simplest ones hurt the most.[pre-lb]"
table of animal friends	false	0	60	bzzt rule	otters	"Your animal friends"	--	""
table of political slogans	false	0	20	sloganing rule	others	"Political slogans"	--	""
table of selly yells	false	0	30	clearing-listen rule	others	"Selly Yells[indic of others]"	""	""	"A big errant inert brag pauses the bartering for a minute."
table of help companies	false	0	30	bzzt rule	Meta Team	"Hint guy t-shirt writing[if have-objhinted is false] (occurs first time you request hints)[end if]"	--	""
table of elmo emo	false	0	30	bzzt rule	Ordeal Reload	"Elmo's romantic complaints[if girls-quip is not mowered] (off-topic Elmo chat)[end if]"	""	""
table of sports chatter	false	0	30	bzzt rule	Ordeal Reload	"Elmo's sports banter[if sports-quip is not mowered] (off-topic Elmo chat)[end if]"	""	""
table of biopics	false	0	30	bzzt rule	Ordeal Reload	"Biopics, good and bad[if media-quip-2 is not mowered] (off-topic Elmo chat)[end if]"	""	""
table of bad rappers	false	0	60	bzzt rule	Ordeal Reload	"Bad rap music[elv-art]"	--	""
table of lame computer games	false	0	30	bzzt rule	Ordeal Reload	"Computer games[elv-art]"	--	""
table of comedians	false	0	30	bzzt rule	Ordeal Reload	"Comedians of Yorpwald[elv-art]"	""	""
table of laughhouses	false	0	30	bzzt rule	Ordeal Reload	"Comedy joints[unless pun-quip is mowered] (with Gunter, lighten the mood with a joke)[end if]"	""	""
table of lame talk shows	false	0	30	bzzt rule	Ordeal Reload	"Bad talk shows[unless media-quip-2 is mowered] (complain about the media some more to Elmo)[end if]"	--	""
table of lame movies	false	0	30	bzzt rule	Ordeal Reload	"Bad movies[elv-art]"	""	""
table of lame tv shows	false	0	30	bzzt rule	Ordeal Reload	"Bad TV shows[elv-art]"	""	""
table of oldies singers	false	0	30	bzzt rule	Ordeal Reload	"Initial oldies singers[elv-art]"	""	""
table of lousy hit songs	false	0	30	bzzt rule	Ordeal Reload	"Bad songs[elv-art]"	--	""
table of self-help bestsellers	false	0	30	bzzt rule	troves	"Self-help bestsellers[pep-clue]"	--	""
table of songs you could write	false	0	30	bzzt rule	troves	"Songs you write on solving Troves"	--	""
table of sleep rejects	false	0	30	am-sleeping rule	Meta Team	"Sleeping rejects"	--	"[pre-lb]"
[tmc]

volume megachatter rules and stubs

part random tables

when play begins (this is the table scramble and index rule) :
	let mycount be 0;
	repeat through table of megachatter:
		now done-once entry is false;
		if there is a mytab entry:
			sort mytab entry in random order;
		unless there is a reps entry:
			now reps entry is 1;
		if there is no curidx entry:
			now curidx entry is 0;
		if there is no maxidx entry or maxidx entry is 0:
			if there is a mytab entry: [just see if the maxidx entry can and should be cut down]
				if there is a maxidx entry and maxidx entry < number of rows in mytab entry:
					do nothing;
				else:
					now maxidx entry is number of rows in mytab entry;
		if there is no maxbeforepause entry:
			now maxbeforepause entry is 40;
		increment mycount;
		now init-order entry is mycount;
		if there is a mytab entry:
			now table-size entry is number of rows in mytab entry;
	prio-sort table of random books: [this puts certain books in front, which may give various clues. It was probably more a thought experiment than anything.]

to prio-sort (ta - table name):
	let temp be 0;
	repeat through ta:
		if there is a prio entry:
			now prio entry is a random number from 1 to prio entry;
		else:
			increment temp;
			now prio entry is temp;
	sort ta in prio order;

chat-rand is a truth state that varies.

every turn (this is the process random dialogue rule) :
	if current action is hinting, do nothing instead;
	if current action is fliptoing, do nothing instead;
	now chat-rand is true;
	process the find-blather rule;
	now chat-rand is false;

ever-hit-last is a truth state that varies. just-hit-last is a truth state that varies.

every turn when ever-hit-last is false (this is the check for loop and warn rule):
	if just-hit-last is true:
		ital-say "you have reached your first end of random text. If you wish to see all the random text, there will be a menu once you win the game. Or you can look in the source that should come with the game.";
		now ever-hit-last is true;

[find-blather is what is used for random dialogue. It relies on the table of megachatter.]

this is the find-blather rule:
	let zz be 0;
	repeat through table of megachatter:
		if eturn entry is chat-rand:
			if there is a go-ahead entry:
				process the go-ahead entry;
				if the rule succeeded:
					if chat-rand is true and talk-quiet is true and done-once entry is true, the rule succeeds;
					if showtabname is true:
						say "([mytab entry])";
					now done-once entry is true;
					increment curidx entry;
					if curidx entry > maxidx entry:
						if there is a lasties entry:
							say "[lasties entry]"; [I maybe should put a paragraph break here but I think it disrupts one of the randoms, so that's no good. It'd be a better solution than pre-brk if it worked...but it's so dicey. Things work as they are.]
							now curidx entry is 0;
							now just-hit-last is true;
							the rule succeeds;
						else:
							say "You feel a sense of deja vu.[paragraph break]";
							now curidx entry is 1;
					if there is a prefix entry:
						say "[prefix entry]";
					let whrow be curidx entry;
					if there is no suffix entry:
						d "WARNING NEED SUFFIX ENTRY FOR [mytab entry]";
					let posties be suffix entry;
					if showtabname is true:
						say "([mytab entry])";
					choose row whrow in mytab entry;
					say "[blurb entry][posties][line break]";
					if chat-rand is true:
						if talk-quiet is true:
							say "[line break]";
							ital-say "the above was random dialogue that won't be repeated since you have HUSH on. You can undo this with UHHS.";
						if quiet-warn is false:
							ital-say "the above was random dialogue that can be turned off with HUSH or on with UHHS. If you forget this, it's in your notepad. Also, if you want all the dialogue, no need to hit Z a ton. You can read the source or, to see it formatted a bit better, solve the game.";
							pad-rec-q "random dialogue";
							now quiet-warn is true;
					the rule succeeds;

[randbla is used for stuff you examine.]

wrap-note is a truth state that varies.

wrap-note-ver is a truth state that varies.

showtabname is a truth state that varies.

to say randbla:
	say "[run paragraph on]";
	let booknote be false;
	let adnote be false;
	repeat through table of megachatter:
		if eturn entry is chat-rand:
			if there is a go-ahead entry:
				process the go-ahead entry;
				if the rule succeeded:
					if showtabname is true:
						say "([mytab entry])";
					increment curidx entry;
					if curidx entry > maxidx entry:
						if there is a lasties entry:
							say "[lasties entry]";
							now curidx entry is 0;
							the rule succeeds;
						else:
							[say "(generic note that random text is cycling)[paragraph break]";]
							now curidx entry is 1;
					if there is a prefix entry:
						say "[prefix entry]";
					let whrow be curidx entry;
					let posties be suffix entry;
					if mytab entry is table of random books:
						now booknote is true;
					if mytab entry is table of ad slogans:
						now adnote is true;
					if reps entry is 1 or reps entry is 0:
						choose row whrow in mytab entry;
						say "[blurb entry][posties]";
					else:
						let repnum be maxidx entry - curidx entry + 1;
						if repnum > reps entry:
							now repnum is reps entry;
							increase curidx entry by repnum - 1; [this is sloppy code but I can't think of another way to take care of this special case]
						else:
							now curidx entry is 0;
						[d "[curidx entry] vs [maxidx entry]. Repnum is [repnum].";]
						let thistab be mytab entry;
						increase curidx entry by repnum; [afterwards gets runtime error as inform thinks it's the new table]
						repeat with county running from 1 to repnum:
							choose row whrow in thistab;
							say "[blurb entry] ";
							increment whrow;
					if wrap-note is false and whrow > 5: [this is a magic number, to see if the person is really examining something.]
						now wrap-note is true;
					the rule succeeds;

every turn when wrap-note is true and wrap-note-ver is false (this is the alert you don't have to gawk rule) :
	ital-say "you've been repeating looking up something with random text a lot--something with at least ten entries and possibly much more. If you solve the game, you can see it all. Thanks for your (apparent) interest! Oh, you can browse the source code for a chunk of text, too, and it shouldn't spoil the game, since it's all in a table. Just remember single apostrophes have a bracket on each side.";
	now wrap-note-ver is true;

to say c-c-u: say " [if Cleric Circle is visited]in the Cleric Circle[else](Routes)[end if]";

to say indic of (reg - a region):
	if last-loc of reg is unvisited:
		say " ([reg])"

die-trigger is a number that varies.
die-to-us is a truth state that varies.

to say ted-die:
	if die-trigger > 0:
		decrement die-trigger;
		say "[if die-trigger is 0]'Die to us!' the blabber babbler yells, pointing at someone who may or may not be using drugs right now. 'To use...I'd...' the poor soul mumbles on being slapped up and carted off. You see red at what must be either harsh injustice or appalling acting[else]Man, it's all so [i]tedious[r][end if].";
	else if a random chance of 1 in 4 succeeds:
		say "After that ... incident, everything is back to [i]tedious[r].";
	else:
		say "[line break]";

to say randexc:
	let re be a random number from 1 to 5;
	repeat with re2 running from 1 to re:
		say "![no line break]";
	if talk-quiet is true:
		say "[line break]";

[below for if list line breaks don't match up with what's in the game]
to say post-brk: [unused]
	if otters is solved:
		say "[paragraph break]";

to say post-lb: [unused]
	if otters is solved:
		say "[line break]";

to say pre-brk:
	unless otters is solved:
		say "[paragraph break]";

to say pre-lb:
	unless otters is solved:
		say "[line break]";

to say pep-clue: say " ([if Loather Rathole is unvisited]Troves[else if Pa Egg Pea is unexamined]examine Pa Egg Pea[end if])"

to say elv-art:
	unless dope-read is true:
		say " (read [if player is male]I Trash His Art[else]Her Arts Er Trash[end if])"

part random text rules

section GENERAL random text rules

this is the bzzt rule:
	the rule fails.

this is the am-yessing rule:
	if current action is saying yes, the rule succeeds;
	the rule fails.

this is the am-noing rule:
	if current action is saying no, the rule succeeds;
	the rule fails.

this is the is-singing rule:
	if current action is singing, the rule succeeds;
	the rule fails.

this is the you-said-nothing rule:
	if pardons is true, the rule succeeds;
	the rule fails;

this is the you-cussed rule:
	if current action is swearing obscenely, the rule succeeds;
	the rule fails;

this is the you-waited rule:
	if current action is waiting, the rule succeeds;
	the rule fails;

this is the you-attacked rule:
	if current action is attacking, the rule succeeds;
	the rule fails;

this is the am-sleeping rule:
	if current action is sleeping, the rule succeeds;
	the rule fails;

this is the undo-ok rule:
	if currently-undoing is true, the rule succeeds;
	the rule fails;

this is the undo-rej rule:
	if currently-rejecting is true, the rule succeeds;
	the rule fails;

section MANOR random text rules

this is the read-books rule:
	if current action is examining the bookshelf, the rule succeeds;
	the rule fails.

this is the pun-quip rule:
	if current quip is pun-quip, the rule succeeds;
	the rule fails.

this is the mob-chanting rule:
	if current action is listening and player is in Dusty Study and gunter is moot, the rule succeeds;
	the rule fails;

section STRIP random text rules

this is the movie-over-ad rule:
	if current action is not examining store c:
		the rule fails;
	if go-with-first of table of sicko movies and table of store c ads, the rule succeeds;
	the rule fails;

this is the compet-over-ad rule:
	if current action is not examining store c:
		the rule fails;
	if go-with-first of table of store c competitors and table of store c ads, the rule succeeds;
	the rule fails;

this is the read-c rule:
	if current action is examining store c, the rule succeeds;
	the rule fails.

this is the ohai-tokers rule:
	if player is in strip and tokers are in strip and nestor is in strip, the rule succeeds;
	the rule fails;

this is the babbler-point rule:
	if player is in cruelest:
		if go-with-first of table of idiotic babbler points and table of overdone movies, the rule succeeds;
	the rule fails;

this is the name-movie rule:
	if player is in cruelest, the rule succeeds;
	the rule fails;

section ROUTES random text rules

this is the ask-deli rule:
	if pat-whine is true, the rule succeeds;
	the rule fails;

this is the read-pious-1 rule:
	if current action is examining the lament mantle:
		if pious-state is true, the rule succeeds;
	the rule fails.

this is the read-pious-2 rule:
	if current action is examining the lament mantle:
		if pious-state is false, the rule succeeds;
	the rule fails.

this is the horby rule:
	if player is in Cleric Circle and Brother Horbert is in Cleric Circle, the rule succeeds;
	the rule fails;

this is the horb-bye rule:
	if current action is exiting in Cleric Circle, the rule succeeds;
	the rule fails;

section TROVES random text rules

this is the read-eths rule:
	if current action is examining Pa Egg Pea, the rule succeeds;
	the rule fails.

this is the say-gritty rule:
	if player is in Bustle Sublet or player is in Boarded Roadbed or player is in Loather Rathole, the rule succeeds;
	the rule fails;

this is the in-lot-or-ruin rule:
	if player is in Bustle Sublet, the rule succeeds;
	the rule fails;

this is the read-deal rule:
	if current action is examining LEAD, the rule succeeds;
	the rule fails;

this is the read-see-dir rule:
	if current action is examining See Dir, the rule succeeds;
	the rule fails;

this is the say-posh rule:
	if player is in Econ Cone or player is in Browse Bowers, the rule succeeds;
	the rule fails;

this is the read-tec rule:
	if current action is examining desk sked, the rule succeeds;
	the rule fails.

this is the desk-look rule:
	if current action is examining the cark rack, the rule succeeds;
	the rule fails;

this is the read-divorces rule:
	if current action is examining DIVORCES, the rule succeeds;
	the rule fails.

section PRESTO random text rules

this is the chitchat-over-idols rule:
	unless Rand is washed up and player is in Dirge Ridge:
		the rule fails;
	if go-with-first of table of Leo-Rand chitchat and table of Leo-Rand idols, the rule succeeds;
	the rule fails;

this is the Leo-Rand-cry rule:
	if Rand is washed up and player is in Dirge Ridge, the rule succeeds;
	the rule fails;

this is the catechism-over-research rule:
	if current action is not examining catechism:
		the rule fails;
	if go-with-first of table of catechism pages and table of research topics, the rule succeeds;
	the rule fails;

this is the research-over-doctors rule:
	if current action is not examining the catechism:
		the rule fails;
	if go-with-first of table of research topics and table of smartypants, the rule succeeds;
	the rule fails.

this is the read-docs rule:
	if current action is examining the catechism, the rule succeeds;
	the rule fails;

this is the read-futon rule:
	if current action is examining the futon, the rule succeeds;
	the rule fails;

section OYSTER random text rules

this is the in-bar rule:
	if player is in hops shop, the rule succeeds;
	the rule fails;

this is the bar-over-comp rule:
	if player is not in hops shop:
		the rule fails;
	if go-with-first of table of bar dialogue and table of competing bars, the rule succeeds;
	the rule fails;

this is the casper-talk rule:
	if casper-mumble is true, the rule succeeds;
	the rule fails;

this is the ohai-bullies rule:
	if carps are in Anger Range and player is in Anger Range, the rule succeeds;
	the rule fails;

this is the insult-over-girls rule:
	if player is not in Anger Range or pikes are not in Anger Range:
		the rule fails;
	if go-with-first of table of fish fries and table of unpopular girls, the rule succeeds;
	the rule fails;

this is the ohai-tuna rule:
	if player is in Lean Lane, the rule succeeds;
	the rule fails;

this is the gossip-over-chatter rule:
	if location of player is not Lean Lane:
		the rule fails;
	if go-with-first of table of tuna gossip and table of aunt tuna chatter, the rule succeeds;
	the rule fails;

this is the screed-read rule:
	if current action is examining the theses sheets, the rule succeeds;
	the rule fails.

section TOWERS random text rules

this is the rodney-here rule:
	if player is in Loftier Trefoil and rodney is in Loftier Trefoil, the rule succeeds;
	the rule fails;

this is the examining-gizmo rule:
	if current action is examining the gizmo, the rule succeeds;
	the rule fails;

section OTTERS random text rules

this is the last-battle rule:
	if current action is playing whistle and player is in Rancho Archon Anchor, the rule succeeds;
	the rule fails.

this is the inclosure-talk rule:
	if player is in Reclusion Inclosure and Merle is in Reclusion Inclosure:
		if holy nest is moot, the rule succeeds;
	the rule fails;

this is the Elvira-taunt rule:
	if player is in Rancho Archon Anchor:
		if current action is going east or current action is gotoing:
			if qbc_litany is not table of Elvira comments, the rule succeeds;
	the rule fails;

section OTHERS random text rules

this is the sloganing rule:
	if player is in Gates Stage and current action is going north, the rule succeeds;
	the rule fails;

this is the clearing-listen rule:
	if player is in Clangier Clearing and current action is listening, the rule succeeds;
	the rule fails.

section deciding how to weight rules

[this is the random rule to decide which of 2 tables we choose if, say, examining the catechism]

weighted is a truth state that varies. weighted is usually false.

to decide whether go-with-first of (t1 - a table name) and (t2 - a table name):
	choose row with mytab of t1 in table of megachatter;
	let n1 be curidx entry;
	let n2 be maxidx entry;
	choose row with mytab of t2 in table of megachatter;
	let m1 be curidx entry;
	let m2 be maxidx entry;
	if weighted is false:
		now n2 is 1;
		now m2 is 1;
	if n1 is 0 or n1 is 1:
		if m1 > 1: [this is not perfect but basically the larger tables come first]
			decide no; [this lets the 2nd bit cycle]
	d "[t1] vs [t2] is [n1] vs [m1] and [n1] * [m2] = [n1 * m2] vs [m1] * [n2] = [n2 * m1]. Also n1=[n1] vs m1=[m1].";
	if n1 * m2 <= n2 * m1:
		decide yes;
	decide no;

this is the blurby rule:
	the rule fails;

[end of rules to parse through]

chapter text twiddling

[this is the code that gives the player the option to scroll through more randoms. Sometimes X.G.G is not feasible, e.g. at the end of Troves.]

twiddle-warn is a truth state that varies.

to say twiddle of (tn - a table name) and (nums - a number):
	if showtabname is true:
		say "([tn])";
	if nums is 1: [this simply forces one name out]
		choose row with mytab of tn in table of megachatter;
		increment curidx entry;
		if curidx entry > maxidx entry:
			now curidx entry is 1;
		let wh-row be curidx entry;
		choose row wh-row in mytab entry;
		say "[blurb entry]";
		continue the action;
	let tr be maxidx corresponding to mytab of tn in table of megachatter;
	let cholet be 0;
	let currow be curidx corresponding to mytab of tn in table of megachatter;
	let thisgrp be nums;
	let ors be false;
	if thisgrp < 0:
		now thisgrp is 0 - thisgrp;
		now ors is true;
	let skip-past be false;
	let curcount be 0;
	if currow > tr:
		say "(a bunch of stuff already read)[line break]";
		continue the action;
	while skip-past is false:
		if thisgrp >= tr - currow:
			now thisgrp is tr - currow;
			now skip-past is true;
		repeat with counter running from 1 to thisgrp:
			increment currow;
			choose row currow in tn;
			if counter is thisgrp and counter > 1:
				say " [if ors is true]or[else]and[end if] ";
			else if counter > 1:
				say ", ";
			say "[blurb entry]";
		if currow < tr and debug-state is false:
			say "... [i][bracket]M for more examples, any other key to move on[close bracket][r]";
			let cholet be the chosen letter;
			if cholet is not 77 and cholet is not 109:
				now skip-past is true;
			say "[line break]";
			increment curcount;
			if curcount is 5 and twiddle-warn is false and skip-past is false:
				now twiddle-warn is true;
				ital-txt "you can see all this at the end, so no need to page through all [tr] entries.";
		else:
			if debug-state is false:
				say " [bracket]That's all![close bracket][line break]";
			now skip-past is true;
	choose row with mytab of tn in table of megachatter; [reset to what's after]
	if currow is tr:
		now currow is 0;
	now curidx entry is currow;

volume random text blurb tables [vrt]

[Note that brackets or (p) mean to let automated checkers to pass on this. Empty brackets = anagram done before, but not duplicated. P = avoid automated punctuation check fail. Eh, what's another 300 bytes if I already got 2mil+?]

book general

table of cussing rejects [xxg1]
blurb
"[if player is male]Mr. Taunt-Tantrum[else]Mrs. Taunt-Tantrums[end if]!"
"A-ah! Not an oath!"
"Absolutely lousy bleat!"
"Ach, a venal avalanche!"
"Ach, yelp cheaply? Yech, pal."
"Acoustics so caustic!"
"Acrimony! I moan, cry!"
"Ah, do the hothead!"
"Ah, rote oather, to hear or hate!" []
"Annoyance? Anyone can..."
"Another hater? No!"
"Arise, thy hysteria! Yeah, stir!"
"Attain-scorn transaction?"
"Aversion varies on, so, vainer."
"Bah, ye [t-w]. Be that way!"
"Base ur-abuser!"
"Be caring. Gab nicer!"
"Be upset? Eep! Bust!"
"Bedlam apex: bad example."
"Beefin['], my? Fine by me!"
"Bemoan? No, beam!"
"Big cheap gibe, chap!"
"Big yap...by a PIG!"
"Bile, fry briefly!"
"Bile? Tip: bite lip!"
"Blustery? Try blues!"
"Bray out, you brat!"
"Bud...seem bemused!"
"Cancerate reactance!"
"Cheap-shot ethos, chap."
"Cheapo? Ah, cope."
"Cite qualm? Quiet calm."
"Cold Fury? Cur, do fly!"
"Cold, raw old craw!"
"Crazy rude? Dreary, cuz."
"A crude rue, cad!"
"Crude's Cursed."
"A cry: racy."
"Curses? Cusser."
"Dang Sour Dour Nags!"
"Defrost, frets! Do!"
"The dins! End this!"
"Dish a dis? Ah!"
"Do thwart that word."
"Don't swear. Neat words!"
"Dourness resounds!"
"Dung-Dip Pudding!"
"Eeg! Gee!"
"Egregious! Ire gouges!"
"Eh, spout a hate-opus? Phase out!"
"Er, exact excreta."
"Er, so sore?" []
"[']Ere's venom! Some nerve!"
"Err, tact? Retract!"
"Errant ranter!"
"Ew! Foul! Woeful!"
"Ew! I opt to wipe."
"Feistier! Fieriest!"
"Ferocity to fry ice!"
"Fit-laden, inflated!"
"Flame up! Fume, pal!"
"Flow, dour foul word!"
"A flow out, too awful."
"Foul words. Dour flows."
"Fractious fiasco? Rut!"
"Frenzied? Fried? Zen!"
"Froth forth!"
"A furor's far sour!"
"Gah! Agh!"
"Gah, write with rage!"
"Go share rages, oh!"
"Goin['] red? Ignored!"
"Gosh! Into hootings?"
"Groan is Soaring!"
"Grow nervy? Very wrong!"
"A grumble? Lame grub."
"Hearin['] hernia!"
"Heavily Vile, Yah!"
"Hi, curse? Uh, cries? Such ire!"
"Hm, sour humors?"
"Hot bile! The boil!"
"A hot oath!"
"Hot rage? Oh, great. Go, hater!"
"Hot words? D'oh, worst! Worth sod."
"Howdy, user! Why so rude?"
"I bleat at bile!"
"I can opt to panic!"
"I cuss. [']Scusi!"
"I drone on, dire." []
"I hear ire. Ah!"
"I paste a spite."
"I Speak: a Spike!"
"I spy yips!"
"I veto each hate voice."
"I'm good at a moot dig!"
"I'm great at grime!"
"If sense, finesse!"
"Ilth-fay: thy fail."
"Immature? Irate? Mum."
"Impiety-yip time."
"Inst-snit?!"
"Intend woe? I [b]WON'T[r] need..."
"The ire! I...there."
"Ire's lousy. Seriously." []
"Ireful bits. Filibuster?"
"Irrupted putrider? Ripe turd."
"Let's moan: so mental? No, lamest."
"Lewd din, dwindle!"
"Lo, bawdy! Way bold!"
"Loathing tha lingo."
"Loathsome! So hot? LAME!"
"Lost? Yep, to Yelps!"
"Loud sin? Un-solid!"
"A loud type? Played out." []
"Mad-spew swamped!"
"Main user is MANURE!"
"Maledict-climated?"
"Mean bilge? Being lame."
"Mean spurt? Smarten up."
"Melt down? Mewl? Don't!" []
"Mo['] crude? Decorum!"
"Mo['] sweary? Ow, my ears!"
"Moany, man? Oy!"
"More-than-harm tone!" []
"Much ado! Ouch! Mad!"
"My dear! Yer mad!"
"'My TAILS, I'm salty!'" [p]
"Nag ruder? Darn urge."
"Nasty, kid. Stay kind."
"Near fog of anger?"
"Next move, vex me not."
"No arts? So, rant: a snort."
"Nose-virus souvenirs!"
"Not now! Edit! Tone it down!"
"Not playing poignantly."
"Notes: crud, don't curse!"
"O, brash abhors!"
"O, pity to yip!"
"O, sip on poison!"
"O, Spiter Riposte!"
"O, yammer more! May mar [']em, yo!"
"Oafy of ya!"
"Obtrusive vibe-roust."
"Oft lame to flame."
"Oh, got in hooting!"
"Oh, tart throat!"
"One retch, coherent not-cheer!"
"One snit. Tension."
"One's ire? No Siree!"
"Ooh, galled? Hella good."
"Oral grime. Rigmarole."
"Out of line, lout? Fie! No!"
"Oy, brash brays! Oh!"
"Oy, curt outcry!"
"Oy, flatus so faulty!"
"Oy! Nut! Rogue! Your tongue!"
"Oy, slurs so surly! Sly! Sour!"
"Oy, words so rowdy."
"A panic, gee? Gain peace!"
"Poop? OPPO!"
"Pout? Eek! Keep out!"
"Profanities? No aperitifs, pristine oaf!"
"Profanities! Points afire! Naif riposte!" []
"Profanities? Soap: niftier." []
"Profanity: any profit?"
"Prurient, err, input."
"Pure rot, eruptor."
"Purer ears? Super rare."
"Radiate a tirade!"
"Rant? Do dart on! And rot! NOT RAD!"
"Rash hoot! Too harsh!"
"Rawness answers!"
"Relax. Swig grawlixes."
"Repulsing lingers up!"
"Resenting it? Interesting."
"Rote dis? So tired!"
"Rude blow, bud. Lower blue word blew dour."
"Rude or Dourer? Ordure!"
"Salty be beastly." []
"Salty coo? Stay cool."
"Savoring raving so?"
"Say nice? Yes, I can!"
"Say snot so nasty? Nay, toss!"
"Say tuff stuff, ya!"
"Scorned? Ire? Reconsider."
"Screed? No! CENSORED!"
"Seagulls['] sullages!"
"Searing rage-sin!"
"Serving ace grievances!"
"A short 'Oh, rats.'"
"A silly say-ill." []
"Sin-oaths astonish!"
"Sink peace? Seek panic? Speak NICE!"
"Slob, Rave So Verbal."
"Snit? Off! No tiffs to sniff."
"Snot-fever so fervent!"
"So edgy! Dog, yes!"
"So icky! Yoicks!"
"So profane, oaf-person!"
"So scary? Oy! Crass!"
"So unruly? Run! Lousy!"
"Soilure? Lousier."
"Some racy scream, oy!"
"Sour hate? Rue oaths!"
"Sow epic cow pies!" []
"Sow hard, raw-shod words? Ha."
"Spicy talk? Splat. Icky."
"Stay Clean! Act sanely!"
"A stew? Waste." []
"Such a mouth! Out, Mac, hush!"
"Such noise! Uh, cession!"
"A surly slur, ay!"
"Swearin[']? I answer: ar, swine!" []
"Tangible bleating."
"Tanginess-assenting?"
"Tedium. I'd mute."
"Temporarily orate primly."
"Temporarily roar emptily." []
"That noise's nastiest, ho!"
"Throw away a wrath, yow!"
"Throw shade? Wrath: hosed!"
"To anger! Grate on!"
"To cuss cuts so!"
"To hiss is tosh." []
"To quips? Quit, sop!"
"To rant: art? NOT!"
"To snipe? So inept!"
"Torchier Rhetoric!"
"Tore up? Pouter."
"Twinges stewing?"
"Typing fire? Petrifying!"
"Uh, screwy. Why curse?"
"Unforgivable baneful vigor!"
"Universal, naive slur."
"Unpolitic punctilio!"
"Urg! Salvo so vulgar!" []
"Utter profane often? Rapture!"
"Voila, stir, as vitriol so trivial?"
"Wearying? Ew, I: ANGRY!"
"Worthless howls, rest!"
"Wow. LORD, low word."
"Yelp mode employed!"
"Yikes! Net stink-eye!"
"Yo['] wrath's trashy. Ow!"
"Your act: Racy! Out!"
"Yuck. Ucky."

table of death messages [xxg2]
blurb
"[d-word-u]! (You MAY Undo.)"
"Aground? Arg. Undo!" []
"Ah, dim! I'm had!" []
"Ahh, dirt hit HARD!"
"Ahh, WORD. How hard!"
"Annihilated, Laid in [']Neath."
"Apt nadir: a dirt nap!"
"'Arh, died! / 'Ha, redid!'" [p]
"Arrowed? Raw! Redo!"
"Big Plans Slip. BANG!"
"Blah, fainter...final breath!"
"Blunder, Blur, END."
"Burned? O, rebound!"
"Closure So Cruel! Lo, curse!"
"Croaked? Ack! Redo!"
"Curatins, cats! Ruin!"
"Curtailed! Ultra-Iced!"
"Da Boot. Too bad."
"The Dead Add Thee!"
"Dear! Night! Death-ring!" []
"Death grip! Gah, trepid!"
"Death Net at the End!"
"Death! No! Ah, to end..." []
"Death's Hasted."
"Departed deep. Drat."
"Diagnosis: sing adios!"
"Die-End? Indeed!"
"Diverge, Grieved!"
"Done! O, End!" []
"Earth-Free, Hereafter: Ether Fare!"
"Eek! Rats! Retakes?"
"Ehh, took the hook!"
"End go! SOS, goodness!"
"End! Nuts! Stunned!"
"Endurance's Sunderance!"
"Erg! No! Goner!"
"Eternal rest enters? Alter!"
"Extinguish, uh, existing."
"Fate's Wile: Life Waste!"
"Fated One, Defeat? NO!"
"Fatigue, I, ug... FATE!"
"Fell, and It Flatlined!"
"Fie! I Fell! Life...LIFE!" []
"Fie, Solver! Life's Over!"
"Final hours rush on: FAIL!"
"Final opus! So painful!"
"Final Word: Fail, Drown, Flow...Nadir."
"Finale's Yields: Elysian Fields."
"Flatlines! Fine stall! It's fallen!"
"Game's Over? Move Sager." []
"The gap gapeth!"
"Get up? Sigh. The gig's up."
"Goodbye, Body, Ego!"
"Grayest Leap Eagerly Past Pearly Gates. Stage Replay?"
"Health-Halt, Eh?"
"Hearse Time, Me Hearties!"
"Heart, head: hear death!"
"Hola, Halo!"
"Hosed, eh, sod?"
"Hot Fade of Death!" []
"How it Ends: Not Wished."
"Hurt ... THRU!" []
"I Bolt Mo['] To Limbo!"
"I Fall. Net: Flatline."
"I nap on, no pain!"
"I redo...or DIE!"
"I... Yo, Dude, You Died."
"I'm down...now...dim!"
"I've lost to evils!"
"I...HALP! Phail!"
"Inert yet: eternity."
"Inter, or...In Retro?"
"A Jam, Guest? Just a Game."
"Jeopardy! Joy pared!"
"Last breath rattles. Bah!"
"Last Dance. Scant deal!"
"Last Word: Drat, Slow!"
"Lie off of life."
"Life's Gone: Fleeing So!"
"LOL, went not well!"
"Long Life Fill? Gone!"
"Look, I be a... KABLOOIE!"
"A Mistake Takes Aim!"
"Mm, uber-bummer!"
"Mount a World? Mortal Wound!"
"Narrow Bed. Barrow-Den."
"Nod. We end, ow."
"Now Dealt a Let-Down!"
"Nuts, I go sign out!"
"O fleeing life, gone!"
"Obitual Bail-Out."
"Offed? Deffo!"
"Oh, stigma! I'm a ghost!"
"Oh, tragedy! Gory death!"
"One Try: All? Not Really."
"One Wrong... Goner, Now!"
"Ooh, Splat. Lo, pathos!"
"Our Take: Yup, You're Kaput!"
"Pal! Use a Pulse?"
"Palings...lapsing...gasp? Nil."
"A Path Ends: Snap! Death!"
"Penalty Aplenty..."
"Perdition riptide! NO!"
"Person dies. Depression!"
"Playin['] Harps Snappily, Rah!"
"Quit in awe? Quiet! A win!"
"Repo-Man's Open Arms!"
"RIP Zone. No Prize!"
"Sad Obit: O, [']Tis Bad!"
"The Self: [if player is male]He's[else]She[end if] Left!"
"Shut-down thuds NOW!"
"Six Feet Under? Needs Fixture."
"Slim Obit: Boil-Mist. It's Limbo."
"Snuffed it. I End Stuff!"
"So futile. Life's out!"
"So, game omegas!"
"Super numb...number's up!"
"Terminated: a Detriment."
"Terminus! Must...Rein..."
"Thy Base's The Abyss!"
"Time Explodes! Motel Deep Six!"
"Time to Undo to, um, Not Die."
"To die? O, edit!"
"To flag...go flat..."
"To my bane? Maybe not."
"Top Update: TAPPED OUT!"
"Uh, slip? Bane! Punishable!"
"Um, right-ho, I'm through!"
"Undo the end, thou!"
"Undone right in the ground!"
"Unfortunate Run Unto Fate."
"Virulent, Vile Turn!" []
"Watch out! ... Uh, act two?"
"Went RIP. New trip?"
"The Win Went, Hi!"
"With Angels, Light as New!"
"Wow, Do Things with Gods Now!"
"Yo, Nix the Bag-Oxygen Habit!"
"Yon Bed Beyond!"
"You're Mortal to Your Realm."
"Your End's Round, Yes?"
"Your Fate: a Fey Rout."
"Your Slip: RIP. Lousy!"
"Your time's out. Misery!"

table of empty command rejects [xxg3]
blurb
"'[one of]On, ho[or]Ho, on[in random order]?' Oh, no!"
"'Actions? Coastin['].'"
"Ah, lots o['] halts."
"Ah, sore? Hoarse?" []
"Ai, nag again?" []
"Arid flows. Words fail." []
"Asonic? I so can!"
"At thoughts? That's tough."
"Basically asyllabic?"
"Be louder. Redouble!"
"Bland emote? Don't be lame."
"Blank line? Lean blink."
"Blank lines? Blink, a lens."
"Blank stare! Ban talkers!"
"A blink, balkin[']. I blank."
"Blunt memo: mumble not!"
"The brave verb-hate!"
"Brevity-try vibe."
"Bury a vocal vocabulary."
"Cat, hatch chat!"
"Chatter is theatrics!"
"Coy Lip Policy."
"Curtness encrusts."
"'Drop the derp, tho['].'"
"Drowsy, pet? Type words!"
"Dud, mum dum-dum!"
"Dunno, so: no sound."
"Echoic choice."
"Eek! Let's try letter keys."
"Eh, inert in there?"
"Eh? Info? Oh, FINE."
"Emit grunt-muttering..."
"An empty type, man."
"Err...DO order."
"Forth? Aw, for what?" []
"Gosh, nice echoings."
"Great, I get air."
"Habla? ...blaah."
"Halting, thin lag."
"Hey, no silence license, honey."
"Hmm...mmh...m-hm."
"A hush to hash out."
"I dread a dead air."
"I.e. man, I mean..."
"In stone. Tension." []
"'Input? I punt!'"
"A light lag hit?"
"Lips slip?"
"A long think: no talk nigh."
"Lorn? Yep. No reply."
"Lurked a lot? Talk louder!"
"Me, I tout time out."
"Me, I'm ... mime!"
"'Me, typing? Emptying!'"
"Mimeness? [']S Immense."
"'A moment to ME, man!'"
"Mopy vales? Play moves!"
"Most neigh SOMETHING." []
"Mulling: a Mulligan."
"Mute? Coo! Come out!"
"Nary text? A try, next."
"'No chars, no crash.' Ah, scorn!"
"No claims. Laconism."
"No letters? Enter lots!"
"No tries in store? So inert."
"A nod at no data."
"A null vibe? Unlivable!"
"O, gag, agog!"
"O gosh, I'd not DO things."
"O, tut! Up! Output!"
"An object? No. Abject."
"Ohh. Um. Ho, hum."
"Oi, evac a voice."
"Omit talks? Total skim. Milk toast."
"Ooh, drat. Too hard."
"Ooh, its...I...shoot."
"Oy, Oy, Yoyo!"
"Panic-stare! I can't parse..."
"Paralysis spiral, say?"
"Parser sparer?"
"Passing gaspins[']."
"Plan book's blank? Oops."
"Plan? Oy, play on."
"Put out output." []
"Re-speak, speaker!"
"Redactional declaration."
"Respirator parrotries?"
"Say what? Aw, hasty."
"Seized-up, dupe-size!"
"Self censor? Confer less."
"Short pause: out, phrases!"
"Silent ops? Pointless."
"So, any say? No."
"So silent, I? Net loss."
"Spiritless lips? Resist!"
"Still? Nag: STALLING!"
"Stonewall tolls anew!"
"Sub-oral labours."
"Taciturn actin['] rut."
"Talk about? Balk out at..."
"There's a stare, eh?"
"Throat-space catastrophe?"
"Tut! Ever on to venture?"
"'Type a word, dopey wart!'"
"Type-ins yet? Spin..."
"Type more! Emote, pry!"
"'Uh, inept input, eh.'"
"Uh, speak! Shake up!"
"Uhh...huh?"
"Um. Ah. A hum."
"Um, garble a grumble?" []
"Umm...mum?"
"Un-speaking sneaking up."
"Up [']til now, low input."
"Very idle delivery!"
"Very stoic. Try voices."
"White noise is thine. Woe!"
"Without a silence license? Whoa, I tut."
"Woes guard word usage."
"Yep, halt the play."
"Yes, inert serenity."
"Yo! Apt to yap!" []
"You mouth out 'Hm.'" [x]
"You re-er." [x]

table of help companies [xxg4]
blurb
"Acing-the-Cheating Hint Cage."
"Advocate Data Cove!"
"Ah, DON'T I Do a Hint."
"Aleph-A Help!"
"All-Hint Anthill."
"Alpha-A HALP!"
"Answering-[']Em Game Winners."
"Authentic-Cheat Unit."
"Aw, Query Sick Quicker Ways!"
"Blue Coast Clue Boats."
"Blueprints: Brunt Piles!"
"Bona Fides Based Info."
"Chad's Tip Dispatch."
"Cheaters['] Hectares."
"Cheating Gain Tech"
"Clear-Cut Clue-Trac."
"Clue a Ton, Clean Out!"
"Cold Hearts Cheat Lords."
"Cued-Gain Guidance."
"Cynthia's Hints Cay."
"D'Onofrio Info Door."
"Delilah's Aid Shell."
"Diagnosis-SOS Aiding!"
"Did-a-Lot Told-Aid."
"Do-Things Hint-Gods."
"Don't-Shirk Dork Hints."
"End-Clueing Indulgence."
"Euclid's Sluiced ID Clues."
"Ever-Fails Life Saver."
"Exam-Tip Mix Tape."
"Figure-Out Fugue Trio."
"Gain the Hintage!"
"Game-Aid Vet: Give Me Data!"
"Garlic the Lethargic Cheat Girl."
"The Giant Get-a-Hint!"
"Gold Hope Good Help."
"Got Hint Tonight?"
"GRATITUDES Strat-Guide."
"Half-Pints['] Plan-Shift Thin Flaps."
"Hecate's E-Cheats."
"A Help Pal, Eh?" []
"Help-Solve-Level Shop."
"Helping-Gen Phil."
"Hep Clan Can Help!"
"Hep Lot: eh, plot to help!"
"Hint-Figs Shifting."
"Hint is in This."
"Hint-Loom Monolith."
"Hint-Me Hitmen."
"Hint Pages in the Gaps!"
"Hint-Seer In There's [if player is male]Seth Neri[else]Erin Tesh[end if]."
"Hint-U-Co: In Touch!"
"Hintable: the IN Lab!"
"Hit-and-Miss Hints Maids."
"Hole? Yup. Help You."
"Hopefully Helpful, Yo!"
"Hot Case O['] Cheats."
"'I Could've' Clue-Void."
"I, Help-Phile!"
"I-Stomp-Mo['] Tips!" []
"I'm-Spent Tips Men."
"Ida's Aids."
"If-Stuck [f-w]-Its."
"In-the-Moment Hint Memento."
"Is-on-Quest Questions."
"Kewl-Klew!"
"The King Hint Keg."
"Lakeside Sleek Aid."
"Le Focus of Clues."
"Le Herp Helper."
"Le Hints-Hit Lens."
"Le Ship is Help!"
"Lead-Tip Deal Pit."
"Leibniz Biz-Line."
"Let-up, ho? Hole-put? Ult-Hope Help Out!"
"Let's Hop to Helps!"
"Light-Speed Help Digest."
"Lights-On Hint Logs."
"Lots Vie/I've Lost: Solve It!"
"Luce's Clues."
"Ma's Prep-Mappers."
"Making-it Gamin['] Kit."
"Map-So-Nice Companies."
"Merciful Clue Firm!"
"Mr. Yates: Ye Smart Mastery!"
"My Clue Lyceum."
"My Thing: Hint Gym!"
"Near-Tips Pantries."
"Neat-Help Elephant!" []
"New-Bits Best-Win!"
"Nice Guys['] Yes-Cuing."
"O-It's-Bad Aid-Bots." []
"Of Hints I Fish Into: This Info."
"Oh, Yelps So Helpy Spyhole!"
"Ole Hint Hotline."
"One Fluid Un-Foiled Duel Info."
"Overleaf of Reveal!" []
"Overnight Hint Grove!"
"The Pal At Help!"
"The Panics-Hint Space."
"Patrick's Tips Rack."
"Peculiar Clue Pair."
"Piersol's Spoilers."
"Plot-Educer Cluer Depot."
"The Plot-Help Tot."
"Poem-Sleuth Helps-Em-Out."
"Prescient Tip-Screen!" []
"Pythonic Hint-Copy."
"Queries Esquire!"
"Query Us to Your Quest!"
"Rec Info In Force!"
"Right-On Hint Org."
"The Risen Hint-Seer." []
"Saner Tip Pantries." []
"Scheduling-Cluing Shed!"
"Should've Solved, Uh?"
"Shoveling Solve Nigh."
"Silverado Aid Lovers."
"Smart-Pick Trick Maps!"
"So Not Fair? Info, Sorta."
"Sol's Ripe Spoilers!" []
"Solution Solo Unit!"
"Spitfire Rife Tips!"
"Stop-RIP Pro Tips!"
"Technical Hint-Accel!" []
"A Thing-Do Hint-Goad."
"This-Turn-Rut Hints."
"Thrive-Tons Hint Troves."
"Top-This Hot Tips!"
"Top-Tips Pit Stop."
"Tut! Rely Utterly?"
"Ugh, a Worthy Way Through."
"Ugh, Tiny Hint Guy!"
"Un-doltish Loud Hints."
"Unclose Counsel."
"Unlock-Em Clue Monk."
"Us-A-Cheat Chateaus."
"Violet's Solve-It." []
"Wacky Squire Quicker Ways!" []
"We Phone New Hope!"
"Well-Said Swell Aid."
"What-Lurks Walkthrus." []
"Why a Rut? Way Thru!"
"Ye Cuing Nice Guy!"
"You Stuck? Yuck! To Us!"

table of noage [xxg5]
blurb
"Another rote 'Nah.'" []
"Arguing? Gag! Ruin!"
"Bien Sur be RUINS!"
"Blase? Edgy? Be glad! Yes!"
"Boo, sulky? Look busy!"
"A Bossy Sob, Say!"
"A cry, torn, contrary."
"Decline? Cede nil!"
"Denial, earn adrenaline!"
"Despair is a derp."
"Dig banes? Being sad?"
"Disagree is geared."
"Don't care? Do recant!"
"Enemy's yes-men!"
"Firm deny, my friend!"
"Fret? Be bereft!"
"Gloom? Mo['] glo!"
"Got up in pouting?"
"Grief, u figure."
"Grimace: magic-er? Erg, mac, I..."
"Grouchy? Uh, go cry!"
"Hate all? A lethal tell: a-ha!"
"Hey, wow...why woe?"
"Howdys, now. Why so down?"
"I'm less smiles!"
"It is not so, too! Insist!"
"Jeer, cat! A reject!"
"Lachrymose clamors, hey!"
"Meanwhile, lame whine..."
"Moan. Yawn. No way, man!"
"Mope, rube? Be more up!"
"Mythical, thy claim!"
"Naw! Yo, no WAY!"
"Neg-gen?"
"No subject: just be CON!"
"Nope, I opine."
"Notter? Rotten!"
"Oh, BS! Bosh!"
"Oh, pouts shoot up!" []
"Pouter's Posture!"
"Rues? Sure!" []
"Sad, user? Assured!"
"A skeptic? Epic task!"
"A smile's aimless!"
"A snub's odd. Sounds bad."
"Tons-Grim Storming!"
"Too grumpy? Go, mopy rut!"
"Whine-hewin[']!"
"Wilcos? I scowl."
"Woe, Ill? Lie low!"
"Yes, pout, you pest!"
"Yo, tend to deny!"
"Yo, tip: visit positivity!"

table of nonviolence messages [xxg6]
blurb
"Aflutter? Feral? Tut!"
"Aggression? Go! Reassign!"
"Ah, these hates, eh? Sheathe!"
"Aha, testy? STAY, HATE! That easy."
"Aw, lob a blow?"
"Ay, belts! Be salty!" []
"Bait! I bat a bit."
"Batteries? Be artiest!" []
"Battering? Bitter nag."
"Beating-up's abusing, pet."
"Box? No, obnox.!"
"Brawling? Glib warn!"
"Brutality? Truly, a bit."
"Conk, eh? Heck no!"
"Conk-fu? [f-w] no!"
"Do war? A word."
"Eh, I swoop...whoopsie!"
"Equip pique?!"
"Ferocious? I, of course, coo 'Furies!'"
"Fist fun? Snuff it."
"Fist? No: oft, sin."
"Fits fly stiffly!"
"Flay-outs? So faulty, lusty oaf." []
"Get mean? Neg, mate."
"Go postal? Log a stop!"
"Gonna hit? No hating!"
"Gyrate on? Negatory!"
"Hackles? SHACKLE."
"Handbags? Gnash! Bad!"
"Harshest thrashes!"
"Hating--a thing? Nah, git."
"A hint: hatin[']? Nah, it..."
"Hit [']um? No! Mouthin[']!"
"Hitter task? Strike that!"
"How stupid is THUD-POW."
"Huh, intent: in the hunt?"
"Hurty, uh, try."
"'I slap' is, pal, a slip." [p]
"I sour to riotous."
"'I swat?' Aw, SIT."
"In a feud? Fun Idea!"
"Indulge dueling? Eluding!"
"It's rot to stir..."
"'Items, smite! Emits!' It's, em..."
"Jerk acts? Rest, jack."
"Lashing out? Hating soul."
"Lay off of Flay!"
"Lay waste? Stale way."
"Leapt into potential peltation? Lo, patient!"
"Less anger: largeness."
"Lie down idle now, wild one."
"Lock in no lick."
"Lunge! Try urgently!"
"Main goal: Go animal?"
"Melee fail! I feel lame!"
"Murdering?! Demurring!"
"Nice hit? Thin ice."
"No belts = noblest."
"O, smite it some!"
"Oh, turn no hurt!" []
"Oho, swipe? Whoopsie." []
"Oi, a bloke! KABLOOIE!"
"Oo, fury for you!"
"Ooh! Fist fits! Oho!"
"Ooh, guts! So tough!"
"Ouch! No way! How CAN you?"
"Out-of-line fool, i.e. nut!" []
"Oy, sport! Too spry!"
"Phat now: whap not."
"Physical? Achy slip."
"A point to pain? A tip: NO!"
"Punch mo[']? No, chump!"
"Punch-outs? Un-posh! Cut!"
"Rage move? Game over!"
"Rah, enmity in my heart! Irate hymn!"
"Real hit? Halt ire."
"Rearing, angrier!"
"Ripe-Fist Spitfire!"
"Row? Dear! A re-word!" []
"Salty, mac. Stay calm."
"Say, don't do nasty!"
"Shift a fist? Ha."
"Sip guilt, pugilist!"
"Slugfest guts SELF."
"Smackin[']? Sick, man."
"Snuffliest fitfulness!"
"So, have a shove? Oh, SAVE."
"So wild? I'd slow..."
"A Sporty Strap, Yo!"
"Striking? Skirting."
"Swop POWS!"
"Sword? Words." []
"Take a swing? A weak sting."
"Tangle? Go! Get along!"
"Terminate? Mean! Trite!"
"Thuds now? Shut down!" []
"To brawl? Raw blot. Low, brat."
"To clash? Ha, clots."
"To scowl: low-cost."
"To shred? D'oh! Rest!" []
"To slash so? HALTS!"
"To slay? Ay, lost."
"To spring on...sporting? No!"
"Trounce? No! Truce!"
"Truculent? Un-clutter. Cut. Let run."
"A twitch? Watch it!"
"Type A? Rec: try peace."
"Um, meanest amusement."
"Un-rec: to trounce." []
"A verb truly very brutal!"
"Violence?! Love! Nice!"
"Violent, so: I solve not!"
"Wallop, pal? Low."
"Warpath? Haw, trap!"
"Weakest swat. Eek!" []
"Whaps? Pshaw!"
"You're... 'this' at hits." [x]
"Zen! Fray a frenzy!"
"Zone of zen? Oof!"

table of singing rejects [xxg7]
blurb
"Bad voice vibe, o cad."
"Be tonal? Not able."
"Blottier libretto."
"Cacophony? No. Coy, Chap."
"The chorus echos hurt!"
"Desultory yodels-rut."
"Eh, wail a while."
"Engrossing, er, sing-song. No sniggers!"
"Gonna sow a song NOW?"
"Harmony, yon? HARM." []
"An itch: I chant!"
"The music, um, itches."
"Neat, bud! Bad tune!"
"No melody! My noodle!"
"The notes? Not these."
"Sad yodel so deadly!"
"Sing here? Eh, resign."
"Sing-ings is NG."
"Sing out in gusto? It's, UG, No." []
"So atonal. Nasal, too!"
"So chanty? Yo, STANCH!"
"A sore arose! O, ears!"
"Talent of...flat note!"
"Tenuously lousy tune you lent us."
"Trololo? Oo, troll!"
"You sang us agony. Go, un-say!"
"You, sing? Oy, suing!"
"Your tune is yet ruinous."
"Your tune? Oy, untrue."
"Your tune's sour. Ye nut. Yes, run out."

table of sleep rejects [xxg8]
blurb
"[if player is male]Senor Snore[else]Senora, a snore[end if]!" []
"'Asleep? Please?' / 'See, pal...'"
"Conk out: OK? No! Cut!"
"Cop out? Up, coot!"
"Eh, napping happening?"
"Fond of nod off?"
"Forty winks? Won't! Frisky!"
"Go to bed? Beg: to DO." []
"Go to bed? Do be got."
"I'm at bed? Bad time!"
"Keel? Apter: keep alert!"
"Let astray? Stay alert!"
"Loafing? I flag? No."
"Nap Time? Am inept!" []
"Nap, tot? Not apt!"
"Nix large relaxing."
"No naps. On! Snap!"
"Not sharp? Short nap."
"Oh, sleep's hopeless."
"Penalties at sleepin[']."
"Plot needs: don't sleep."
"Rest now? We snort!"
"'Rest opp! To preps!'"
"Rest pad? Departs!"
"Select nap? Can't sleep."
"Sleep, eh? Sheeple." []
"Sleep, man? Pense mal."
"A sod, upset, passed out."
"Some rest seems rot."
"Splurge no super-long gulp-snore."
"Tired now? Won't ride!"
"To nap: apt? No."
"To nap is a top sin!"
"To nap now: wanton op!"
"To naps? No! Past!"
"To sleep? Eep! Lost!"
"To yawns? Say, won't! Stay, now!"
"To zen, cad? Can't doze!"
"Yo! Want to yawn? Aw, t/y, no."

table of undo allows [xxg9]
blurb
"'Action over? Revocation!'"
"'Adjourn? Jar! Undo!'"
"Ah, sow whoas!"
"Ambient time-nab."
"And touche! Cheat, undo."
"'Anyhow, it's THIS way, no?'"
"'Anyhow, tear another way.'"
"'Ay, rooked? Redo okay. A door key.'"
"Betise-beset, I!"
"'A blunder? Deal. Burn.'"
"'A blunder? Learn, bud.'" []
"'Construe recounts.'"
"'Cor! Veer! Recover!'"
"Desperately replayed? Set!"
"'Dire act? I redact!'"
"Dire tale? I altered!"
"Diving so? Voidings!"
"'Do a run-around.'"
"'Do. Certain? Redaction.'"
"'Do it, man, and omit...'"
"Done that? Oh, attend."
"Done work. Know. Redo."
"'Easy, tidy. Yay, edits!'"
"'Echos: CHOSE!'"
"Editing: IGNITED!"
"'Editor! Redo it!'" []
"'Eliminate a timeline!'"
"'Er, cautions. Recusation.'"
"Erase that! Ah, restate!"
"'Erase tons! So earnest!'" []
"Fare ill? A refill."
"Fault now? Not awful."
"'Flounderer! Err, Undo Elf!'"
"'A fresh re-fash.'"
"'Funny li'l nullify'n!'"
"'Gad! Reset!' / 'Restaged.'"
"'Gah, spun. Hang-ups.'"
"'Gird one redoing!'"
"'Go, erase so eager!'"
"'Go-over groove!'"
"'A goadin[']: Do again.'"
"'Greener Reneger!'"
"Gruntin['] turning."
"'Hampering nigh. Re-amp!'"
"'Hark! Redos?' / 'Rad. Kosher, dark horse.'" []
"Heap errs? Rephrase!"
"Hi, fast: a shift!"
"'I create a re-cite.'"
"I go find my modifying. Dignify mo[']."
"I plan, cute: un-place it. Clean it up."
"'I--return! Re-run it!'"
"'I rode. O, dire! I redo!'" []
"'I wander. A rewind!'"
"Ill-fated fall? Edit!"
"Jaunts dig adjusting."
"Lamely using mulligan? Yes!"
"Last move? Slam! Veto!"
"Lo! Back a block."
"Loth sound: 'Should not undo, sloth! Thud!' Loons." [p]
"'A mess-up? Um, passe.'"
"Mistype is empty. My, I step."
"Mistype-smit? Yep!" []
"'A misuse, I assume.'"
"'A modern redo, man. Ram. DONE.'"
"'More to re-moot!'"
"Most haywire! More THIS way!"
"'Much done. Ouch, mend, undo-mech!'"
"Neat! Retro! Retreat on!"
"Nil wrested? Let's rewind."
"'No! A slip so plain!'"
"'No gain, Ace? Once Again!'"
"'Nod. Kill old link.'"
"'O, unrest! Not sure!'"
"'Odd! I've...voided.'"
"'Oh, dear!' / 'Ah, redo!'" []
"'On, bud, to undo-bot!' / 'No doubt.'"
"Ooh, redraft, for the road."
"Oops, there. Pooh, reset."
"'Or else, er, LOSE!'"
"Or gear a re-org!"
"'Or the other...'"
"'Ordeal reload!'"
"'Play around, parlay, undo.'"
"'Pout. Darn. Trap. Undo.'"
"'Prevailer reprieval.'"
"'Re-gluing? Grueling! Gurgle in!'"
"'Re-gluing...grueling!'" []
"'Reader, at a retread.'"
"'Redacting? Can get rid.'"
"'Redaction? I don't care.'" []
"'Redo-so rodeos!'"
"'Redoin['].' / 'Ride on.'" []
"Redound: red! Undo!"
"Refocus? O, of course!"
"'Rein in, er...'"
"Relief on! Lo, refine!"
"Rem: a rut. Erratum! Maturer?"
"'Rent-up? Re-punt.'"
"Repeatedly-retype deal!"
"'Reportedly redo pertly. Lord, retype! Orderly, pet.'"
"A rerun? Un-rare."
"Reset-bot! Better, SO."
"'Retrace, fox, for exacter extra force!'"
"'Retractin[']? Err, INTACT!'"
"'A retry artery.'"
"'Rets-ster?!'"
"Revamp it, tho[']. Improve that."
"Revisit! I strive! Vie! Stir!"
"'Rewind: new dir!'" []
"'Rid new. Rewind.'" []
"'Roger. Reorg.'"
"'Romp so, [if player is male]Mr. Oops[else]Ms. Or-Op[end if]!'"
"'Rote. Void. Do it over.'"
"'Rub this rush-bit!'"
"Simply a mis-play."
"Simply a misplay."
"Snare? Phew. New phrase: we sharpen!"
"So, ruined? Rise, undo!"
"'So, undo. Uno, dos...'"
"'Spoils by slips? Boy, possibly!'" []
"Strayed, yes? Drat!"
"'Strife? Re-fits.'"
"Take now? No, tweak."
"Temporary typo. Re-arm!"
"Terse old 'Let's redo!'"
"'Time warp: we impart!'"
"'Trip? See respite!'"
"'Tweak! To Take Two!'" []
"'Un-hack a chunk.'" []
"'Undo, trow?' / 'Round two.'"
"'The undo: uh, noted.'" []
"'Undoers, resound sounder!'"
"The vigor's oversight trove. Sigh."
"'Was void! Disavow!'"
"'We earn a renew!'"
"We impart time warp!" []
"'Went awry? Aw, new try.'"
"'Word one: redo NOW!'"
"'Wrong foot. I now go for it.'"
"'Yo, retro, men! One more try!'"
"'Yo, start to stray...'"

table of undo rejects [xxg0]
blurb
"Beat? A knock? No take back!"
"Bouts of undo: out of bounds!"
"Bud, to tiny bitty undo? Don't buy it!"
"Can't redo! Don't care." []
"Can't undo. Dunno--ACT?"
"CHOSEN! Nag no changes!"
"Dire to redo it." []
"Double dip, dupe? I...bold." []
"Double dips despoil, Bud."
"An edit? DETAIN!"
"'Hark! Redo?' / 'Dark, Hero!'"
"'Here, rash rehasher!'"
"If redos, so fired."
"Inverts, ace? Can't revise antics, ever."
"'Last idea? IT'S A DEAL!'"
"Last slip? It'll pass."
"Mistypes? Mess? Pity!"
"No, rude undoer."
"No tube to un-be."
"Not again! A giant NO."
"Now, take tweak? NO!"
"Oo, rend no re-do."
"Redo? AVERT! Overrated!"
"Redo? Riven! Overriden."
"Redoes-try? Er, destroy!" []
"Redoin[']? NO! Dire!" []
"Redoing ignored!" []
"Rehash, eh? Rash!"
"Reorients? No retries!"
"A reset? Ee, rats! Teaser!" []
"A reset? NO! Erase not."
"Retracing act: erring."
"Retreads? ARRESTED!"
"'Revise, Pops? Oppressive!'"
"A rewind? Naw, ride."
"Second try? Descry not."
"Second way decays now!"
"So, Refund Founders."
"A taint froths: that's not fair!"
"Time travel? Vile matter!"
"To rewind? Dire! Won't!"
"Too far back! A fact, bro[sic]. OK."
"Too tired to redo it."
"Undo this? No. Duh. Sit."
"Undoin[']? I dunno."
"Undoing? I'd gun on."
"Undos? What? A shutdown."
"Word, NOTE: won't redo!"

table of wait responses [xxg10]
blurb
"Act, cat!"
"'Actin[']? I can't!'"
"Actions as tonic? I so can't!"
"Ah, so: net no haste."
"Ahh, paused? Push ahead!"
"Any gelid delaying: yield nag."
"Apathy: phat, ay!"
"Astoundingly languid. Stony."
"Atrophy? Oh, party!"
"Aw, actin['] can wait."
"Aw, yer weary."
"Be patient? Tip: beaten."
"Bore-fest so bereft!"
"Breaks, Basker?"
"Camp it? IMPACT!"
"Cast acts."
"'Come along? Congeal mo[']!'"
"Contain no actin[']."
"A dally: all day?"
"Deferment fermented."
"Delayings yield nags."
"Dog, a hint: do a thing!" []
"Dust off! DO stuff!"
"'Effort? I forfeit!'"
"Effort is forfeits!"
"Eh, I try on...in THEORY."
"Elapsing: Pleasing?"
"Ennui-abled? Undeniable."
"Erg, sponsor no progress?"
"Estimable Blase Time."
"Fatigue? Ague fit? Fie, a tug!" []
"Feet of toffee." []
"Fester, freest!" []
"Finagle lag? Fine."
"Flat, idle: ill-fated." []
"Froward? Forward!"
"Game rut? Um, great."
"Gee, don't get done."
"...Gets all 'Let's lag!'"
"Glare! Nix Relaxing"
"A glum, um, lag."
"Gosh, di'n't DO things." [p] []
"Gotta STEP to get past!"
"Hangings? Gnashing!"
"Haste? Meh! The shame!"
"Haw, lie a while." []
"Hold sweat? Slow death."
"Howdy! Why do?"
"Hurry on? No hurry."
"I contain inaction."
"I lag. Fun? Gainful?"
"'I loaf?' O, fail!"
"'I locked up?' Lucid poke."
"I stew. We sit."
"'I wanna win...naa.'"
"I'd lessen idleness."
"'I'll best be still.'"
"'I'm so not motions!'"
"Idle, goof? Good life!"
"Idyll? Dilly, dilly."
"Idyll so: solidly."
"Inertest interest, it enters." []
"Init's sin, it. Sit in!"
"Know more work? Me? No."
"Lag-hit? Alight!" []
"Lag, lag, all gag."
"Lag oft? Go flat." []
"Lassitude is saluted!"
"Latence's cleanest."
"Leady delay dealy..." []
"Let time pass? Simple taste. I step lamest!"
"Loaf? Err for-real."
"Loafin[']? No! Fail!"
"Loitering? Toil, Reign!"
"Long pause plagues on."
"Me: torpor promoter."
"'Momentum? Umm, not me.'"
"Mope? Put up tempo! Um, to pep!"
"More action! Motion! Race!"
"Motionless. Not lissome?"
"Nay, tot. Do not today."
"Neg to 'Get on!'"
"No vim? Movin[']! Movin[']!"
"Not pro-pronto?"
"The now went, oh!" []
"O, bring boring!"
"O, loaf, aloof!"
"O, rush, hours!" []
"O, slog! Go slo!"
"Oaf! Clot! Act, fool!"
"Oh, told to hold."
"On, ho? No! Oh!"
"Oy, Lotza Too-Lazy."
"Panic?! Pacin[']?!"
"Paroles? Reposal."
"Pass time? A misstep!"
"Passivity pays visit."
"Pausing gains up."
"Petrous posture!" []
"'Please elapse,' you think, and time does." [x]
"Practise paretics?"
"Rather BE. Breather!"
"Reclination's nonrealistic."
"Rest off efforts."
"Restin['] is Sinister!"
"Runt! Evade adventure?"
"Samely? Measly? Slay me!"
"Sit-around durations." []
"Sit? Lo, TOILS!" []
"Sit no mo[']! MOTIONS!"
"Sit there? Stir thee!"
"A slick 'I slack.'"
"Slowing up? Lo, upswing!"
"So, don't do tons."
"So idle? I'd lose!"
"Sod do's." []
"'Sorties? I rest, so.'"
"Stamina? Man, I sat."
"Stasis? Assist."
"Stay[if player is male]s, Mr[else], Mrs[end if]? My stars!"
"A stew on? No sweat." []
"Stimu? I must, um, sit."
"Stuff-op? Puts off!"
"Tarries! I arrest!"
"Tarrying? Grit: nary."
"Tediums Must Die!"
"Temporarily mopy? Retrial!"
"This wait. What is it?"
"Thy large lethargy? Lag? Eh, TRY!"
"Time off? Fit fo['] me!"
"To delays? Loads, yet."
"To dog Godot!"
"To park: OK? TRAP!"
"To spin in spot? No. Pits."
"To tarry? Rot, a try!"
"Torpor? Pro-rot!"
"Trek slow? Let's work!"
"Trepidation: adroit? Inept!"
"'Tries? It's, er...I rest.'"
"Uh, stir! Rush it!"
"Uhh, mo['] ho-hum?" []
"Unmotivated? Vim! Do attune!"
"Veg out, eh? The vogue."
"Waste time?! Emit sweat!"
"A watch? Haw, act."
"Way in, I yawn."
"When? Not now, then?" []
"Won't dare to wander."
"Yea, told to delay."
"'A yield. I delay.'"
"You mind muy doin[']?"
"You pass, so? Say, UP!"

table of yessage [xxg11]
blurb
"Agree, Eager."
"Agreed? Gee, rad!"
"Agreement's sent? Meagre."
"Attuning nutating?"
"Beam nice ambience!"
"Bound to doubt? NO!" []
"Doggone, life! Feeling good!"
"Enamored demeanor!"
"Enthusiasm tsunamis, eh?"
"Flatterer alert! Fret!"
"Flattery? Fly treat!"
"Fling treats, flatterings!"
"A frown? Far, now!" []
"Gee, says yessage."
"Ha, cute! Boy, you betcha!"
"Hey, wow! Whew! Yo!" []
"Honesty? Tons, Hey!"
"Languid lauding!"
"Lo, serve resolve!"
"Mild, sane, smile and mend ails!"
"Nod. Truth don't hurt."
"'O, quite,' quote I."
"On doubts: bud, not so!"
"Pleasing, pale sign."
"Pouting? I go punt!"
"Reaction's so certain."
"Right on, I throng!" []
"Say ays?"
"Simpers: impress? Erp! Miss!"
"So cheery! Or...cheesy?"
"So fond of nods!"
"Sure, user! Sure!" []
"Yes, cast ecstasy!"
"Yes, eh? Yeesh!"

book manor

table of ad slogans [xxm1]
blurb	blare [random sad ads: the blare field designates whether you have an exclamation point at the end]
"[d-t] Saffo Fast Food"	false
"[if player is male]Aaron Colt[else]Lora Acton[end if]'s Root Canals"	false [p]
"[if player is male]Alec Pino[else]Loni Cape[end if]'s Special on Pecan Oils!"	true [p]
"[if player is male]Arie Voss[else]Eva Rossi[end if] Savories"	false
"[if player is male]Ced Minton's[else]Dot McInnes[end if] Condiments"	false
"[if player is male]Curt Aish[else]Traci Hsu[end if] Haircuts"	false
"[if player is male]Dave Heiss[else]Vida Hesse[end if] Adhesives"	false
"[if player is male]Derek Weill[else]Elke Wilder[end if] Weed Killer"	false
"[if player is male]Eli Nolan[else]Nell Inoa[end if] All-in-One Loan Line"	false
"[if player is male]Hal Moet[else]Mae Holt[end if]'s Hot Meals Most Hale"	false [p]
"[if player is male]Ivan Coats[else]Staci Avon[end if] Vacations"	false
"[if player is male]Leif Donat[else]Ida Felton[end if] Deflation Defoliant"	false
"[if player is male]Leo Starr[else]Rosa Ertl[end if] Realtors"	false
"[if player is male]Marc Lea's[else]Marcela's[end if] Caramels"	false
"[if player is male]Ned Segura[else]Agnes Duer[end if] Ungreased Dungarees"	false
"[if player is male]Omar Warfel[else]Mara Fowler[end if] Formal Wear"	false
"[if player is male]Ray Lund[else]Lady-Run[end if] Laundry"	false
"[if player is male]Rex Patil's[else]Lex Raptis[end if] Pixel Arts"	false
"[if player is male]Sandi Doucet[else]Count Addie's[end if] Dance Studio"	false
"[if player is male]Saul Fern[else]Fran Lue's[end if] Funerals"	false
"[if player is male]Ted Reining's[else]Enid Ginter's[end if] Tenderising Ingredients"	false
"[if player is male]Wes Prieto[else]Teri Swope[end if] Power Ties"	false
"A-Lister Retails"	false []
"A-Maze-Ing Magazine"	false
"A-Sled Deals"	false
"Abe Bruce Barbecue"	false
"Abelson's Bonselas"	false
"Abler Acre, a Cerebral Cereal Bar"	false
"Abrante's Ratsbane"	false
"Abs by Babsy"	false
"Absurdist Drab Suits"	false
"Accept CapTec!"	true
"Ace-Diet Iced Tea"	false
"Ace Finn Finance"	false
"Ace Finn's Finances"	false
"Ace Reed's Decrease-Care Seed"	false
"Acne Irks? Skin Care!"	true
"Acne? LOL, One Call: Cal Leon!"	true
"Acne-Plus Clean Ups"	false
"Adeline's Sane Deli"	false
"Adless Slade's"	false
"Aethers-Heaters"	false []
"Agnello Galleon"	false
"Agramonte Matronage"	false
"Akridge Kid Gear"	false
"Al Agan's Lasagna"	false
"Al Rocco's Cool Cars"	false
"Al Tower's Low Rates Wares Lot"	false
"Al's IV Vials"	false []
"Alba's Rad Salad Bar"	false
"Albertsen Rentables"	false
"Alcster Clarets"	false
"Alda's Salad"	false
"AleCo's Solace!"	true
"Alemoat Oatmeal"	false
"Alemonde Lemonade"	false
"Alex's Axles"	false
"All-Ads Lad Sal Dallas"	false
"All-Soy Alloys"	false
"All-Sweet Swell Tea"	false
"Aloisi Aiolis"	false
"Alpert's Plaster"	false
"Alph Pierre Peripheral Repair Help"	false
"Alrite Retail"	false
"Alstott's Stats Lot"	false
"Alterman Maternal"	false
"Altidor's Dilators"	false
"Altoids: Lots Aid Sad Toil!"	true
"Alvin's Anvils: We Stay Sweaty!"	true
"Amaro's Aromas"	false
"Amortised Mediators"	false
"Amos Mao's Moas"	false
"Amy's Yams"	false
"Ana Peck's Pancakes"	false
"Angela's Lasagne"	false
"Angelica's Analgesic"	false
"Angelis Leasing"	false
"Annetta's Tannates"	false
"Annoyed? Nay, Done? Anodyne!"	true
"Anti-Modern Ordainment"	false
"Antony's Tannoys"	false
"Anyone's-Aim Mayonnaise"	false
"Ape-Musk Makeups: Um, Speak!"	true
"Apothecary [if player is male]Paco Thayer[else]Chaya Perot[end if]"	false
"Apperson Propanes"	false
"Aquino Quinoa"	false
"Ar, Avast! Ava's Art Avatars"	true
"Aragon's Angoras"	false
"Ardolino's Doornails"	false
"Argentic Catering"	false
"Arista Tiaras"	false
"Ark O['] Okra"	false
"Arlinda's Laniards"	false
"Arming Margin"	false
"Armorer Marrero"	false
"Arrow Slope Solar Power"	false []
"Art Cho's Hot Cars"	false
"Art Reed's Serrated Treaders"	false []
"Artsy Logo Astrology"	false
"ASAP St. Pastas"	false
"Asherin Hernias Shearin[']"	false
"Asich Chais"	false
"Ask-Best Baskets"	false []
"Ask-Bob Kabobs"	false
"Ask-Kay Kayaks"	false
"Asphodel Deal Shop"	false
"Aspinwall Law-Splain"	false
"Asprey's Spayers"	false
"Associated Coast Ideas"	false
"Astilbe Lab Site"	false
"Astle's Tassle Slates"	false
"Astor's Assort-Roasts"	false
"At-Cost Cotta's"	false
"Atari's Tiaras"	false []
"Atchinson's Stanchions"	false
"Atchley's Slay-Tech"	false
"Atherton's Northeast"	false
"Attebery's Terabytes"	false
"Atwell's Wallets"	false
"Auberge Gebauer"	false
"Auntie Q's Antiques"	false
"Aviles's Valises"	false
"Avon Nova Nav-O"	false []
"AwnedCo: We Can Do a New Doc!"	true
"Axel's Vita-Laxatives"	false
"B-Dry by Dr. Byrd"	false
"Babel E-Blab: B-Able!"	true
"Babilo's Bio-Labs"	false
"Back Pain? Nab a Pick!"	true
"Bad Anna's Bandanas"	false
"Bagels['] Gables"	false
"Bags by Gabby's"	false
"Ball State Table Salt"	false
"The Balm, Bleah (TM)"	false
"Bang! Ira's Bargains!"	true
"Bangor's Brogans"	false
"Baquero Baroque"	false
"Barclay's Lacy Bras"	false
"Bardot Bod-Art"	false
"Barkey-Kearby Bakery"	false
"Barlow's Law Bros"	false
"Barnaby Bay Bran"	false
"Barros Arbors"	false
"Bart's Fake Breakfast"	false
"Bartolini's Librations"	false
"Bartolo's Toolbars"	false
"Bartolome's Motorables"	false
"Bartolucci's Subcortical Caloric Bust"	false
"Battershell Tetherballs"	false
"Batterson Betatrons"	false
"Bauder Dauber-Earbud"	false
"Bawdy-Era Waybread"	false
"Bea Kraft's Breakfast"	false []
"Bearded Dad Beer"	false
"Beat-Slop Potables"	false
"Beaudry Daubery"	false
"Beavins Ave. Bins"	false
"Beilfuss Sub-Files"	false
"Bella's Labels"	false
"Beloit's Best Oil"	false
"Ben Liszt Blintzes"	false
"Ben Moral's Lemon Bars"	false
"Ben Way's News Bay"	false
"Benton's Bonnets"	false
"Berdahl's Halberds"	false
"Berhorst Brothers"	false
"Bert Snow Brownest Snot-Brew"	false
"Best Bets"	false
"Best Buy Yet: Bub's!"	true
"Bettina's Tabinets"	false
"Bettinger Bettering"	false
"Betton's Bot-Nets"	false
"Bevis Vibes"	false
"Bhandari's Hairbands"	false
"Bhat's Baths"	false
"Bhutto's Hot Tubs"	false
"Biel's Libes"	false
"Big and Bad Gin"	false
"Big Chalk St. Backlights"	false
"Big Max's Mix Bags"	false
"Big Nat's Basting"	false
"Big Rana's Bargains"	false
"Big Tank's Knit Bags"	false
"Big Tent Betting"	false
"Billinger Rebilling"	false
"Bin-Grown Brown Gin"	false
"Blacksmith Thick Balms"	false
"Blair's Bold Billboards"	false
"Bleak Cat Black Tea"	false
"Blest Belts"	false
"Blockbuster Bulb Restock!"	true
"Blotchy? BlythCo!"	true
"Bo Dean's: Based on No Beans an['] Bones!"	true
"Bo Lett's: Belts to Bottles!"	true
"Bo Novak's Book Vans"	false
"Bo Stamp's Spambots"	false
"Bo's OK Books"	false
"Boar's Head Rehab Soda"	false
"Bob's Grain: Absorbing!"	true
"Bobo's Urn Bourbons"	false
"Boehner's Neo-Herbs"	false
"Boettcher's Brochettes"	false
"Bogle's Globes"	false
"Bojan's Banjos"	false
"Boldest DebtSol"	false
"Bonet's Bentos"	false
"Boniness Benisons"	false
"Booby-Fad Baby Food"	false
"Boorts-Stroob Boostr-Robots"	false
"Boost-Gang Toboggans"	false
"Borelli's Brollies"	false
"Bostic Bits Co"	false
"Boswell Bellows"	false
"Boutilier's Boiler Suit"	false
"Bowdoin's Wood Bins"	false
"Bowen's OK New Books"	false
"Boxer Yang's Oxygen Bars"	false
"Br'er Wes Brewers"	false
"Brad Canton Contraband"	false
"Brad Coe's Barcodes"	false
"Brainer Berrian"	false
"Brandey's Dry Beans"	false
"Brandi's Ribands"	false
"Brandley's Benadryls"	false
"Brave-Win Vain Brew"	false
"Break Down? Know Dr. [a-b]!"	true
"Break-Sweat-Wear Basket"	false []
"Bree Eber Beer"	false
"Brenna's Banners"	false
"Bri's Ribs"	false
"Briceno's Bicornes"	false
"Brie's Biers"	false
"Brigandi Braiding"	false
"Brisance Carbines"	false
"Brisbon-Robbins Ribbons"	false
"Bristol Ribs Lot"	false
"Bro Green's Born Serge Rosenberg."	false
"Broch St. Borscht"	false
"Brookdon's Doorknobs"	false
"Broomyard Body Armor"	false
"Brunetto's Obstruent Buttoners"	false
"Brushpiles Publishers"	false
"Bub Lea's Baubles"	false
"Buckingham's Hick Guns. BAM!"	true
"Bud Eley's Blue Dyes"	false
"Burchette's Trebuchets"	false
"Burp-Ade's Super Bad!"	true
"Burrage Garbure"	false
"Burstein Turbines"	false
"Burt Straw Bratwurst"	false
"Butty by Tut"	false
"A Buzz: ZUBAZ!"	true
"Cafe Do-Shop-Cheap Foods"	false
"Cafe Fine Caffeine"	false
"Caggiano's Anagogics"	false
"Cagney Agency"	false
"Cahill's Challis"	false
"Caisson Casinos"	false
"Cal Berg's Crab Legs"	false
"Cal Crown's Clown Cars"	false
"Calder's Cradles"	false
"Caleb's Cables"	false
"Calo-Cola: All Cocoa!"	true
"Calumet's Muscatel"	false
"Camara's Mascara"	false
"Camden's Med-Cans"	false
"Camenish Machines"	false
"Camille's Micellas"	false
"Candor Dacron"	false
"Canker-is-a-Snicker Skin Care"	false
"Capell's Scalpel"	false
"Capelli's All-Spice"	false
"Capozzoli Cool Pizza"	false
"Capps-Baker Paperbacks"	false
"Captain-A Catnip"	false
"Caravan Nav-a-Car"	false
"Cardozo's Zoo Cards"	false
"Care to Try Ye Tractor"	false
"Cargil Garlic"	false
"Carin's Scarin['] Cairns"	false
"Carlee's Cereals"	false
"Carleen's Cleaners"	false
"Carleen's Cleanser"	false
"Carlo's Ol['] Cars"	false
"Carlsbad Lab Cards"	false
"Carly's Lycras"	false
"Carolee's Escarole"	false
"Caroline's Real Coins"	false
"Carquest Racquets"	false
"Carson Acorns"	false
"Carstarphen Sharp Nectar"	false
"Casoni Asonic Casino"	false []
"Cassel Scales"	false
"Castile's Scaliest Elastics"	false
"Castillo Ill Tacos/Cola List"	false
"Cat's Ill? St. Lilac!"	true
"Catapano Caponata"	false
"Catarino's Raincoats"	false
"Catt Reich, Architect"	false
"Cave Wine: a New Vice!"	true
"Ceci Van's Vaccines"	false
"Celona's Seconal"	false
"Certain Caterin[']"	false
"Cestaro's Coarsest Coasters"	false
"Chad's Wines, Sandwiches"	false
"Chad's Wines/Sandwiches"	false
"Chamber Gin: Be Charming!"	true
"Chandra's Handcars"	false
"Chapin's Chips an['] Spinach"	false
"Charest's Starches"	false
"Charette's Catheters"	false
"Charlie's Heli-Cars"	false
"Charlie's Rich Ales"	false []
"Chat is at Chi's. Cash it!"	true
"Cheesed-Off? Coffee Shed!"	true
"Cheetam's Machetes"	false
"Chen-Lu's Lunches"	false
"Chet's Techs Chest"	false
"Chez Una's Szechuan"	false
"Chic Metro Micro-Tech"	false
"Chip Kroft's Pitchforks"	false
"Chipotle PoliTech"	false
"Choose ShoeCo!"	true
"Chopin's Phonics Shop, Inc"	false
"Chopra's Car Shop"	false
"Chrestman Merchants"	false
"Cigars? No. Craigson Organics!"	true
"Cilla's Lilacs"	false
"Citator Ricotta"	false
"Citizens, Nice Zits? Zinc-Site!"	true
"Cittadino Dictation"	false
"CJ Poster Projects"	false
"Clapper's Scrapple"	false
"Clarkston's Corn Stalks"	false
"Clem's Odd Cold Meds"	false
"Clemente's Selectmen"	false
"Clepski Pickles"	false
"Cline Elms Smell Nice"	false []
"Closer Relocs"	false
"Clothier Eric Holt"	false
"Coatless? Lacoste's"	true
"Cobain's is Bacon!"	true
"Cobra-X's Boxcars"	false
"Cohan's Nachos"	false
"Coif fail official? Up, see to toupees!"	true
"Colgin's: CLOSING!"	true
"Colty's Costly Octyls"	false
"Comic Sans Moccasins"	false
"Compton's Compost'n"	false
"Con Base Beacons"	false
"Condit's IntDocs"	false
"Consider Doc Reins!"	true
"Consider SniderCo"	false
"Consoled? Don Close Condoles!"	true
"Consume Us: MenCo!"	true
"Cook-OK Co"	false
"Cool Hal's Alcohols"	false
"Cool Story Color Toys"	false
"Cooney's Econ-Soy"	false
"Coons & Son Co"	false
"Cooper Rope Co"	false
"Coppola Alco-Pop"	false
"Coppola's Loco Apps"	false
"Corces Soccer Co-Recs"	false
"Cordia D'Arico Cardio"	false
"Cordova's Vac-Doors"	false
"Corelli's Colliers"	false
"CoreOp RepoCo."	false []
"Coretta's Tots-Care"	false
"Cormac's Scram Co"	false
"Corzine's Zinc Ores"	false
"Cosell Cellos"	false
"Costa Tacos"	false []
"Costean Octanes"	false
"Costumer Curt Mose"	false
"Cosy Fork Fry Cooks"	false
"Cotner's Cornets"	false
"Count on NoNutCo!"	true
"Courington Contouring"	false
"Couth-Hut Co"	false
"Covet Eco-TV!"	true
"Cowherd's Chowders"	false
"Craig's Cigars"	false
"Cred-Tips Predicts"	false
"Creeps['] Crepes. Respec[']!"	true
"Cremins Mincers"	false
"Crisp Alt Clip-Arts"	false
"Cristobo Robotics"	false
"Cropham's Camphors"	false
"Crowe's Escrow"	false
"Cruiser Curries"	false
"Crusoe's Sucrose Sources"	false []
"Cuneo's Ounces"	false
"Cuper's Spruce Up Recs"	false
"Curatory Carry-Out"	false
"Curt Uden's Undercuts"	false
"Customiser Costumiers"	false
"CuteLab's Blue Cats"	false
"Dale's Deals"	false []
"Dalton's Sandlot"	false
"Damage Bros. Board Games"	false
"Dan Peck's Neck Pads"	false
"Dario's I-So-Rad Radios"	false
"Darner's Errands"	false
"Darrel's Larders"	false
"Data Reps Adapters"	false
"Dav's OK Vodkas"	false
"Dawn Krom's Markdowns"	false
"Deb Hooks Book Shed"	false
"Deb Saxon's Sandboxes"	false
"Deb's Beds"	false
"Debarros's Adsorbers"	false
"Debit Bidet"	false
"Decent-Tec Den"	false
"Decide on IndeedCo"	true
"Decorations['] Co-Ordinates"	false
"Def Pyre Deep-Fry"	false
"Deforrest's Fortressed Defrosters"	false
"Defuse-Us Feed"	false
"DefWear: Few Dare!"	true
"DeGrasse Dressage"	false
"Degreasant Tea Gardens"	false
"DeHoios Hoodies"	false
"Deion's is Done! So, dine!"	true
"DeLancey's Clean Dyes"	false
"Delgiorno's Gondoliers"	false
"Della's Ladles"	false
"Delmore's Modelers"	false
"DeLoise's Oilseeds"	false
"Delrossi Soldiers"	false
"Deluca's Caudles"	false
"Demarais Madeiras"	false
"DeMarino Radio Men"	false
"Demaris's Misreads"	false
"Demersal Emeralds"	false
"Denault's Unsalted Nuts Deal"	false
"Denniston Nintendos"	false
"Dense Strainer Needs Trainers!"	true
"Dentinger's Tenderings"	false
"Depend on Ned Epdon!"	true
"Deponte's Pentodes"	false
"DermaDream = Rad Me!"	true
"Derrig's Girders"	false
"Deryl can dry clean!"	true
"Devine's Endives"	false
"Di Best Bidets"	false
"Di Malanta's Dalmatians"	false
"DiCarlo's Cordials"	false
"Diebel's Edibles"	false
"Dig Crafts? Gift cards!"	true
"Digestional Gelatinoids"	false
"Dilger's Girdles"	false
"Dinkel's Kindles"	false
"Diploma Mail-Pod"	false
"Discarded Dad's Cider"	false
"Discount Conduits"	false
"DISCOUNTER REDUCTIONS!!!!!"	true
"Discover VidScore!"	true
"Dish a la Dahlia's"	false [p]
"DiveNet: Evident!"	true []
"Doane's Anodes"	false []
"Doc Hume's Does-Much Ouch-Meds"	false
"Doc Tom Dot Com"	false
"Doc's Cult Cold Cuts"	false
"DocTime's Medics To Domestic"	false
"Dodie's Diodes"	false
"Dolinger-Reingold Older Gin"	false
"Dolinger's Soldering"	false
"Domestic Dime-Cost Doc-Items"	false []
"Don Leitner's Tenderloins"	false
"Done-Lame Lemonade"	false []
"Donuts by Bud Tony's"	false
"Dood Luc's Cool Duds"	false
"Door Dr. Rod Ord"	false
"Dorado's Odd Oars"	false
"Dori's Roids"	false
"DorstCo Doctors"	false
"Doss Sods"	false
"Doug Roush Sourdough"	false
"Downing, Wingdon [']N Godwin"	false
"Downscale Slow-Dance Decals Now!"	true
"Dr. Core's Records"	false
"Dr. Estes Dessert"	false
"Dr. Oven Vendor"	false
"Dr. Rose Orders Doser-R"	true
"Dr. Singer Grinders"	false
"Dr. Tice Credit"	false
"Drab is Bad, Sir. Baird's Braids!"	true
"Dredwic's Cwidders"	false
"Drees's Seders"	false
"Dry Alan's Lanyards"	false
"Duarte's True Ads"	false
"Dubinsky Kind Buys"	false
"DuCharme Cured Ham"	false
"Duds? BAM! Mad Bud's Dumb Ads"	true
"Duds By Buddy's"	false
"Duerst's Trussed Dusters"	false
"Dufner's Refunds"	false []
"DuFrein's: Friend Us, Find Sure Fun Rides!"	true
"Duggar's Drug-Gas"	false
"Dunegan Dunnage"	false
"Duo-Lab Lo-Baud"	false
"Dusenbury Underbuys"	false
"DuShane's Sunshade"	false
"Dust'd Off Odd Stuff"	false
"Duty Free Feed Yurt: True, Defy!"	true
"E-Sci-Dev Devices"	false
"E-Z-War Warez"	false
"Eagle U League"	false
"Eagleson Gasolene"	false
"Earl Blum's Uber-Small Umbrellas"	false
"Earl Hoke's Lake Shore Kosher Ale"	false
"Earl's Fake Leaf Rakes"	false
"Earl's Laser"	false
"EarnSol Loaners"	false
"Earwig Wirage"	false
"Easler Leaser Resale"	false []
"Eat Rod's Roasted!"	true
"Ebert's BESTER Berets"	false
"Eckart's Rackets"	false
"Ed Cain's Sad Nice Candies and Ices"	false
"Ed Lieb's Edibles"	false []
"Ed Short Red Hots"	false []
"Ed Stagg Gadgets"	false
"Ed Stone Denotes Needs to Set Done!"	true
"Ed West Stewed Tweeds"	false
"Ed Wye: Ye Wed, We Dye"	false
"Ed's Twig Widgets"	false
"Edgiest Tees. Dig!"	true
"Edmonds Oddsmen"	false
"Edsall Ladles"	false []
"Edwards Wadders"	false
"Eel-Hat, the Ale: ah, Leet!"	true
"Egleston's Leet Songs"	false
"Ego-Farm Fromage"	false
"Egoists['] Stogies"	false
"Egwin's Sewing"	false
"Eh, Debtor-Bothered? Bet-Horde!"	true
"Ehinger's Greenish Sheering"	false []
"Ehler St. Shelter"	false
"Elan-Shot Ethanols"	false
"Eleas Easel-Lease"	false []
"Elf Wine: Feel Win, New Life!"	true
"Eli Ott's Toilets"	false
"Elidia's Dailies"	false
"Ella Cheng's Challenges"	false
"Elrod's Solder"	false
"Elsa's Sales"	false
"Elva's Salve"	false []
"Em Heick Kimchee"	false
"Emert's Meters"	false
"An Empty Payment"	false []
"Enger Green-Regen"	true
"Engram's Mangers"	false
"Enos's Senso-Noses"	false
"Enstrom Mentors"	false
"Entsminger Resignment"	false
"Equitos: QUITE SO!"	true
"Erdahl's Heralds"	false
"Eric Gant Catering"	false
"Eric's Fun Nice Furs"	false
"Ericson Coiners"	false
"Ernest Tian Entertains Tenantries"	true
"Ernest VI: Nerviest? Reinvest!"	true
"Ernestina Tanneries"	false
"Esau Eaus"	false []
"Esberth Sherbet"	false
"Estala's Atlases"	false
"Estrich Richest Cithers"	false []
"Etc.-Tec"	false
"Etland Dental"	false
"Ettina's Tea Tins: In Taste It's Neat!"	true
"Ettinger's Resetting/Retesting"	false
"Eubanks's Sunbakes"	false
"Euro-Medal Remoulade"	false
"Eustis Tissue"	false
"Eutsler's Streusel"	false
"Evangelist Elevatings"	false
"Evaristo's Assortive Savoriest"	false
"Eve's Gig Veggies"	false
"Evelina's Vaseline"	false
"Everhart's Harvester"	false
"Evon's Ovens"	false
"Evrice's Ecrives Service"	false
"Ewart Water"	false
"Exasp-a-Spex"	false
"Excalibur: I-Be-LUX Car!"	true
"Experiment Re-Exemptin[']"	false
"Fab Ron's Brans of no Barfs"	false
"Faberge's Free Bags"	false
"Fae Ott's: To Feast of Taste: Eats Oft!"	true
"Faintest Fine Tats"	false
"Fake Rustic Fruitcakes"	false
"Fake-Vite: Take Five!"	true
"False-Obit Lifeboats"	false []
"Fan Moods? Man's Food!"	true
"Fancy Do of Candy"	false
"FartsCo Factors Far Cost! O, Crafts!"	true
"Fast Life Stiff Ale"	false
"Fast Paced Pat's Decaf"	false
"Fastbaker Breakfast"	false []
"Fat Frodo Afford-to-Fart Food"	false
"Fat Jai's Fajitas"	false
"Fat-O-Meal Meat Loaf"	false
"Faunists['] Fustians"	false
"Faustin's Fustians"	false []
"Fear Plot, Mr[fs]? Platformer[fs]!"	true
"Fechter's Fetchers"	false
"Feddersen Defenders"	false
"Feebler Elf Beer"	false
"Feel Wan? New Leaf!"	true
"Fehringer's: Refreshing!"	true
"Felecia's Calefies!"	true
"Fermat's RAM Fest"	false
"Ferrington Refronting"	false
"Fiesta-Race Cafeterias: Easier, Fact!"	true
"Fight Ops Gift Shop"	false
"Fillmore's Lore Films"	false
"FineOrg: No Grief!"	true
"Finer Cash Franchise"	false
"Fines St. Fitness INFESTS!"	true
"Finewood's Food & Wines"	false
"Finster's Snifters"	false
"Fischler Filchers"	false
"Fisher's is Fresh!"	true
"Flat Lee's Leaflets"	false
"Flattering Gift Rental"	false
"Fletson Teflons"	false
"Flo Goede Feel-Good Glee Food"	false
"Floranti's Flatirons"	false
"Florencia's Falconries"	false
"Fogel's Gels of Self-Go"	false
"The Food of Hot Ed"	false
"A Fool's Loofas"	false
"Footpads['] Apt Foods"	false
"Forbis Rosbif"	false
"Forensic Info-Recs"	false
"A Forge of Gear"	false
"Fouts So-Tuf Tofus"	false
"Fowler's Flowers"	false
"Fox Lake Fake Lox"	false
"Fran Tait's Fast-Train"	false
"Freelance Fencer Ale"	false
"Freiling Refiling"	false
"Fresh at Father's"	false
"Freund's Refunds"	false []
"Friere's Ferries"	false
"Frigman Farming"	false
"Frostwood Worst Food"	false
"Frugal Gal Fur"	false
"Frutansky Funky Arts"	false
"Fun Bart's Burns Fat (Barf TUNS!)"	true
"Fun-Fort Turnoff"	false
"Fungal-Unflag"	false
"Funk Dojo Junk Food"	false
"Furlham Rum: HALF Harmful!"	true
"Fuse-Act Faucets"	false
"G. Crosby Cyborgs"	false []
"G. Frei Grief-Refig"	false
"Gaal's Galas"	false
"Gabe Sand Bandages"	false
"Gail Thon's Thingolas"	false
"Gaiman's is MANGA!"	true
"Gamble! Be GLAM!"	true
"Gandhi's Shading"	false
"Garish Grisha Hi-Rags"	false
"Garlic-Soil Cigarillos"	false
"Garmenture Reargument"	false
"Garone's Oranges"	false
"Garoutte Tutorage"	false
"Garuti's Guitars"	false
"Gasometer Megastore"	false
"Gassert Stagers"	false
"Gasvale Salvage: LA, Vegas"	false
"Gatepost Pottages"	false
"Gaubert's Guest Bar"	false
"Gavin's Saving"	false
"Gawjiss Jigsaws"	false
"Gay Pools Pay Logos"	false
"Gayton's Nag Toys"	false
"Gearhead Headgear"	false
"Gecko Keg Co"	false
"Gencarelli's Allergenics"	false
"Gendreau's Dungarees"	false []
"Gennie's Engines"	false
"Gerlach's Schlager"	false
"Germain's Smearing"	false
"Gerri's Re-Rigs"	false
"Gerrity's Registry"	false
"GerryCo Grocery"	false []
"Gervais Gravies"	false []
"Gervase Greaves"	false
"Gervasi Gravies"	false []
"Gesualdi's Gladiuses"	false
"Get KASS Gaskets"	false
"Get-Lean: A Gentle, Elegant, Neat Gel"	false
"Get on GoNet!"	true
"Get Oscar's Escargots"	false
"Get Rad Ale: GREAT DEAL!"	true
"Get SAKS Gaskets!"	true
"Get Taube's Baguettes"	false
"Get Vint Vetting!"	true
"Geyserite Tiger-Eyes"	false
"Gia Vent Vintage: Get Vain!"	true
"Giannotti's Stationing"	false
"Gibson/Bogins Bingos"	false
"Gijer's Rejigs"	false
"Gil Matsko Goat's Milk"	false
"Gil's Nice Ceilings"	false
"Gilgath's Gaslight"	false
"GimpNest Pigments"	false
"Gingold Lodging"	false
"Gino's Clip Policings"	false
"Giselle Gellies"	false
"Glamour-Goal Rum"	false
"Glass Pen Spangles"	false
"Gleaton's Tangelos"	false
"Glinco's: CLOSING!"	true
"Glintier Retiling"	false
"Glum-Labs Gumballs"	false
"Go-Sprint Sporting"	false
"Go to Duff's: Good Stuff"	false
"Goblin St. Biltongs"	false
"God's-Lab Ad Blogs"	false
"Godinho Hood Gin"	false
"Godwin's Dowsing"	false
"Gold Cola? Good Call!"	true
"Golding's Lodgings"	false
"Goob's BOGOs"	false
"Goodwill's Wild Logos"	false
"Gord Fu's Drugs of Dog Furs"	false
"Gordon C.'s Corndogs"	false
"Gordon Facio Organic Food"	false
"Gorin's O-Rings"	false
"Gorsline-Olinger's Resoling"	false
"Gosman Mangos"	false
"Got new? Get now!!!!"	true
"Got-Plus Lug-Pots"	false
"Goths['] Inn: [']S Nothing!"	true
"Gotta love to ogle a TV!"	true
"Gowan's No-Swag Wagons"	false
"Grab Ian's Bargains!"	true
"Gracia's Agarics"	false
"Gracie's E-Cigars"	false
"Graefe's Serfage"	false
"Gramps Vine Revampings"	false
"Grandison Adornings"	false
"Granier's Earrings"	false
"Granieri's Reraising"	false
"Grannis Snaring"	false
"Grapevine Vegan Pier"	false
"Grauner's Rare Guns"	false
"Graydon Organdy"	false
"Greatest Rates-Get! Gee, Start!"	true
"GreenSci Generics"	false
"Greenwood's Newer Goods"	false []
"Greg Mota's Mortgages"	false
"Grierson Ignorers"	false
"Grigson Gorgins"	false
"Grimaldo's Marigolds"	false
"Grin-Wit Writing"	false []
"Gringo's Sin-Grog"	false
"Grishin Hirings"	false
"Groomsman Monograms"	false
"GrowTek: Get Work!"	true
"Grub Harem's Hamburgers"	false
"Gruber's Burgers"	false
"Gruden's Rug Dens"	false
"Grundy's Dry Guns"	false
"Gueremin Meringue"	false
"Guiton's Go-Units"	false []
"Gumpy's Gypsum"	false
"Gus Elem Legumes"	false
"Gus McNiff McGuffins"	false
"Gus Troy Go-Try-Us Yogurts"
"Guthounds['] Doughnuts"	false
"Guy Bass Buys Gas!"	true
"Gwen Idds Weddings"	false
"Gyro-Orgy"	false
"Haberland's Handlebars"	false
"Haggins Gashing"	false
"Halpern's Shrapnel"	false
"Hamlyn's Hymnals"	false
"Handy Wm Wyndham"	false
"Hansen Hennas"	false []
"Hardesty Hydrates!"	true []
"Haring's Garnish"	false
"Harrison Air Horns"	false
"Harwick's Rickshaw"	false
"Harwood's Road Show"	false
"Haselton Ethanols"	false []
"Hassinger Garnishes/Shearings"	false
"Hastert Hatters"	false
"Hastings Stashing"	false
"Hauk's Hakus"	false
"Hawtin's WIN Hats"	false
"HeapsCo: So Cheap!"	true
"Hebrew Mo's Homebrews"	false
"Hector's Torches & Troches"	false
"Heinous Uni-Hose"	false
"Heisler's Heirless Relishes"	false
"Hellenic Chenille"	false
"Helsing's Shingles"	false
"Hempiest Epithems"	false
"Henderson Nosher Den"	false
"Henry Gloop Nephrology/Phrenology"	false
"Hep Cats['] Patches"	false []
"Hep? No? PHENO-PHONE!"	true []
"Her Best Sherbet"	false []
"Herbalist Hair-Belts"	false
"Heuring's Ushering"	false
"Hi-Copes Hospice"	false
"Hi-Glare Hair Gel"	false []
"Higton's Thingos"	false
"Hilgdon's: Holdings Sold Nigh!"	true
"Hilgert's Slighter Lighters"	false
"Hip Cons Shop, Inc."	false []
"Hip Goths['] High Tops"	false
"A hipper happier paper. Hi!"	true
"Hiroads Hairdos"	false
"His Ready Hair Dyes Are Dishy!"	true
"Hislop Polish"	false
"HIT NOW! WIN! HOT!!!"	true
"HoboMart's Bathrooms"	false
"Holgerson's Long Horses"	false
"Holistic Chits Oil"	false
"Honig's Hosing"	false
"HoochCo, Ohh!"	true
"Hopkins Ink Shop"	false
"Hosman's Hansoms"	false
"Hot Duds Odd Huts"	false
"Hot? Jet in the Joint!"	true
"Hot-Presses Prostheses"	false
"Hsiu's Sushi"	false
"Huckstep Ketchups"	false
"Hula-Haul"	false
"I-Be-Foul Biofuel"	false
"I-Bouquet Boutique"	false
"I-Look-OK Oil"	false
"I Stake at Ike's!"	true
"I-Steal-It Sale!"	true
"I Trust Titus R.!"	true
"I Use Mr. I'm Sure!"	true
"I'm-Mo[']-Super Emporiums"	false
"Iannello Lanoline"	false []
"Ice-So-OK Cookies"	false
"Iced-Spite Pesticide"	false
"Icer Dome: Mediocre? Dire? Come! More Dice!"	true
"IdleCo's EcoLids"	false
"If Acne in Face: ECAFIN!"	true
"If ALE, a Life!"	true
"If-Stout Outfits"	false
"Ilich's Chilis"	false
"Ilse Kan's Seal Skin"	false
"Imbrogno Brooming"	false
"Inane Curs Insurance"	false
"IndustCo Conduits"	false []
"IndustCo Discount"	false []
"Ink by Binky"	false
"Instanter Transient Intranets"	false
"Insured UI Nerds!"	true
"Intellectual Null-Ice Latte"	false
"Inter-Local Citronella"	false
"Intriago Rigatoni"	false
"Ionic Prints Inscription"	false
"Irate-Face Cafeteria"	false
"Isaac Acais"	false
"Isenhart Hairnets"	false
"Isenhour's Nourishes"	false
"It's at Tait's!"	true
"Ittner's Retints"	false
"Ivie Garnett Integrative Vinaigrette"	false
"Jane's Jeans"	false
"Janey Bell's Jelly Beans"	false
"Jay Ross Soy Jars"	false
"JebstCo Objects"	false
"Jen Booth: on the Job!"	true
"Jillee's Jellies"	false
"Jim Klug's Milk Jugs"	false
"Joe Bond's Jobs DONE!"	true
"JoinStar Janitors"	false
"Jon's Web New Jobs"	false
"Joshi's Shojis"	false
"Joubert's True Jobs"	false
"Julio's Oil-Jus"	false
"Juniot's U-Joints"	false
"Kagmin's Masking Makings"	false
"Kalis Lasik"	false
"Kasebier Bakeries"	false
"Kate's Steak"	false
"Katy Cash's Haystacks"	false
"Kay Chen's Hackneys"	false
"Keitha's Shitake"	false
"Keniston's Inkstones"	false
"Kershaw Hawkers: We Shark!"	true
"Ketterman's Tentmakers"	false
"Kevin's Knives"	false
"Kick-Start Track-Kits"	false
"KidScape is PACKED!"	true
"Kiesel's Selkies"	false
"Kiko's Kiosk"	false
"Kilbane's Sinkable Blankies"	false
"Kim Loy's Soy Milk"	false
"Kimball's Silk Balm"	false
"Kimura's Rumakis"	false
"Kindfort's Soft Drink"	false
"Kindness Inn Desks"	false
"King Fear-Freak Gin"	false
"Kip's Cafe: Safe Pick!"	true
"Kishka Khakis"	false
"Kissler's: Risk Less!"	true
"Kit Sews Weskits!"	true
"Kittner's Trinkets"	false
"Klepac's Spackle"	false
"Klossner Snorkels"	false
"Koch's Shock Hocks"	false
"KonigCo Cooking"	false
"Korhonen's Nonkosher"	false
"KorTech: THE ROCK!"	true
"Kosar Okras"	false []
"Krewson Knowers"	false
"Kris Best Briskets"	false
"Kubik's Bikkus"	false
"Kumari Rumaki"	false
"La Niche Chilean"	false
"Laciest Elastic"	false
"Lacivita's Viaticals"	false
"Lacourse's Carousels"	false
"Lads['] [crap-u] Placards"	false
"Laffer's Raffles"	false
"Laforce's Alfresco Flares Co"	false
"Lambert's Rest Balm"	false
"Lame Host Mae Holt's Hot Meals"	false []
"Lammert's Trammels"	false
"Lankest Anklets"	false
"Lannister Internals"	false
"Lapser Pearls"	false
"Larber's Barrels"	false
"Lasco Colas"	false
"Lasseigne ensilages: agileness!"	true
"Lassiter Realists"	false
"Last Boy Toy Labs"	false
"Last Cue! Cut-Sale!"	true
"LastOnCo Coolants"	false
"Latham's Has Malt!"	true
"Laurice Wolf Cauliflower"	false
"Lauryn's Uranyls"	false
"Lavages Salvage"	false []
"LaVonda's Load-Vans"	false
"Le Apt Plate"	false []
"Le Cap Place"	false
"Le Seven-Elevens"	false
"Le Vest Svelte"	false
"Lea's Ales Sale"	false
"Leaphart's Asphalter"	false
"Leavitt's 'A' Vittles"	false
"Leavitt's Vile Tats"	false []
"Leaworthy Holy Water"	false
"LeDoux Delux-O"	false
"Lee Vries-Elsevier RELIEVES!"	true
"Legato's Gelatos"	false
"Legba's Bagels"	false []
"Lego-Bot Bootleg"	false
"Leibman's Bailsmen"	false
"Leighton's Hosteling"	false
"Leisinger Lingeries"	false
"LeMay's Measly Yealms"	false
"Len's Pic Pencils"	false
"Lenin's Linens"	false
"LensCare Cleanser"	false []
"Lequire's Reliques"	false
"Les Gray Argyles"	false
"Lesmeister Smelteries"	false
"Lesniak Alkines"	false
"Lesniak's Sealskin"	false
"LeSport Petrols"	false
"Let-Mesh Helmets"	false
"LetMeCo Telecom"	false
"Letta's Latest Lattes"	false
"Levechi's Vehicles"	false
"Levitan's Ventails"	false
"Levon's Novels"	false
"Lew Link's Inkwells"	false
"Lew's Lens Wellness"	false
"Lewey Jr. Jewelry"	false
"Ley's Lyes"	false
"Leyton's Soylent"	false
"Li'l Reg's Grilles"	false
"Li'l Stan's Installs"	false
"Li'l Stew's: It's Swell!"	true
"Lide's Delis: Sidle, Slide!"	true
"Life Coach/Cliche Oaf [if player is male]Leif Chaco[else]Felica Cho[end if]"	false
"Life Stinks? Niki Felts's Finest Silk"	true
"Lignum Vitae Time-Valuing Vitamin-Glue"	false
"Like-Fads Fake Lids"	false
"Limbert's Timbrels"	false
"Limbs-B-Slim"	false
"Linares Nailers"	false
"Lindauer's Laundries"	false
"Lindenberg Reblending"	false
"LinkPress Sprinkles"	false
"Lipman's Samplin[']"	false
"Literary Alert: Try It!"	true
"Little Girl's Ill Glitters"	false
"Liv Chee's Vehicles"	false
"Lo-Bust U-Bolts Sub-Lot"	false
"Lo-Caste Eco-Salt"	false
"Lo, cat! AltCo!"	true
"Lo, Get a Gelato!"	true
"Loaded Odd Ale"	false
"Loafers For Sale"	false
"Local Bros['] Robo-Calls"	false
"LoCastro Locators"	false
"Lockheed's Helo-Decks"	false
"Loco Lash Alcohols"	false
"Loco Men's Monocles"	false
"Lodestar Leotards"	false
"Lois Tisch Holistics"	false
"Lombardi's Drab Limos"	false
"Lon Ito No-Toil Lotion"	false
"Long Street Lorgnettes"	false
"Longfoot's Font Logos"	false
"Lonny's Nylons"	false
"Loo Iliff Lo-Fi Foil"	false []
"Loo's PROVEN Provolones"	false
"Loose Oleos"	false
"Lori Hass Hair Loss/Rash Oils"	false
"Lorini's Sirloin"	false
"Loss-Rift Florists"	false
"Lost? Rely: Ye Trolls['] Trolleys"	false
"Lotspeich Chipotles"	false
"Lottie's Toilets"	false []
"Lou's Farm Formulas"	false
"Louetta's Toluates"	false
"Lowbrow Bowl Row"	false
"Lu Regan's Lean Rugs"	false
"Luanna's Annuals"	false
"Lubeck's Buckles"	false
"Luca Omega Guacamole"	false
"Lunchtimes Munch Islet"	false
"Lusty Ranch Lunch Trays"	false
"Lyla Phipps Happy Pills"	false
"Lyman H.'s Hymnals"	false []
"Ma Blink's Lambskin"	false
"Ma Lucci's Accu-Slim"	false
"Ma Otto's Tomatos"	false
"Ma's Queer Marquees"	false
"Mac Bly's Cymbals"	false
"Mac's Scam-Cams"	false
"Macrae's Cameras"	false
"Maddie's Diadems"	false
"Maier's Armies"	false []
"Malbrough Rough Balm"	false
"Malia's Salami"	false
"Malisa's Salamis"	false
"Malthus Alt-Mush"	false
"Malvina's Mail Vans"	false
"Mama's Den Manmades"	false
"Man-I-Dare Marinade"	false
"MAN SPOT Tampons"	false
"Mangino's Masoning"	false
"Manliest Ailments? Salt-Mine Meal-Tins!"	true
"Marchese's Cashmeres"	false
"Marg Steel Telegrams"	false
"Margie's Imagers"	false
"Margolis Milagros"	false
"Marilyn's Slim Yarn"	false
"Marla's Alarms"	false
"Marsden Damners"	false
"Marsicano Macaronis"	false
"Mart Law's Raw Malts"	false
"Marv's VRAMs"	false
"Masoner Ransome"	false []
"Massimo Mimosas"	false
"Massingale Magnesials"	false
"Mastroianni Marinations"	false
"Match-Up Chum Pat"	false []
"Mathiesen Hematines"	false
"Matt's Jar Jam Tarts"	false
"Mattoon's Ottomans"	false
"Maurer's Armures"	false
"Maw's Real Malwares"	false
"Max Eick Cake Mix"	false
"McAlister Cartelism"	false
"McCauli Calcium"	false
"McDaniel's Medcinals"	false
"McGuire Rice Gum"	false
"McHeinus Nice Mush Munchies"	false
"Mclean's Encalms!"	true
"McNealy Clay Men"	false
"McPoot's Compost"	false
"Me-Bod: Be Mod, Bed Mo[']!"	true
"Meade's Edemas"	false
"Meals at Almeta's Tamales"	false
"Meat-Flip Flame Pit"	false
"Meatiest Teatimes"	false
"Medeiros Remedios"	false
"Meg Graf's Egg Farms"	false
"Meg's Gems"	false
"Meisner Ermines"	false
"Mel, Cal McLeal: Call [']Em!"	true
"Mel's Duo-Model-Us Modules"	false
"Mel's Faint Filaments"	false
"Melius Muesli"	false
"Meloni Moline Lo Mein"	false
"Melting Mint Gel"	false []
"Meltser's Smelters"	false
"Mentioner's Minsetrone"	false
"Mercantile-Mint Cereal"	false []
"Mesko's Smokes"	false
"Messiah Mashies"	false
"Meyerson Moneyers"	false
"Millage's Legalism"	false
"Milliken's Lime Kilns"	false
"MiltonCo Cool Mint"	false
"Minced Med'Cin"	false
"Minde's Denims"	false
"Minden Indemn-Mendin[']"	false
"Mine Camp Pemmican"	false
"Ming Acuff's Macguffins"	false
"Minty-Ade: Dynamite!"	true
"MiscCo Cosmic Comics"	false
"Mister C Metrics"	false
"Mitchell's Tech Mills"	false
"MixCo Comix"	false
"Modglin Molding"	false
"Moebius BioMuse"	false
"Moilanen's Minneolas"	false
"Mom Roush's Mushrooms"	false
"Mom's MMOs"	false
"Monstrous Sun Motors"	false [p]
"Moody's: Be Somebody!"	true
"More Acne? NEO-CREAM!"	true
"More-Gut Gourmet"	false
"Moreira's Armoires"	false
"Morissette Meteorists"	false
"Moser Bros.['] Sombreros"	false
"Moss Cute Costumes"	false
"Mount St. Muttons"	false
"Mouse's Mousse"	false
"Mr. Cha's Charms"	false
"Mr. Cub's Crumbs"	false
"Mr. Fatso's Fast Roms"	false
"Mr. Hume's Hummers"	false
"Mr. O's ROMs"	false
"Mr. Pave-Revamp"	false
"Mr. SoftCo Comforts"	false
"Mr. Up-Fee Perfume"	false
"Mr. US Rums"	false
"Mr. Vose, Ms. Rove, Movers"	false
"Mrs. Elli, Mr. Lisle: Millers"	false
"Mrs. Pape Pampers"	false
"Ms. Peal's Samples"	false
"Ms. Rowe Mowers"	false
"Muir Poem Emporium"	false
"Mum's Gear Rummages"	false
"Mum's Ripe Premiums"	false
"MunchLate Lunchmeat"	false
"Mundane Nun Mead"	false
"Munster's Sternums"	false
"Muraro Armour"	false
"Murton's Nostrum"	false
"MushCo: So Much!"	true
"Mushrooms So Sour, Hmm"	false []
"Musil's Simuls"	false
"Muston Mounts"	false
"Mute Al's Amulets"	false
"My Abs By Sam"	false
"My Car: Camry!"	true
"My Gift: Fit-Gym!"	true
"My Suit It's YUM"	false
"My Thing's Smyth Gin!"	true
"My Weight? White Gym!"	true
"Mysterious Emory Suits"	false
"Naggies Signage"	false
"Nakata's Katanas"	false
"Napoli's Oil Pans So Plain: No Pails!"	true
"Nashtier Hairnets"	false []
"Nat's Limp Implants"	false
"Natale's Sealant"	false
"Near edge? Renegade Green-Ade!"	false
"Near-Miss Seminars"	false
"NeatCo: Octane at Once!"	true
"Ned Barr's Rebrands"	false
"Neil's Liens"	false
"Nelson's Data Stands Alone!"	true
"Nemeth Menthe"	false
"Neurogenic Encoignure"	false
"Neustadt Dust-Neat"	false
"Nevski Knives"	false []
"New Age Awe-Gen"	false
"New-Eyes Sweeney"	false
"Ngoma's Mangos"	false []
"Niagra's Sangria"	false
"Nic Cave's Vaccines"	false []
"Nic Fay's is Fancy!"	true
"Nicastro's Croissant"	false
"Nice-Thing Ethnic Gin"	false
"Nice Zits, Citizens? Zinc-Ites!"	true
"Niceham's Machines"	false []
"Nicest-Day Candy Site Syndicate"	false
"Nichelle's Chenilles"	false
"Nicola's Oilcans"	false []
"Nik Grey's Key Rings"	false
"Nik, Wes: We Sink Skewin[']"	false
"Nik's Skin Inks"	false
"Nilsen-Enslin Linens"	false []
"Nip's Spin & Snip"	false
"Nitschke Kitchens"	false
"Nitzsche Chintzes"	false
"No date? Note ad! Do neat! Donate to Dean!"	true
"No-Daze Ad Zone"	false
"No-Glitch Clothing"	false
"No-Lard Roland Ladron"	true
"No-Logic Cool Gin"	false
"No-Sight Hosting"	false []
"No Thaws? Hawton's Snow Hat!"	true
"No-Wit Towin['] WON IT!"	true
"No zip? PONZI!!!"	true
"Noguchi's Hocusing"	false
"Nokes Kenos"	false
"Nola's Salon"	false
"The Nook Hot Keno"	false
"Nora's Sonar"	false
"Nu-Place CleanUp"	false
"Nuisancer Insurance"	false []
"NWOT Town"	false []
"O-Grade Do-Gear"	false
"O. Russert Trousers"	false
"O'Cain's Casino"	false []
"O'Leary's Real Soy"	false
"O'Riley Oilery"	false
"Odd-Goof Dog Food"	false
"Off the Pace? Hope-Affect Coffee: Phat!"	true
"Ogden's Sod-Gen"	false
"Oh, stop to shop!"	true
"Ohh, Pets: the Shop"	false
"OK-Kiss Kiosks"	false
"Ol['] Bo's Slob-O Bolos"	false
"Ol['] Chet's Clothes"	false
"Ol['] Ethan's Ethanols"	false []
"Ol['] Ian: a Lion, I Loan!"	true
"Ol['] Ruf's Flours"	false
"Old Dog's Odd Logs"	false
"Old Fool's LOL Foods"	false
"Old Omega's Good Meals"	false
"Oldmere's Remodels"	false []
"Ole Gina's Gasoline"	false
"Ole Japan's Jalapenos"	false
"Oleg's LEGOs"	false
"Olga Hu's Goulash"	false
"Olga Mohr's Holograms"	false []
"Olympus Slop, Yum: Plum, Soy!"	true
"Omar Reis Armories"	false
"One-Swap Weapons"	false
"Oompah's Shampoo"	false
"Ooz-Rich Chorizo"	false
"Opal-Jane's Jalapenos"	false []
"Ophi's: I Shop So Hip!"	true
"Optimum Opium (TM)"	false
"Opus Up-So Soup"	false
"Or Need Redone? Don Ree."	true
"OrbitCo's Robotics"	false
"Orca-Yurt Carry Out Oat Curry"	false
"Organic Grain Co"	false
"Orleans-Salerno Loaners"	false []
"Orrienti's Interiors"	false
"Ortega's Storage"	false
"Osaki is A-OK!"	true
"Oscoli Silo Co is Cool!"	true
"Osgard Do-Rags"	false
"Ospina Pianos"	false
"Osseter Stereos"	false []
"Osterkamp Top Makers"	false
"Osterman-Sarmento MAN STORE"	false
"Ostermann-Martenson Ornaments"	false
"Ostermeier Eriometers"	false
"Ostertag Garottes"	false
"Ouida Audio"	false
"Ouida's Audios"	false
"Our Brit's Burritos"	false
"Our Cute Cut-Euro Couture"	false
"Our Lad's Dour Sal!"	true
"Ovide's Videos"	false
"P Sawyer: We Spray/Swap yer Spyware!"	true
"Pa Krum's Markups"	false
"Pa Otto's Potatos"	false
"Pa Phelps Help Apps"	false
"Pa Reg's Grapes"	false
"Pa's Spa"	false
"Pacer St. Carpets"	false
"Paid Loss Disposal"	false
"Pain-Cost Captions"	false
"Painter's Pantries"	false []
"Palmerton Patrolmen"	false
"Pam Tell's Pet Malls"	false
"Pamila's Impalas"	false
"Panic St. Catnips"	false
"Paniccia's Capsaicin"	false
"Pappy's Spy App"	false
"Parrent's Partners"	false
"Parriott's Portraits"	false
"PartyCo's Crap Toys"	false
"Passero Soapers"	false
"Pasternak Partakens"	false
"Pat Fair's Parfaits"	false
"Pat Kelp's Pep Talks"	false
"Pat's Hot Top Hats"	false
"Pati's Pitas"	false
"Patterson Patentors"	false
"Paw/Mum's Wampums"	false
"Peaceful Cape Fuel"	false []
"Pecina's Inscape"	false
"Pedlar Lepard"	false
"Peete's Tepees"	false
"Peg Hiatt's Past-Eight Spaghetti"	false
"Peltzer's Pretzels"	false
"Pena's Panes"	false
"Penfold Flop Den"	false
"Peon Tim's Nepotism Pimentos"	false
"Pepi's Pipes"	false
"Pepito's Top Pies"	false
"Percival's Rave Clips"	false
"Perdue Pureed"	false
"Perkins's Skin-Resp"	false
"Perlin's Pilsner"	false
"Perreira's Repairers"	false
"Perretta's Pre-Treats"	false
"Perrin Street Interpreters"	false
"Persico Copiers"	false
"Persing Pingers"	false
"PertDais: Spread it Rapidest!"	true
"Pescador's Scorepads"	false
"Peshram Hampers"	false
"Pessard Spreads"	false
"Pest-Clean Pentacles"	false []
"Petrisa's Raspiest Pastries"	false
"Pettey's Typeset"	false
"Pettinger's Pre-Testing"	false
"Pfister's Pre-Sifts"	false
"Phat Rey P. Thayer Therapy"	false
"Phil Cote Chipotle"	false []
"Photos: Oh, Stop to Shop!"	true
"Pia's IPAs: A Sip?"	true
"Picard's Rad Pics"	false
"Pick Nat's Knit Caps!"	true
"A Pickled DeliPack @ KidPlace!"	true
"Pie/Salad Palisade"	false
"Pig-Heart Graphite"	false
"Piles-Ups Supplies is Supple!"	true
"Pill Marts Strip Mall"	false
"Pinegar Reaping"	false
"Pining Pig Inn"	false
"Pinot's: Stop in to Spin!"	true
"Pip Ferry Frippery"	false
"Pip Hong's Shopping"	false
"Pip Wang's Swapping"	false
"Pirani's Aspirin"	false
"Pisces Spices"	false
"Pithel's: it Helps the Lips!"	true
"Pitman's Stampin[']"	false
"A Pizza Piazza: no stopping on toppings!"	true
"Plain-Blots Ballpoints"	false
"Planets St. Test Plans"	false
"Plato's Postal"	false []
"Playsome Maypoles"	false
"Please Do Dale Poe's Dope Sale!"	true
"A Plebe Cot: Place to Be!"	true
"Pluck-O Lockup"	false
"Po['] Caleb's Placebos"	false
"Po['] Will's Pillows"	false
"Poe's Def Feed-Ops of Speed"	false
"Poignancy Canopying"	false
"Polaris RailOps"	false
"Polite Ole Pit Pie Lot"	false
"Pollinger Repolling"	false
"Pontiac's Captions"	false []
"Poop-o-Pop Cola is Social!"	true
"Pop Erik's Pork Pies"	false
"Pop Hawn's Pawn Shop"	false
"Pop Haynes Pay Phones"	false
"Pop Hull's Push Poll Pull Shop"	false
"Pop's Alt Laptops"	false
"Pop's Hot Top Shop"	false
"Pop's Opps"	false
"Pop's Rave-Approves"	false
"Pops Hull's Push Polls"	false
"Portia's Air Stop"	false
"Posh Tot Hot-Pots"	false
"Posies I S'Pose"	false
"Posture-Up Store"	false []
"PR Pa Rapp"	false
"Pram-Loft Platform"	false
"Prepaid ID Paper"	false
"President's Driest Pens"	false
"Price Club's Bicep Curls"	false
"Pricy Goth Copyright"	false
"Priestley's Peristyles"	false
"Prig Fanny's Frying Pans"	false
"Prim Sot Imports Is Top, Mr.!"	true
"ProTec's Copters"	false
"Protect-Tec Port"	false
"Proust's Sprouts"	false
"PSI ISP"	false
"Ptacek's Packets"	false
"Pulliam's Palliums"	false
"Pup-Ick Pick-Up"	false
"PureFem Perfume"	false []
"Purplish Hip-Slurp"	false
"Pursell Pullers"	false
"Quentin's Quinnets"	false
"Quero's Roques"	false
"Quito's Quoits"	false
"RaceSoft's Forecasts"	false
"Rackham's Chakrams"	false
"Racquel's Lacquers"	false
"RaderCo: Record a Rare Doc!"	true
"Rag-Bone Neo-Garb"	false
"Raimondo's Main Doors"	false
"Rain-Mist Martinis"	false
"Rainwater's Warranties"	false
"Rally-Rite Rarely-Lit Artillery"	false
"Ramaker's Earmarks"	false
"Rambini's Minibars"	false
"Rampley's Lampreys Samplery"	false
"Ramstad Mad Arts"	false
"Rapport's Art Props"	false
"Rapson Aprons"	false
"Rare-Lit Trailer"	false
"Rare-Rib Barrier"	false
"Raschke Hackers"	false
"Rasnic Cairns"	false []
"Rattiness, Tartiness"	false
"Ratto's Tats or Tarots"	false
"Raw-Spite Wiretaps"	false [**promote to regular idea?]
"Rawlings's Wrassling"	false
"Ray Blend Benadryl"	false
"Ray Lew, Lawyer"	false
"Ray Pew's Spyware"	false
"Raymon's Masonry"	false
"RealTec's Clearest Treacles"	false
"Reb Heet, the Beer: Be There!"	true
"Rebate Beater Art Bee"	true
"Rebier's Berries"	false
"Rebuildy Bud Riley"	false
"Recursions Co-Insurers"	false
"Red Bay Bad Rye"	false []
"Red Machine's Merchandise"	false
"Red Oafs['] Fedoras"	false
"Redleaf Federal"	false
"Reebok OK Beer"	false
"Reeknose Kerosene"	false
"Reiber's Berries"	false []
"Reid's Rides"	false
"Reingold's Soldering"	false []
"Reisz's Sizers"	false
"Reitman's Raiments"	false
"Reliable Lee Blair"	false
"Rema Rios Armoires"	false []
"Remington Mentoring"	false
"Ren Slick Clinkers"	false
"Renetta's Entreats"	false
"Rep. Gross: PROGRESS!"	true
"Resiny Sin-Rye"	false
"Resmoothed Hodometers"	false
"ReSnubCo Bouncers"	false
"Retta's Taters"	false
"Rev. Erv"	false
"Rex's RXes"	false
"Rey's Rug Surgery"	false
"Reyes Eyers"	false
"Rhett Inge Tightener Tethering"	false
"Rhoda's Hoards"	false
"Rhodus's Shrouds"	false
"Rhoney's Noshery"	false
"Rich Best Britches"	false
"Rich Sod Orchids"	false
"Richeson Chorines"	false
"Riedel Lieder"	false
"Rierson Ironers"	false
"Rife Re-Fi"	true
"Rifkin's Firkins"	false
"Ringstad Tradings"	false
"Rioch's So-Rich Choirs"	false
"Ritson Nitros"	false
"Rob Lew's Bowlers"	false
"Robotham's Bathrooms"	false []
"Robur's Burros"	false
"Rod Gump's Gumdrops"	false
"Roddis Droids"	false
"Roden's Drones"	false []
"Roderick's Rock Rides"	false
"Roger's Reorgs"	false
"Rolling-On Grill"	false
"Rome Clan Corn Meal"	false
"Ron Copp Popcorn Op-N-Proc"	false
"Roper St. Porters"	false
"Rosa Lang Granolas"	false
"Rose Gupta Great Soup"	false
"Ross Belt Lobsters"	false []
"Ross Tye Oysters"	false
"Rosy-Set Oysters"	false []
"Rote Fun Fortune"	false []
"Roundtree's Outrenders"	false
"Roussette's Tutoresses"	false
"Rousting Tourings"	false
"Rullo/Ruoff Flour"	false
"Rummager Margerum"	false
"Rumstad Mustard"	false
"Ruscanti Curtains"	false []
"Russ Fulop Surplus of Plus Fours"	false
"Russet's Trusses"	false
"Rust-O-Roust Tours"	false
"The Rust Shutter"	false
"Ruthie's New Wiener Huts"	false
"Rutner's Returns"	false
"SaberDoc Barcodes"	false []
"Sabic's Basics"	false
"Sabino Bonsai"	false
"Sabo Boas"	false
"Sad Al's Salads"	false
"Saeger's Greases"	false
"Safe-Cut Faucets"	false
"Sager Gears"	false
"Saggare Garages"	false
"Sal Cort Car Lots"	false
"Sal Grey Argyles"	false []
"Sal Hess Has Less Hassles!"	true
"Sal Inge Gasline Sealing"	false []
"Salveig Glaives"	false
"Sam Funke Makes Fun Fake Nums!"	true
"Samaroo's Amorosas"	false
"Samson Masons"	false []
"Sandoval Vanloads O'Vandals"	false [] []
"Santa Fe Fan Eats"	false
"Santa Fe's Safe Tans"	false
"Santillo Stallion Allotins"	false
"Santillo's Stallions"	false
"Sapp Apps"	false
"Saputo's: Pass OUT!"	true
"Sara Long Granolas"	false
"Saracino Ocarinas"	false
"Sarah's Odd Hard Sodas"	false
"Sarge Franc Fragrances"	false
"Sastre Tasers"	false []
"Sato Oats"	false []
"Saunders Danseurs"	false
"Savaric Caviars"	false
"Savile's Valises"	false []
"Saw-Vine Weavins"	false
"Say, Bud, Sad? BUY!"	true
"Scag Peak Packages"	false
"Scalisi Silicas"	false
"Scanter Nectars"	false
"Scarantino Carnations"	false
"Scaturro Curators"	false
"Scavenger Green-Vacs"	false
"Scavenger Reg Vance's"	false
"Scavenger Van Creeg's"	false []
"Scheirer-Riechers Cherries"	false
"Schiavone Anchovies"	false
"Schomer Chromes"	false
"Schubert Butchers"	false
"Sci-Vault Victuals"	false
"Scofield Doc-Files"	false
"Scooter Store Co"	false
"Scooter StoreCo"	false []
"Scooting-Go Tonics"	false
"Scorpion PrisonCo"	false
"Scout-Pile Poultices"	false
"Screen-Free References"	false
"Scudder's Duds Recs"	false
"Sea-Bulb Baubles"	false []
"Seabird Darbies"	false []
"Seagull Ale-Slug"	false
"Seagull-Slug Ale"	false []
"Sean Boy's Soybeans"	false
"Seattle Lattees: Le Taste!" 	true []
"Seaward Adwares"	false
"Sedgwick Wigs Deck"	false
"Seed-Mart Red Meats"	false
"Seedmen Demesne"	false
"Seegerd Degrees"	false
"Segel Food Feels Good!"	true
"Segui's Guises"	false
"Seifried's Firesides"	false
"Seitz: It's E-Z!"	true
"Selfridge Dregs-Life"	false
"Selfridge Fried Legs"	false
"Seligman Mealings"	false
"Selkind Kindles"	false []
"Selkirk Likkers"	false
"Selvio-Voiles Olives"	false
"Seneca's Seances"	false
"The Senor Seth Reno: There's No Honester!"	true
"Serif Fries"	false
"Serpentries Enterprises"	false
"Serpico Copiers"	false []
"Seward Waders"	false
"Sewer Br. Brewers"	false []
"Shagband Handbags"	false []
"Shamon's Hansoms"	false [] []
"Shamrock OK Charms"	false
"Shapiro Airshop"	false []
"Sharee's Hearses"	false
"Sharpest Hat Press"	false
"Shawnda's Handsaws"	false
"Shay's Art Ashtrays"	false
"Shem Kalski Milkshakes"	false
"Shenita's Anthesis Shanties"	false
"Sheridan Ad Shrine: Yer Ad Ready!"	true
"Sherman Dice Merchandise"	false
"Shetter Tethers"	false
"Shilling Hill Gins"	false
"Shoes So She"	false
"Shop at Potash: Ah, Tops! So Phat!"	true
"Shop-O-Hoops"	false
"Shop-Rite Trophies"	false
"Shoreman Menorahs"	false
"ShortCo Cohorts"	false
"Show-M-Beer Homebrews"	false []
"Shui's Sushi"	false []
"Shula Hauls"	false
"Shy Moe's: My Shoes!"	true
"Si Cubit's Biscuits"	false
"Sick Goon Cookings"	false
"Sicko Hater Artichokes"	false
"Sign Up! Ed's Dispunges Pudginess!"	true
"Signature Great Unis"	false []
"Signeur Guerin's Reusing"	false
"Signor Ringo's"	false []
"Silbernagel Relabelings"	false
"Silken-April Painkillers"	false
"Simcox's Comix"	false
"Siminski Miniskis"	false
"Simona Amnios"	false
"Sin-Bred Binders"	false
"Sin-Cut Tunics"	false
"Sin-Pact Catnips"	false []
"Sincere Seer, Inc"	false
"Sinegal's Gainless Leasings"	false
"Singler's Ringless Slingers"	false
"Sink Doc Dickson-Dockins"	false
"Sir Beef's Frisbees"	false
"Sir Hawk's Rikshaws"	false
"Sir Ian's Raisins"	false
"Sir Manic Mini-Cars"	false
"Sir-or-Mr. Mirrors"	false
"Sir Pain Aspirin"	false []
"Sir Thunder's Undershirts"	false
"Sir Turbo Burritos Ur-Bistro"	false []
"Sistare's Assister"	false
"Sitek Tikes['] Kites"	false
"Six Flags Glass-Fix"	false
"Six-Lire Elixirs"	false
"Skeeter's Keesters"	false
"Skeptics pick TESS!"	true
"Skin Doc Dickson"	false []
"Skipper Kippers"	false
"Skit Kits"	false
"Skrbic Bricks"	false
"Slam Dunk Land Musk"	false
"Slates's Tassels"	false
"Slaymaker Malarkeys"	false
"Sleeman Enamels"	false
"Sleep City: Epic Style!"	true
"Slick-Taco Cocktails"	false
"Slick Thom, Locksmith"	false
"Slick-Tips Lipsticks"	false
"Slim-Flax Fills Max!"	true
"Sloan Loans Salon"	false []
"Slob-Champ Lambchops"	false
"SlopArt Plastro-Portals"	false
"Sly Pup Pulpy's Supply"	false
"Sly's Beam Assembly"	false
"Smart Marts"	false
"Smart Pill Mall Strip"	false
"Smedley Medleys"	false
"Smolenski Moleskins"	false
"Smoothback Matchbooks"	false
"SniffCo Coffins"	false
"Snowberger Wrong Beers"	false
"Snowpea Weapons"	false []
"So-Cheap Poaches: Ace Shop!"	false
"So-Local Cool Al's"	false
"So-Low Wools"	false
"So Unfed? No-Feuds Fondues!"	true
"So-Urgent Gun Store"	false []
"Soapy Spa, Yo--So Pay!"	true []
"Sobol Bolos"	false []
"SoCal Colas"	false [] []
"Socko Cooks"	false
"Socrates Coasters"	false []
"Soft Sal Salts of Fat Loss"	false
"Softo Fotos"	false
"Sokol Looks Skool"	false
"Solis Silos"	false
"Some-Pains Noise Amps"	false
"Somers-Morse's S'Mores"	false [p]
"Sontag Tangos"	false
"Sorghum-Gro Mush"	false
"Sot Herb Borseth BOTHERS!"	true
"SotCo Scoot-O-Cots"	false
"Sourvine's Souvenirs"	false []
"The Space: Cheapest Tech Apse"	false
"SpamCo: So Camp!"	true
"Spangler Grapnels"	false
"Spankin['] Napkins"	false
"Sparty Pastry"	false
"Spas O['] Soaps"	false
"Spazzi Pizzas"	false
"Speiser's Pressies"	false
"Spetzler Pretzels"	false []
"Spice-Tides Pesticides/Septicides"	false
"Spite St. Pie"	false
"Spitzer's Spritzes"	false
"Spoon-It Potions"	false
"Sportman Portman's"	false
"Sprier Priers"	false
"Springsteen Presentings"	false
"Sprint-Prints"	false
"Spruce-It Pictures"	false
"Spud Loco Cold Soup"	false
"Square-Deal Resale Quad"	false
"Ssh-Ware Washers"	false
"St. Egan Agents"	false
"St. James Jetsams"	false
"St. Nico Not-Sci Scinto-Tonics"	false
"St. Pam's Stamps"	false
"St. Roj or J.T.'s Jorts"	false
"Staap Tapas/Pasta"	false
"Stagle Aglets"	false
"Stale-Munch Lunch Meats"	false
"Stampney Payments"	false
"Stanfield Inflateds"	false
"Stanhope Phaetons"	false
"Stapleton Talent Ops"	false
"StarrCo Carrots"	false
"Staub Tubas"	false
"Steadham's Mastheads"	false
"Stedwig Widgets"	false []
"Steeley Eyelets"	false
"Stef Hamer Fresh Meat"	false
"Stef's Fests"	false
"Stefan's Fastens Fatness"	false
"Stefni's Fitness"	false
"Steinbecher's Nice Sherbets"	false
"Steinert's Insetters"	false
"Stella's Sallets"	false
"Stelma Metals"	false
"Stelzer-Setzler Seltzer"	false
"Stelzer's Seltzers"	false
"Stenger Regents"	false
"Stepter's Pretests"	false
"Stevo's Stoves"	false
"Stew Tree Tweeters"	false
"Stillinger Trellising"	false
"Stillwagon Tallowings"	false
"Stinkford's Soft Drinks"	false
"Stir Thy Thirsty"	false
"Stiverson Investors"	false
"Sto['] G Gots Togs!"	true
"Stockinger Rocketings"	false
"Stohler's Hostlers"	false
"Stony Cedar/Nerdy Coast Candy Store"	false
"Storable Bloaters"	false
"Stoudemire Udometries"	false
"Strachan's Trash Cans"	false
"Streed's Dessert"	false []
"Stressed? Desserts!"	true
"Striating Attirings"	false
"Studio B OUTBIDS!"	true
"Sturgeon Rust-Gone"	false []
"Su Brant Rust-Ban Turbans"	false
"Su-prise! Priuses is Super!"	true
"Su's Bad Bus Ads"	false
"Su's Prep-Suppers"	false
"Suarez Azures"	false
"Sue and Duane's Sundae"	false
"Sue Lipps Supplies"	false
"Sue Profitt Top Fustier Petit Fours"	false
"Sulaiman Aluminas"	false
"Sultry-Hope Upholstery"	false
"Sum-Lab Albums"	false
"Sumlin's Muslins"	false
"Sun Co-Op Coupons"	false
"SunPro Prunos"	false
"Super Big Grub/Pies"	false
"Super-Chow: Such Power!"	true
"Super-E Purees: Peruse!"	true
"Super-Vid Drive-Ups"	false
"Superbly Spry Lube"	false
"Superstar User Parts"	false
"SureCity Security"	false
"Surf Furs"	false
"Surname Manures"	false
"Susana Saunas"	false
"Suze Chan Szechuan"	false []
"Svet's Vests"	false
"Swarts Straws"	false
"Swensen Newness"	false
"Swenson: NOWNESS!"	true
"Swindle Weldins[']"	false
"Swine Sinew Wines"	false
"Swing-All Wallings"	false
"Swoboda's Basswood"	false
"Syed Edy's Dyes"	false
"Synthetic Itchy Nets"	false
"Tabitha's Habitats"	false
"Tacos Inn: Contains No Actins!"	true
"Talley's LA Style"	false []
"Tanaka's Katanas"	false [] []
"Tapani's Pinatas"	false
"TarverCo Cover Art"	false
"Tas-T-Tats"	false
"Taste by Beatty's"	false
"Tastier/Iratest Artiste Attires"	false
"Tat by Byatt"	false
"Tats by Batty's"	false
"Tats STAT!"	true
"Tawnier Tinware"	false
"TaxesCo: So Exact!"	true
"Tayler-Artley Realty"	false
"Tea Park: Partake!"	true
"Tea Scribe Beatrice's"	false
"Tea's Up in Petunia's!"	true
"Tech-Sol Clothes"	false []
"Ted Blan Belt and Dent Lab"	false
"Ted's Gag Gadgets"	false []
"TeensyNet: Yes!"	true []
"Telma's Metals"	false
"Temporal Metal Pro [if player is male]Tom Pearl[else]Pam Toler[end if]"	false
"TendsUmCo Documents"	false
"Tenisha's Shanties"	false []
"Teschner Trenches"	false []
"Tesla's Steals"	false [] []
"Tessman Stamens"	false
"Tex Rapp Tax Prep"	false
"Thaler's Slather-Lathers"	false
"ThemesCo: Some Tech to Scheme"	false
"Thielbar's Herbalist"	false []
"ThingCo's Hint Cogs"	false
"Thirsty? Try this!"	true
"This Bag: Big Hats!"	true
"Thoop's: Oh, Stop to Shop!"	true
"Tiger-Man's Mean Grits"	false []
"Time/Place Elite Camp"	false
"Tingly's Styling"	false
"Tired? Zoom! Tom Dozier Motorized!"	true
"TiredCo's Cot Rides"	false
"To Fix it: FOX!"	true
"To Score: Cooter's StoreCo!"	true
"Tobie's So-Be-It Boites"	false []
"Tofu's so TUF!"	true []
"ToilCo: Loci to Cool It!"	true
"Tolstoy Tool Sty"	false
"Tolstoy's Toys Lots"	false
"Tom Lee's Omelets."	false
"Tom's Gag Maggots"	false
"Tomkin's OK Mints"	false
"Tonita's Station"	false
"Tony-Shape Pantyhose"	false
"Too Happy Pay Photo"	false
"Tootles's Toolsets"	false
"Top-Cert-Protect"	false []
"Top-Loan Platoon"	false
"Top opt: Pop Ott!"	true
"Top Secure Pet Source"	false
"TopNet: Potent!"	true
"Tops Car Parts Co"	false
"Torre Retro"	false
"Torres's Resorts"	false
"Tortorelli's Rototillers"	false
"Tosca Coats"	false []
"Tot-Gro Grotto"	false []
"Totem Inn Ointment"	false
"Touhy Youth"	false
"Toy Lords['] Dry Tools"	false
"Traci Shu Haircuts"	false
"Trades at Red's"	false
"TransCo Cartons"	false
"Traverse-Averters"	false
"Treater Retreat"	false
"Treatin['] Nattier"	false
"TreeGen's Greenest!"	true
"Trey's Tyres"	false
"Tricia's Iatrics"	false
"Trig's Grits/Grist"	false
"TriMax MixArt Matrix"	false
"Trino's No-Stir Storin[']"	false []
"Trish's Shirts"	false
"A Trite Attire: I Treat!"	true
"Tropic Trip Co"	false
"TroveCo: To Cover or Covet!"	true
"TruBet Butter"	false
"TrueCo: Rec Out Our Tec to Cure!"	true
"TrueCom's: More Cuts, Customer!!!"	true
"TruGo Grout"	false
"Truly Good Old Yogurt"	false
"Trupiano's Rainspout"	false
"Trust-O Tutors"	false
"Try Eliot Toiletry!"	true
"Try Pa's Pastry!"	true
"Try Pat's Party St.!"	true
"Try Rif's Stir-Fry!"	true
"Tsao/Sato Oats"	false []
"Tuan Tuna"	false
"Tuckahoe's Tack House"	false
"Tucker Tek-Cru"	false
"Turano Naruto"	false
"Twin Peaks Weak Pints"	false
"Twin Pigs Wing Tips"	false
"Ty Rose's Oysters"	false []
"Ty Sato's: Tots Say So Tasty!"	true []
"Ty Tao's: O, Tasty to Stay!"	true
"Ty's Good Dog Toys"	false
"Typographic Pictography"	false
"U-Go-Try Yogurt"	false
"U-Got-Yr Grouty Yogurt"	false []
"U. Sanchez Szechuan"	false []
"U-Save Suave"	false
"Uby's: Busy Buys BY US!!!!"	true
"Ug's Rad Guards"	false []
"Ult-Sav Vaults"	false
"UltCo = CLOUT!"	true []
"UltCorps Plus ROTC Sculptor"	false
"Ultimate Multi-Tea"	false
"Ultra-Fine Train Fuel"	false []
"Un-Brite Tribune"	false
"Un-Deffest? Need STUFF!"	true
"UnitCo: I Count!"	true
"Unity Shoe Tiny House"	false
"Up-So Soup"	false
"Upcast Pa Cust Catsup"	false
"Upcaste Teacups"	false
"Upsner Prunes"	false
"Urpy's Syrup"	false
"Us-Angry Ray Guns"	false
"Us, Preach? Purchase Reach-Ups!"	true
"Us-Turbo TourBus"	false
"Us-Vape: Save Up!"	true
"Use Gin, Genius!"	true
"UsMenCo: CONSUME!"	true
"Utech's Chutes"	false
"Utter Schlock Clothes Truck"	false
"VanOrden's Drone Navs"	false
"Vasser Savers"	false
"Vegas Beer Beverages"	false
"Ventura TrueNav"	false
"Vesta's Staves"	false
"Vibrant Vit-Bran"	false
"Victoria TriviaCo"	false
"Vidmaster Trev Midas"	false
"Villacorta's Vacillators"	false
"Vin Dee's Endives"	false
"Vin Mani's Minivans"	false
"VineGen Nine-Veg Evening!"	true
"Vito's Tivos"	false
"Voeller's Oversell"	false
"Vogel's Gloves"	false
"Vonnie's Venison on Vines"	false
"Voorhees's Overshoes"	false
"Vote Art to Avert!"	true
"Vote for Rev. Foot!"	true
"Vote Sol to Solve!"	true
"Vy's Sure Surveys"	false
"Wal-Mart Raw Malt"	false
"Wallaby Ballway"	false
"Walsh's Shawls"	false
"Wang's Gnaws"	false
"Warm-Voices Microwaves"	false
"Warnecke Neckwear"	false
"Wary-Peon Weaponry: REPAY NOW!"	true
"Way-Wiser Wireways"	false
"We trust Stu Wert!"	true
"Wearying? GRAY WINE!"	true
"Wechsler Welchers"	false
"Weidner Red Wine"	false
"Weigand Windage"	false
"Weird Tom's Worm Diets"	false []
"Wendi's New IDs"	false
"Weninger Renewing"	false
"Wes Roof Woofers"	false
"Wesserman Menswears"	false
"Westering's Tree Swings"	false
"Westgate's Sweet Tags"	false
"Westin Twines: it's New"	false
"What's-On-Now Hats"	false
"Wignall Walling"	false
"Win-Big Wig Bin"	false
"Winberg Brewing"	false
"Winnings in Gwinn's."	false
"Wm. Flair Law Firm"	false
"Wogan's Wagons"	false []
"Wohlberg's Glow-Herbs"	false
"Wollam's Mallows"	false
"Wolters Low-Rest Trowels"	false
"Wong's Gowns"	false
"Wood Farm's Warm Foods"	false
"Wormscribe Microbrews"	false
"Worst Gin: It's WRONG!"	true
"Wreathing Nightwear"	false
"Wronski Workins[']"	false
"X. Brasco Boxcars"	false []
"Yaeko's Kayoes"	false
"Yahnke's Hankeys"	false
"Yarwood's Doorways"	false
"Yawpers['] Spyware"	false []
"Ye Fast Safety"	false
"Ye Rustic Security"	false []
"Yeats Yeast"	false
"Yenter's Styrene"	false []
"Yeo's Gum: Some Guy Goes Yum!"	true []
"YES With Whitey's!"	true
"Yesterday's Dessert: Yay!"	true
"Yo, Curst? Scry Out YurtsCo!"	true
"Yo['] Ma's Mayos"	false
"Yong Gyno"	false
"Yost Toys"	false
"You're Stuck? Sky Couture!"	true
"Your Pets['] Super Toy"	false
"Yr. Avg Gravy"	false
"Yucatan Cay Tuna"	false
"Yukster Turkeys"	false
"Zambino's Zambonis"	false
"Zanghi Hazing"	false

table of bad rappers [xxm2]
blurb
"[d-word-u] Crews Mcandrews"
"[d-word-u] Earl Alderman"
"[d-word-u] Ed Madden"
"[d-word-u] Erick Dickerman"
"[d-word-u] Esta Steadman"
"[d-word-u] Gia Madigan"
"[d-word-u] Hellen Mendenhall"
"[d-word-u] Ira Miranda" []
"[d-word-u] Karl Markland"
"[d-word-u] Lea Adelman"
"[d-word-u] Leah Haldeman"
"[d-word-u] Lee Edelman"
"[d-word-u] Lita Maitland"
"[d-word-u] Lore Moreland"
"[d-word-u] Man Dammann"
"[d-word-u] Neil Lindeman"
"[d-word-u] Rae Dearman"
"[d-word-u] Ray Maynard"
"[d-word-u] Rhea Hardeman"
"[d-word-u] Roe Medrano-Dameron" []
"[d-word-u] Ron Normand-Nordman"
"[d-word-u] Ronni Normandin"
"[d-word-u] Roy Raymond" []
"[d-word-u] Zoe Mendoza"
"Agile Slur Guerillas"
"All Time Ill Mate Tim Leal"
"Art Sopp, Rap's Top Pop Star"
"Artsome Maestro Moe Rast"
"Autotuned Tout Duane"
"Be-Crunk Buckner"
"Be-Down Bowden"
"Beatboxin['] Benito Bax"
"Big-Chains Inga Bisch"
"Big-Nuts Stu Bing"
"Blind Hater Hildebrant"
"Bongo-B-Goon"
"Bottom Tot Mob"
"Bragging Brig Gang"
"Brilliant Illin['] Bart"
"Busta Staub"
"Calm MC Al"
"Chief at Hit Cafe"
"Chill Arie Chiarelli"
"Chill Em Michell"
"Chill Mei Michelli"
"Chill Rupe Cullipher"
"Chill Shane Chisenhall"
"Chill Singer Schillinger"
"Chilla Cahill"
"Chiller Li'l Cher"
"Chillun['] Nic Hull"
"Clans So No-Class"
"Club Ripe Republic"
"Cold Loc'd Clod Doc L"
"Comped Dope MC"
"Complete Poet Clem"
"Cra-Z-Czar Zac R"
"Criswell Ills Crew"
"Darin['] Alec Cardinale"
"Darin['] Cal Cardinal" []
"Darin['] Ceola Candelario"
"Darin['] Elsa Saldierna"
"Darin['] Geri Gardinier"
"Darin['] Guy Guinyard"
"Darin['] Laci Cardinali"
"Darin['] Leo Andreoli"
"Darin['] Les Sindelar"
"Darin['] Li Rinaldi"
"Darin['] Lue Lindauer"
"Darin['] Ma Miranda" []
"Darin['] Mona Mandarino"
"Darin['] Noe Orendain"
"Darin['] Song Grandison" []
"Darin['] Ted Trindade"
"Darin['] Telma Martindale"
"Darin['] Tomi DiMartino"
"Darin['] Velvet Vandervliet"
"Darin['] Zelma Almendariz"
"Darin['] Zoe Darienzo"
"Def Agnus Fagundes"
"Def Arlen Freeland"
"Def Blain Banfield"
"Def Blair Barfield"
"Def Brock Beckford"
"Def Callie Lacefield"
"Def Caron Defranco"
"Def Corie Federico"
"Def Cory Fordyce"
"Def Dry Freddy"
"Def Fishel Sheffield"
"Def Grisel Selfridge"
"Def Hilda Hadfield"
"Def Lon Folden"
"Def Lord Ledford"
"Def Lorri Reliford"
"Def Lucia Caufield"
"Def Maren Freedman"
"Def Mirna Friedman-Manfredi" []
"Def Nasir Sandifer"
"Def Neil Fielden"
"Def Norah Forehand"
"Def Nurse Dufresne"
"Def Oglin['] Feingold"
"Def Ogre DeForge"
"Def Olin Delfino"
"Def Reginald Dangerfield"
"Def Rod Deford"
"Def Ronna Fernando"
"Def Sanner Fernandes"
"Def Seaton Destefano"
"Def Terisa Defreitas"
"Def Tones Ed Sefton"
"Def Wilborn Brownfield"
"Dis-Well Sidwell"
"Disowned Odd Swine"
"DJ [n-t] Tjaden"
"DJ Amee Majeed"
"DJ Aron Jordan" []
"DJ Astor Jorstad"
"DJ Cesena Cendejas"
"DJ Erminia Demirjian"
"DJ Eva Javed"
"DJ Geno DeJong"
"DJ Iva Javid"
"DJ Lorah Jordahl"
"DJ Louie DeJulio"
"DJ Mae Madej"
"DJ Rae Jared"
"DJ Ree Jerde"
"DJ Reina Jardine"
"DJ Renetta DeJarnett"
"DJ Rina Jardin-Jindra"
"DJ Shona Dosanjh"
"DJ Stan Bro Bjornstad"
"Dogs So G'd"
"Dope Al Depalo"
"Dope Arn Peardon"
"Dope Bay Peabody"
"Dope Cari Preciado-Decaprio"
"Dope Ian Peinado"
"Dope Lavern Vanderpoel"
"Dope Lin Delpino"
"Dope Lina DeNapoli"
"Dope Lisa DePaolis"
"Dope Lon Polendo"
"Dope Lori Polidore"
"Dope Mark Komperda"
"Dope Mars Sampedro"
"Dope Merri Pridemore"
"Dope Nat Patnode-Daponte"
"Dope Nilsa Espindola"
"Dope Ros Pedroso"
"Dope Skiver Doverspike"
"Dope Slavin Valdespino"
"Dope Teri Depietro"
"Dope Ula DePaulo"
"Dopeness Den Posse"
"Down Al Waldon"
"Down Aldo Woodland"
"Down Ed Dowden"
"Down Gil Dowling"
"Down Hal Howland"
"Down Rik Dworkin"
"Dr. Yo It's So Dirty"
"Droppin['] Pip Dorn"
"Dub's Buds"
"Dukes of KO Feuds"
"Eliot Hogg the Gigolo"
"Fab Boy Bob Fay"
"Fallen Ira Farinella"
"Fallen Iva Villafane"
"Fallen Tiger Lingafelter"
"Festive Set Five" []
"Finally-Fly Lani"
"Flashy Fly Ash"
"Fly Arie Frailey"
"Fly Debi Byfield"
"Fly Delia Layfield"
"Fly Dina Findlay"
"Fly Eden Fendley"
"Fly Enid Findley"
"Fly Fae Laffey"
"Fly Hater Flaherty"
"Fly Ian Finlay"
"Fly Madie Mayfield"
"Fly Peer Pelfrey"
"Fly Rae Farley" []
"Fly Rana Flanary"
"Fly Reid Fridley"
"Fly Rena Flanery"
"Fly Renna Flannery"
"Fly Ware Frawley"
"Frankly Fly Rank"
"Freakin['] Frankie"
"Fresh Eli Fleisher"
"Fresh Eric Schriefer"
"Fresh Hilda Harshfield"
"Fresh Tilda Hartsfield"
"Gala Lord Gallardo"
"Gangster G-Strange"
"Gankee Keegan"
"Gnawing Gang, Win"
"Grim Rebel Milberger"
"Grinder Derrin G"
"Grounded Drug-O Ned"
"Gyrant Gantry"
"Hard Bub Hubbard"
"Hater Chum Hutmacher"
"Hater Clem McElreath"
"Hater Cris Carithers"
"Hater Denis Eisenhardt"
"Hater Elwood Leatherwood"
"Hater Floy O'Flaherty"
"Hater Gil Iglehart"
"Hater Glen Engelhart"
"Hater Ines Eisenhart"
"Hater Kacy Thackeray"
"Hater Lin Lanthier"
"Hater Lon Leonhart"
"Hater Lu Rheault"
"Hater Luca Archuleta"
"Hater Min Meinhart"
"Hater Monica Chiaramonte"
"Hater Old Aderholt"
"Hater Rand Earnhardt"
"Hater Rena Earnheart"
"Hater Ty Hattery"
"Hater Weimer Meriweather"
"Hater Wes Weathers"
"Hemp-EMPH" [p]
"Hood Gay Haygood"
"Hood Greta Goodheart"
"Hood Lang Hoogland"
"Hood Noe Donohoe"
"Hood Rena Nearhood"
"Hood Si Odisho"
"Hood Trey O'Doherty"
"Hood Una Dunahoo"
"Hood Wade Woodhead"
"Hot-Rap Porath"
"Hype Man Ham Pyne"
"Hype-Well Whelpley"
"I-Ill-Hard Hilliard"
"I-Roll-[']Em Morelli"
"Ice Don Condie" []
"Ice Kam Mackie" []
"Ice Kym Mickey"
"Ice Leah Aichele"
"Ice Lyn Nicely" []
"Ice Matt Mattice"
"Ice Randal Cardinale" []
"Ice Regan Carnegie"
"Ice Rolanda Candelario" []
"Ice Sean Necaise"
"Ice Sha Chiesa"
"Ice Shavon Schiavone" []
"Ice Son Enciso"
"Ice Sona Asencio"
"Ice Tona Atencio"
"Ice Trish Christie"
"Ill Abe Laible"
"Ill Al Lalli" []
"Ill Alvera Villareal"
"Ill Amy Millay"
"Ill Andre Nardelli"
"Ill Angel Langille"
"Ill Annie Iannelli"
"Ill Archie Chiarelli" []
"Ill Ash Sillah" []
"Ill Bee Liebel"
"Ill Ben Bellin"
"Ill Brad Billard"
"Ill Bree Liebler"
"Ill Brent Britnell"
"Ill Cameron Marcellino"
"Ill Cara Laclair"
"Ill Cesar Carlisle"
"Ill Chana Callihan"
"Ill Chas Challis" []
"Ill Chase Achilles"
"Ill Cora Carillo"
"Ill Corie Ciriello"
"Ill Cyr Crilly"
"Ill Dave DeVilla"
"Ill Dean Daniell"
"Ill Debra Belliard"
"Ill Dee Liedel"
"Ill Derick Licklider"
"Ill Don Dillon"
"Ill Dora Radillo"
"Ill Earl Lallier"
"Ill Ed Dille"
"Ill Elmo Melillo"
"Ill Elvin Linville"
"Ill Enos Ellison"
"Ill Eric Cirelli"
"Ill Erica Caillier"
"Ill Eva Vallie"
"Ill Evan Villena"
"Ill Evans Sanville"
"Ill Ewan Allwein" []
"Ill Genna Nelligan"
"Ill German Mallinger"
"Ill Gina Gillian"
"Ill Glenda Gilleland"
"Ill Glinda Gilliland"
"Ill Goth Gil Holt"
"Ill Grady Gillyard"
"Ill Gwen Welling"
"Ill Hanna Hallinan"
"Ill Hans Shinall"
"Ill Hardy Hillyard"
"Ill Hayes Hallisey"
"Ill Horace Chiarello"
"Ill Huong Loughlin"
"Ill Ivan Villani" []
"Ill Joe Jollie"
"Ill Lavon Villalon"
"Ill Mack Mallick"
"Ill Mara Mallari"
"Ill Marcie Camilleri"
"Ill Marva Villamar"
"Ill Mate Maillet" []
"Ill Nathan Tannahill"
"Ill Nevada Villaneda"
"Ill-Nice Cellini"
"Ill Noe O'Neill" []
"Ill Nordine Rondinelli"
"Ill Omer Morelli" []
"Ill One Lionel" []
"Ill Paolo Paolillo"
"Ill Peter Petrelli"
"Ill Regan Allinger"
"Ill Regena Langelier"
"Ill Remona Marinello" []
"Ill Retta Litteral"
"Ill Rey Reilly"
"Ill Rico Cirillo"
"Ill Rose Ellisor"
"Ill Ruben Brunelli"
"Ill Sabra Barillas"
"Ill Sam Mallis"
"Ill Samara Amarillas"
"Ill Shon Hollins-Hillson"
"Ill Sol Lollis"
"Ill Stew Willets"
"Ill Stone Elliston"
"Ill Swami Williams"
"Ill Terresa Serritella"
"Ill Trey Tillery"
"Ill Ty Tilly"
"Ill Vera Averill"
"Ill Verda Darville"
"Ill Vernia Rainville"
"Ill Vilma Villamil"
"Ill Ward Willard"
"Ill Yacoub Coulibaly"
"Illest Li'l Set"
"Illest Si Tell" []
"In-Camp MC Pain"
"In-Crowd-Down Ric"
"Jennski Jenkins"
"Judy Yu, DJ"
"The Kid Keith D"
"Killa [if player is male]Kalil[else]Kalli[end if]"
"Killing Li'l King"
"L. A. Al"
"L-Dog Gold"
"Lawless Wassell"
"Le Doc Dolce"
"Loud Ludo"
"Low-Rap Parlow"
"M-Watt Matt W"
"Mac the Hate MC"
"Macking King Cam"
"Macking Nag Mick" []
"Manic MC Ian"
"MC Aaron Carmona-Marcano" [amusing note: I got a lot of MC Andrew McAndrew etc from this generator]
"MC Alex Exclam"
"MC Aline Macneil"
"MC Allyn Mcnally"
"MC Asia Macias"
"MC Bowen Newcomb"
"MC Celina Mcclaine"
"MC Dario Dimarco"
"MC Elana Maclean"
"MC Elisha Michaels"
"MC Elvina Mcelvain"
"MC English Schmeling"
"MC Fleta Metcalf"
"MC Garth Mcgrath"
"MC Ike Mckie"
"MC Ira Macri" []
"Mc Kandi Dickman"
"MC Karena Ackerman"
"MC Karin Rickman"
"Mc Kathe Ketcham"
"MC Kena Eckman" []
"MC Kerri Merrick"
"MC Kia Amick"
"MC KO-Mock"
"MC Larisa Mariscal"
"MC Layne Mcnealy" []
"MC Leona Coleman"
"MC Leonore Colmenero"
"MC Lulu Cullum"
"MC Niki Minick"
"MC Push-Chumps"
"MC Rena Carmen-Mcnear" []
"MC Reyna Mcraney"
"MC Rheba Chamber"
"MC Rina Mcnair" []
"MC Rosa Marcos" []
"MC Rush Schrum"
"MC Ryan Mcnary"
"MC Seaborn Branscome"
"MC Serena Cremeans"
"MC Shana Cashman"
"MC Shaun Cushman"
"MC Sherri Schirmer"
"MC Shiloh Chisholm"
"MC Shona Hanscom"
"MC Stanko Stockman"
"MC Su Scum"
"MC Tish Schmit"
"MC Visit-Victims"
"Miracle MC Ariel"
"Mofo of Mo[']"
"Molten Montel" []
"Mosh Man Hammons"
"Mr. Hear-Harmer"
"Ms. Play-My-Pals Sly Pam"
"Neo Al Oneal" []
"Neo Amy Yeoman"
"Neo Bart Boatner"
"Neo Bill Bellino-Bonelli"
"Neo Bo Boone"
"Neo Britt Robinett"
"Neo-Bro Oberon"
"Neo Chas Acheson"
"Neo Chris Richeson" []
"Neo Coy Cooney"
"Neo Cris Ericson-Recinos" []
"Neo Curt Cureton" []
"Neo Del Deleon"
"Neo Dorla Leonardo"
"Neo Emil Lemoine" []
"Neo Gala Galeano"
"Neo Gay Gonyea"
"Neo Irma Romaine"
"Neo Kris Erikson"
"Neo Lan Nealon" []
"Neo Laura Laureano"
"Neo Les Leeson-Olesen"
"Neo Lew Loewen"
"Neo Lida Odaniel"
"Neo Lisa Eliason" []
"Neo Marc Cameron-Marenco" []
"Neo Mary Maroney"
"Neo Ming Mignone"
"Neo Pat Aponte"
"Neo Rand Nardone"
"Neo Rhett Etherton"
"Neo Rich Eichorn"
"Neo Rosy Reynoso"
"Neo Roy Rooney"
"Neo Sal Sloane-Leanos" []
"Neo Sam Seamon"
"Neo Sid Edison-Eidson"
"Neo Sol Oleson"
"Neo Tad Deaton"
"Neo Tina Antoine"
"Neo Tori Tenorio"
"Neo Ty Toney"
"Neo Vanda Avendano"
"Neo Wm Mowen"
"New Berry Newberry"
"New Bill Newbill"
"New Bo Bowen-Bowne"
"New Bob Benbow"
"New Carlee Lawerence"
"New Carlo Lowrance"
"New Clare Lawrence"
"New Dee Weeden"
"New G Gwen" []
"New Gerald Greenwald"
"New Gita Wingate" []
"New Hal Whalen-Whelan"
"New Irma Wireman"
"New Kirk Newkirk"
"New Leo Loewen" []
"New Lida Weiland"
"New Lon Newlon"
"New Mac Mcewan"
"New Madie Wiedeman"
"New Marta Waterman"
"New Mina Weinman"
"New Minna Weinmann"
"New Reid Weidner-Widener-Redwine" []
"New Rick Renwick"
"New Rob Browne"
"New Robin Winborne"
"New Robt Brewton"
"New Rod Worden-Rowden-Downer"
"New Ruby Newbury"
"New Sarah Earnshaw"
"New Son Newson"
"New Thomas Mathewson"
"New Thor Worthen"
"New Trisha Swinehart"
"Nik 'Ego' Koenig"
"No-Cred Ed Corn"
"No Cute Tune Co"
"No-Flaws [if player is male]Alf Snow[else]Flo Swan[end if]" []
"No-Rhyme Mo Henry"
"No-Rhymes Shon Emry"
"Noble L-Bone" []
"Not-Swell Townsell"
"Nuclear Cur Neal" []
"Null-Rep Purnell"
"On-Beats Bastone"
"Our Fat Far Out Oaf Rut"
"Our Rap Uproar"
"Out Loud Lout Duo"
"Pamperin['] Pimp Rena"
"Pep Lord Doppler"
"Pepe's Peeps"
"Perpin['] Nipper Ren Pip"
"Pimp Keenan Kemppainen"
"Pimp Leah Pamphile"
"Pimp Verna Vipperman"
"Playa Al Yap"
"Playful Fly Paul"
"Poet Carn Caperton"
"Poet Clem Lecompte"
"Poet Dan Patnode" []
"Poet Ernst Petterson"
"Poet Hans Stanhope" []
"Poet Lina Lapointe"
"Pop Diva Ida Vopp"
"Pop Lee's Peoples"
"Pope O['] Pep"
"Posing Gipson"
"Postered Dopester Poser Ted"
"Prim Past Art Pimps"
"Punk Erma Kuperman"
"Punk Isis Supinski"
"Punk Lisi Lupinski"
"Punk Slim Lumpkins"
"Rad-Flow Waldorf"
"Rad Les Sadler"
"Raggae Garage"
"Raw Ern Warren" []
"Real Butch Culbreath"
"Real Earl Lear"
"Real MC Marcel McLear"
"Red Hot Ed Hort" []
"Reggae Tart Greta Gater"
"Rockin[']-on Rick"
"Rollin['] Ill Ron"
"Schooling Lois Chong"
"Scowl'n Clowns"
"Scummier Crummies"
"Sellout Lout Les"
"Slowfast Flowstas"
"Sly Abe Beasly"
"Smoking Hot King Smooth"
"Smooth Host Mo"
"Smoother Moe Short"
"So-Money Mo Noyes"
"So Wrong Song Row"
"Sold-Out Lost Duo"
"Sound Man Amundson"
"Stink-It Kittins"
"Stoner Mo Montrose"
"Street Mix Extremist Mister Tex"
"Streetwise [if player is male]Stew Steier[else]Tessie Wert[end if]"
"Swell Bo Bellows" []
"Swell Harton Allensworth"
"Swell Roth Ellsworth"
"Tennis Hater Hartenstein"
"Thrill-Ed The Ill Dr"
"Tim Hepp the Pimp"
"Tin-Ear Renita"
"Tone-Deaf [if player is male]Nat DeFoe[else]Dee Afton[end if]" []
"Too-Def Ted Foo"
"Too-Swell [if player is male]Sol Towle[else]Lolo West[end if]"
"Top Wack Two-Pack"
"A Troop Poor at Rap Too"
"Uber-Hater Brethauer"
"Ult-O-Lout"
"Un-Lame Manuel"
"Us Dodgy Odd Guys"
"Vice Lord [if player is male]Cid Lover[else]Di Colver[end if]"
"Wack Butler Buckwalter"
"Wack Flop Wolfpack"
"Wack Min Wickman"
"Wack Mo Womack"
"Wack Roby Brockway"
"Wack Ron Warnock"
"Wack Roni Nawrocki"
"War-Tech Hat Crew" []
"Way Chill Willy Cha"
"Way-Dope Ady Powe"
"West Arch Hats Crew"
"Wild Free Life Drew"
"Wino Dog Goodwin" []
"Words-Poet Prestwood"
"Yo['] Bust Boy Stu"
"Yolo Al Loyola"
"Yolo Ed Dooley"
"Yolo Gill Gillooly"
"Yolo Lew Woolley"
"Yolo Wes Woolsey"

table of biopics [xxm3]
blurb	fave
"[if player is male]One Man, No Name[else]I, Hereon, Heroine[end if][r], by [if player is male]Ann Moe[else]Irene Ho[end if]"	true
"Able Doing? No Big Deal: Angled Bio[r], by [if player is male]Eli Bogdan[else]Gia Bondel[end if]"	false
"Ace's Win Was Nice[r], by Wes Cain"	true
"All Those Words: Shallow Doters, Worthless Load[r], by Stowell Rhoads"	false
"Another Try, Hero-Tyrant[r], by Roy Harnett & [if player is male]Tony Erhart[else]Thora Tyner[end if]"	false
"Armageddon Raged On, Mad[r], by [if player is male]Edgar Damon[else]Marna Dodge[end if]"	true
"Arriviste: it Arrives[r], by Teri Rivas"	false
"Ascend, Rote Second-Rate[r], by [if player is male]Dan Cortese[else]Eden Castro[end if]"	false
"Aw, We All Call Ace[r], by Alec Law-Wallace"	true
"Bald is Laid BS[r], by [if player is male]Sid Alb[else]Di Blas[end if]"	false
"Being Good Bio? GONGED[r], by Ned Boggio"	false
"Bias of I-So-Fab: a Fib, So[r], by Bo Asif"	false
"Big House: Bio's HUGE[r], by Hugo Seib"	true
"Bigly Bilgy[r], by Gilly Bigby"	false
"Bilk, Pact, BLACK PIT[r], by Pat Blick"	false
"Black Ego Blockage[r], by Olga Beck"	false
"A Blot-Bloat[r], by Lola Abbott"	false
"Bold Age: Go, Blade[r], by [a-b] Gold"	true
"Con Called CLEAN? COLD[r], by Dec Callon"	true
"Contemn a 'Hero' More Than Once[r], by Chante Monroe"	false
"Cover Stolen: Not So Clever[r], by Colton Veres"	false
"A Curse Causer[r], by Cara-Sue Cruse"	false
"Da Lingo Be No Big Deal[r], by Deb Alongi"	false
"Detest-Tested[r], by Ted Tse"	true
"Dim-Worths Wordsmith[r], by Dr. Tim Show & Dr. Tom Wish"	false
"Duty-Call: Act Dully[r], by Lucy Ladt"	false
"Epic Fail: a Life Pic[r], by Ace Filip"	false
"Era's Hip Sharpie, a Re-Ship[r], by Ira Pesh"	true
"Evil Ways: a Sly View[r], by Ivy Wales"	false
"Fallen Star, Flat Learns[r], by [if player is male]Stan Farell[else]Fran Stella[end if]"	false
"Fame, Arid, Amid Fear: Fair-Made?[r] by Adam Frei"	false
"Fame Rises, Seems Fair[r], by Sam Friese"	true
"First-Rate Fast Trier: Art, Strife[r], by Rea Fritts"	true
"Fly? Ah, Tons Not Flashy[r], by Shyla Font"	false
"A Fly Debut...BY DEFAULT[r], by Fleta Duby"	false
"A Fossil Fails So[r], by Flo Issa"	false
"Foul Plays: a Folly's Up[r], by Polly Faus"	false
"Free a Ghost for the Ages[r], by Tosha Grefe"	true
"Gawd, S'More Word Games[r], by [if player is male]Drew Gamos[else]Margo Dews[end if]"	false
"A Genius in Usage[r], by Gina-Sue Seguain"	true
"Go, O. G., Go[r], by Og G. Goo"	true
"Good [if player is male]Man? [else]Woman? Ow, [end if]Mad Goon[r], by [if player is male]Dan[else]Wonda[end if] Moog"	false
"The Goon on the Go[r], by Theo Ong"	false
"Here Trots the Sorter[r], by Ester Hort"	true
"Hero, Get There: GO[r], by Thor Gee"	true
"Hero, Ply, Be Hyperbole[r], by [if player is male]Lee Brophy[else]Beryl Hope[end if]"	true
"Hero Tasks? Ask Others[r], by [if player is male]Theo Krass[else]Kathe Ross[end if]"	false
"Hero Tent Not There[r], by Rene Toth-Etherton"	false
"Hog, Urge a Rough Age[r], by Rea Gough"	false
"Home Again: Oh, I Manage[r], by [if player is male]Noah Megia[else]Naomi Hage[end if]"	true
"Howl, Drab Blah-Word Blowhard[r], by W. Harbold"	false
"I, Chooser So Heroic[r], by [if player is male]Rico Shoe[else]Cheri Soo[end if]"	true
"I, Grand, Drag in a Grind[r], by [if player is male]Girard Dignan[else]Ingrid Gardan[end if]"	true
"I Ran Out on Our Nation[r], by [toti] Ruano"	false
"I, the Worm With More[r], by Moe Wirth"	false
"I, Vanilla: a Villain[r], by Alvin Lai"	false
"Immersion in Memoirs, Semi-Minor[r], by Mimi Rosen"	false
"In Steady: a Destiny[r], by [if player is male]Ty Daines & Ted Yasin[else]Nita Syed & Sade Tiny[end if]"	true
"Influential? I, Fallen Unit[r], by Tuan Finelli"	false
"Inspired, I? Insipider[r], by Sid Perini"	false
"Key: Arch-Hackery[r], by Ray Heck"	false
"Let Soul Sell Out[r], by Su Tolle"	false
"Letter Swap? Stale Twerp[r], by [if player is male]Stew Alpert[else]Pearl Swett[end if]"	false
"Letter Swap? Stale Twerp[r], by Stew Alpert"	false
"Lion Heart? No, the Liar[r], by [if player is male]Ali Theron[else]Lori Ethan[end if]"	false
"Love-in? No, Evil[r], by Vivion Leonel"	false
"Master? No, a Monster[r], by Ron Mesta"	false
"More Fit for Time of Merit[r], by Tim Foer"	true
"More Hurts: the Rumors[r], by [if player is male]Homer Rust[else]Ruth Moser[end if]"	true
"My Trail: I'm To Immortality[r], by Timmy Lorita"	true
"Nigh Rude Hired Gun[r], by [if player is male]Ned Uhrig[else]Inge Hurd[end if]"	false
"Normalcy? Lo, Cry, Man[r], by Marc Lyon"	true
"Nostalgi-Gloatins[r], by [if player is male]Otis Lang[else]Lois Gant[end if]"	true
"Not So Great: Gotta Snore[r], by Otto Sanger"	false
"Notoriety to Inert, Yo[r], by [if player is male]Otto Eryin[else]Tori Toney[end if]"	false
"OK, Words, Do Works[r], by Rod Skow"	true
"Older and Wiser, I Learned Words[r], by Delores Darwin"	true
"One Act? NOT, Ace[r], by Nat Coe"	false
"One Cold Neo-Clod[r], by Don Cole"	false
"One Path: Neat Hop, Phaeton[r], by Nat Hope"	true
"One Set Seen To[r], by Tennessee Oto"	true
"A Pedantic Pain Acted[r], by Pia DeCant"	false
"Permutations? Imposter, a Nut[r], by [if player is male]Tatum Pierson[else]Maurine Potts[end if]"	false
"Permuting, Urgent Imp[r], by Meg Turpin"	false
"A Pride, Paired[r], by Piedad Rapier"	false
"Prodigious? Odious Prig[r], by Guido Spiro"	false
"Re-Grow, Mad Word Gamer[r], by [if player is male]Drew Magro[else]Meg Darrow[end if]"	true []
"Really Po['] Role Play[r], by [if player is male]Lyle Pora[else]Lora Pyle[end if]"	false
"Recapping Pap: CRINGE[r], by Pip Cregan"	false
"Resume It, Emeritus[r], by Su Metier"	true
"Right One? Inert Hog[r], by [if player is male]Theo Ring[else]Inge Roth[end if]"	false
"Robust BS Tour[r], by Brutus Botros"	false
"Rogue at Our Gate: Outrage[r], by U. Ortega"	false
"Rogue: Aye, You Agree?[r] by Yao Egure"	false
"Rogue's Bio: Bourgeois, Sour Bogie[r], by Sergio Bou"	false
"Royal Asset? So Last Year[r], by Rosa Staley"	false
"A Ruined Idea Run[r], by Enid Rau"	false
"Saint? Ungodly, Astoundingly[r], by [if player is male]Landis Guyton[else]Glinda Younts[end if]"	false
"Sainted? Stained Instead[r], by Sid Etna"	false
"Say, Sane: an Essay[r], by Ena Syas"	true
"Scholar, to Loco Trash[r], by Oscar Holt"	false
"Score High, Go Cherish[r], by Chris Hoge"	true
"Sedentary, Needy Star[r], by [if player is male]Ernest Day[else]Tyra Sneed[end if]"	false
"Shame Fit This Fame[r], by Fae Smith"	false
"Shoo, Mere Emo Hoser: Some Hero[r], by Romeo Esh"	false
"A Shuffler: Flush Fear[r], by Sal Huffer"	true
"Sloth, Be the Slob[r], by Les Both"	false
"So Daunting, Astounding[r], by [if player is male]Otis Dungan[else]Gia Dunston[end if]"	true
"The Sorry Hero's Try[r], by Rory Tesh"	false
"St. Be-Best[r], by Bess Bett"	true
"Stymie Not Testimony[r], by Simon Yett"	true
"Suaver? No, Ravenous[r], by Evan Urso"	false
"Super Macho? A Sore Chump[r], by Marcus Hope"	false
"Tasty or Artsy to So Ratty[r], by Tyra Tso"	false
"There Rots the Sorter[r], by Ros Threet"	false
"Titan's Taints[r], by Si Tant"	false
"Titans: a Stint[r], by Santina Stitt"	false
"Titled? TILTED[r], by Ed Litt"	false
"To Bull: Easy, Absolutely, by a Sellout[r], by [if player is male]Solly Taube[else]Tula Boyles[end if]"	false
"To Vanish, Shot, Vain[r], by Hans Voit"	false
"Topness: On Steps Spent So[r], by Tess Pon"	true
"A Trek Taker[r], by Kara Rettke"	true
"Upstream Into Permutations Use: Important[r], by [if player is male]Rupe Mattison[else]Simona Pruett[end if]"	true
"Urgent Icon Recounting: Reign, Count[r], by Cori Nugent"	true
"Very Well Done? YELLOW NERVED[r], by [if player is male]Dewey Norvell[else]Evelyn Dowler[end if]"	false
"Vie, Rebel, Believer[r], by Bree Levi"	true
"Visionary? Yo, VAIN, Sir[r], by Ivory Sina"	false
"Whoa, Heart, What a Hero[r], by Tarah Howe"	true
"A Wit, Hedged: Dead Weight[r], by Dwight Eade"	false
"Word Game: Go Ward [']Em[r], by [if player is male]Drew Goma[else]Marge Dow[end if]"	true
"Word Shift: Who Drifts[r], by Rhod Swift"	false
"Wordplaying Paid Wrongly: a Dingy Prowl[r], by Apryl Godwin"	false
"Worth Dims, Wordsmith[r], by Tim Shrowd"	false
"Wow, Riddle World Wide[r], by Dowd Wiler"	true
"Wrongs Ached: Change, Words[r], by [if player is male]Seward Chong[else]Gwenda Rosch[end if]"	true
"Yeah, So What: a Showy Hate[r], by Tasha Howey"	false

table of comedians [xxm4]
blurb
"Absurdist Trudi Bass" []
"Acerbic Ric Cabe"
"Actor Ann Cantoran"
"Actor Bo Brocato"
"Actor Don Coonradt"
"Actor Eli Talerico"
"Actor Elli Tallerico"
"Actor Ian Catarino"
"Actor Ines Tiscareno" []
"Actor Jens Castrejon"
"Actor Len Carleton"
"Actor Lila Tallarico"
"Actor Lin Coltrain"
"Actor Lou Curatolo"
"Actor Ly Claytor"
"Actor Meri Cromartie"
"Actor Nehls Charleston"
"Actor Ren Torrance" []
"Actor Sam Armacost"
"Actor Sean Castorena"
"Actor Sol Locastro" []
"Actor Welsh Schowalter"
"Adolfo Da Fool"
"Adrenalin-Riled Erlinda Ladnier-Ireland" []
"Adult Kid Ida Kludt"
"Alf of Offal"
"Alive Elvia Leiva"
"Am-I-Nuts Mustain"
"Amuser Mauser"
"Amuser Semrau" []
"Amusing Smug Ian"
"Anarchic Cara Chin"
"Anarchy Ray Chan"
"Antic Dee Cadiente"
"Antic Jo Jacinto"
"Antic Leah Chatelain"
"Antic Ly Caitlyn" []
"Antic Pierre Carpentieri"
"Antic Red Tancredi"
"Antic Rhee Catherine"
"Antic Rita Carattini"
"Antic Roe Caterino-Nicotera"
"Antic Romona Marcantonio"
"Antic Ros Nicastro" []
"Antic Rose Tiscareno" []
"Antic Ross Croissant" []
"Antic Shari Christiana"
"Antic Sher Christena"
"Antic Shon Atchinson"
"Any-Barb Barnaby" []
"Any-Jerk [if player is male]Jay Kern[else]Jen Kray[end if]"
"Aper Earp"
"Apin['] Dr. Pinard"
"Appalling Al Appling"
"Aron 'Baha' Barahona"
"At-Pranks Nat Parks"
"Attentioneer [if player is male]Etienne Ratto[else]Anette Tierno[end if]"
"Atypical Pati Lacy"
"Bad Word Bawd Rod"
"Baiter I.E. Brat Artie B"
"Banned Deb-Ann"
"Batty Byatt" []
"Bawdier [if player is male]Brad Wei[else]Ewa Bird[end if]"
"Bellicose Ilse Coble"
"Berater Bret Rea"
"Best-Ever Reb Steve"
"Big-LOLs Glib Sol"
"Big-Time Gibe Tim"
"Blane 'Laugh' Allenbaugh"
"Blase Norm Lamberson" []
"Blotto Bo Lott"
"Blowhard Brad Wohl"
"Bo 'Laugh' Lobaugh"
"Bombshell Mell Hobbs"
"Bonkers Berkson"
"Boob Bobo"
"Boor Atkins Stainbrook"
"Boor Cami Ambrocio"
"Boor Daron Bordonaro"
"Boor Del Robledo"
"Boor Delta Debartolo"
"Boor Em Broome"
"Boor Fred Oberdorf"
"Boor Glinda Longobardi"
"Boor Lemons Rosenbloom"
"Boor Mel Bloomer"
"Boor Melita Bartolomei"
"Boor Ming Imbrogno" []
"Boor Mose Roseboom"
"Boor Omer Borromeo"
"Boor Ray Borrayo"
"Boor Sean Soberano"
"Boor Sima Ambrosio"
"Boor Stan Boonstra"
"Boor Susi Brosious"
"Boor Tami Morabito"
"Boor Telma Bartolome"
"Boor Tilda Dibartolo"
"Bro Al Albro"
"Bro Alden Bolander"
"Bro Andre Dearborn" []
"Bro Dale Laborde" []
"Bro Dan Bodnar"
"Bro Dee DeBoer"
"Bro Dong Brogdon"
"Bro Drew Browder"
"Bro Ed Brode"
"Bro Efren Freeborn"
"Bro Eldon Bordelon"
"Bro Elmo Bloomer" []
"Bro Ethan Rathbone"
"Bro Gus Burgos"
"Bro Ian O'Brian" []
"Bro Lee Oberle"
"Bro Len Lebron"
"Bro Les Robles"
"Bro Nat Barton"
"Bro Neal Lebaron"
"Bro Ned Borden-Bodner"
"Bro Neil Oberlin"
"Bro Nestor Robertson"
"Bro Nic Corbin"
"Bro Nigel Bolinger"
"Bro Ray Yarbro"
"Bro Rene Boerner"
"Bro Rey O'Berry"
"Bro Ryan Rayborn"
"Bro Sean Seaborn"
"Bro Wes Bowers" []
"Brony Byron" []
"Bud 'Razz' Buzzard"
"Buffoon Bo Onuff"
"Bunch-O-JK John Buck"
"Card Alan Calandra"
"Card Ali Clarida"
"Card Aline Cardinale" []
"Card Allen Callander"
"Card Angelo Darcangelo"
"Card Anh Chandra"
"Card Bee Breceda"
"Card Eli Decarli"
"Card Elia Caldeira"
"Card Ella Cardella"
"Card Elois Decarolis"
"Card Elwood Calderwood"
"Card Evan Vandecar"
"Card Hellen Challender"
"Card Ike Radecki"
"Card Ileana Candelaria"
"Card Kip Pickard"
"Card Kris Rickards"
"Card Lea Caldera"
"Card Lee Recalde"
"Card Len Crandle"
"Card Leo Decarlo"
"Card Leon Calderon"
"Card Leona Colandrea"
"Card Lin Clinard"
"Card Lina Cardinal" []
"Card Lon Caldron"
"Card Mel Mcardle"
"Card Neil Calderin"
"Card Nell Crandell"
"Card Neoma Cardamone"
"Card Noelia Candelario" []
"Card Nola Calandro"
"Card Olin Alcindor" []
"Card Oren Dorrance"
"Card Reina Carradine"
"Card Rhea Hardacre"
"Card Roy Cordray"
"Card Sean Cardenas"
"Card Sina Sciandra"
"Cardy Darcy Crady"
"Careless Crass Lee"
"Cartoonish [if player is male]Otis Achorn[else]Staci Honor[end if]"
"Cartoony [if player is male]Tony Cora[else]Toya Corn[end if]"
"Charlatan [if player is male]Nat Rachal[else]Tana Larch[end if]"
"Cheap [tt] Piechota"
"Cheap Art Capehart"
"Cheap Daniel Chapdelaine"
"Cheap Lu Plauche"
"Cheap Patti Chiappetta"
"Cheap Pearl Chappelear"
"Cheap-Shot Hope Tasch" []
"Chet Karn the Crank"
"Clown Rae Lowrance" []
"Cockamamie [if player is male]Kam Macioce[else]Emiko McCaa[end if]"
"Colorful Luc Floro"
"Comic Al Climaco"
"Comic Arn Cormican"
"Comic Ed DeMicco"
"Comic Ken McConkie"
"Comic Luann Councilman"
"Comic Noah Manocchio"
"Comic Olga Magliocco"
"Comical Cam Clio"
"Comical Mac Olic" []
"Compelling Peon McGill"
"Contrary Corny Art" []
"Cora 'Razz' Carrozza"
"Corn-Free Enforcer Fern Core"
"Cornball Cal Blorn"
"Cornier Corrine"
"Corny Abel Clayborne"
"Corny Al Carlyon"
"Corny Ed Condrey"
"Corny Em Morency"
"Corny Lea Roylance"
"Corny Ma Carmony"
"Cranky KC Ryan"
"Crass Agee Escarsega"
"Crass Ella Scarsella"
"Crass Ely Casserly"
"Crass Iona Cassarino"
"Crass Leo Lacrosse" []
"Crass Lon Carlsson"
"Crass Min Crissman"
"Crass Noren Rosencrans"
"Crass Oren Rosecrans"
"Crass Rao Socarras"
"Crass Toi Cossairt"
"Crass Toni Croissant" []
"Crass Yue Syracuse"
"Cray-Cray Aryc Cary" []
"Crazy Maker Cary Mrazek"
"Crude Al Caulder"
"Crude Sam DeMarcus"
"Crude Seth Deutscher"
"Cult Hero Ruth Cole"
"Cuss Trio So Rustic"
"Cutesy Su Tyce"
"Cynic Niccy"
"Daemonic Moni Cade"
"Dan 'Laugh' Haugland"
"Dang-Fool Gandolfo"
"Dazzling Lizz Gand"
"Dear Al Delara"
"Dear Ben Bearden" []
"Dear Bill Belliard" []
"Dear Dan Andrade" []
"Dear Don Denardo"
"Dear Glen Legrande"
"Dear Glenn Englander"
"Dear Juan Jandreau"
"Dear Leo Deloera"
"Dear Luis Urdiales"
"Dear Lynn Nylander"
"Dear Neal Ardelean"
"Dear Rob Berardo"
"Dear Robin Berardino"
"Dear Ron Reardon"
"Dear Sam Dearmas"
"Dear Saul Raudales"
"Demagogue Doug Magee"
"Derider Red Reid"
"Dirtiest Trite Sid"
"Disparager [if player is male]Edgar[else]Gerda[end if] Paris"
"Disparager [if player is male]Reid Gaspar[else]Geri Prasad[end if]" []
"Diss Man Dan Sims"
"Disturbing Birgit Sund"
"Don 'Laugh' Hoaglund"
"Dona 'Razz' Randazzo"
"Doodler [if player is male]Rod Dole[else]Loo Redd[end if]"
"Driest Sir Ted" []
"Drippy Dry Pip"
"Drolest Oldster Lost Red"
"Droll Ace Cardello"
"Droll Ace Del Carlo" []
"Droll Inge Dollinger"
"Droll Mae Delmoral"
"Droll Sacha Cashdollar"
"Droll Swain Willardson"
"Droller Dorrell"
"Drunkest Ken Durst"
"Dry Ace Darcey Redcay"
"Dry Ed Reddy"
"Dry Fat Tad Fry"
"Duffer Fred Fu"
"Dung-y Gundy" [p]
"Edgy Al Dagley"
"Edgy Bo Godbey"
"Edgy Lin Dingley"
"Edgy Loo Goodley"
"Edgy Noah Donaghey"
"Edgy Roger Degregory"
"Elton Ho the Loon"
"Eunice 'Baha' Beauchaine"
"Eve 'Zest' Estevez"
"The Famous [if player is male]Mose Hauft[else]Sue Fathom[end if]"
"Fool Argo Garofolo"
"Fool Denis Ildefonso"
"Fool Diemer Moorefield"
"Fool Eril Fiorello"
"Fool Fred Loffredo"
"Fool Inge Fenoglio"
"Fool Lan O'Fallon"
"Fool Ma Maloof"
"Fool Tinner Florentino"
"Fooling Fogolin"
"Foul Bee Leboeuf"
"Foul Gast Falgoust"
"Foul Kerns Fulkerson"
"Foul Tianna Lafountain"
"Foul Trena Lafortune"
"Foul Wold Fullwood"
"Frances 'Laugh' Schraufnagel"
"Frenzied Ned Fizer" []
"Fresh Boy Hy Forbes"
"Fresh Girl Shirl Ferg"
"Freudian [if player is male]Ned Rufai[else]Adrien Fu[end if]"
"Fun Carole Faulconer"
"Fun Dee Dunfee"
"Fun Doreen Neuendorf"
"Fun Fred Duffner"
"Fun Gay Fanguy"
"Fun Helga Hufnagel"
"Fun Hiram Fuhriman"
"Fun Latonia Lafountain" []
"Fun Loreta Lafortune" []
"Fun Marc Curfman"
"Fun Mark Frankum"
"Fun Omar Fourman"
"Fun Rae Fernau"
"Fun Red Dufner-Freund"
"Fun Reda Dufrane"
"Fun Reed DuFrene"
"Fun Rey Furney"
"Fun Tessie Sifuentes"
"Fun Tisa Faustin"
"Fun Tonia Fountain"
"Fun Tora Fortuna"
"Funster Ali Saintfleur"
"Galling Gil Lang"
"Godwin-y Gwydion" [p]
"Gonged Ned Ogg"
"Goof Erin Forgione"
"Goof Fred Goffredo"
"Goof Lora Garofolo" []
"Goof Neil Fenoglio" []
"Goof Rana Garofano"
"Goofball Flo Balgo"
"Got-a-Fry Fogarty"
"Grant 'Baha' Bhatnagar"
"Grounded Nerd Doug" []
"Ham [n-t] Mathena"
"Ham Alden Haldeman" []
"Ham Andre Hardeman" []
"Ham Anna Manahan"
"Ham Barb Brabham"
"Ham Berna Haberman"
"Ham Cecil Michalec"
"Ham Clare Lamarche"
"Ham Clarice Carmichael"
"Ham Darin Hardiman"
"Ham Ed Ahmed"
"Ham Eden Needham"
"Ham Erinn Hinerman"
"Ham Esta Eastham" []
"Ham Evan Haveman"
"Ham Gena Hageman" []
"Ham Genna Hagemann"
"Ham Inge Meighan"
"Ham Lance Leachman"
"Ham Len Lehman-Helman"
"Ham Leon Holeman"
"Ham Lise Ishmael"
"Ham Lon Holman-Lohman"
"Ham Lucy Mulcahy"
"Ham Lyla Mayhall"
"Ham Ned Denham"
"Ham Neil Heilman" []
"Ham Nell Hellman"
"Ham Nick Hickman" []
"Ham Noe Mahone"
"Ham Nona Monahan"
"Ham Olin Holiman"
"Ham Pearl Lamphear"
"Ham Regan Hagerman"
"Ham Ron 'No Harm' Harmon-Mahorn" [p] []
"Ham Ron Harmon" []
"Ham Rose Ashmore" []
"Ham Sabra Abrahams"
"Ham Sal Haslam"
"Ham Tisa Mathias" []
"Ham Tran Hartman"
"Ham Tyler Matherly"
"Ham Weston Mathewson" []
"Hard-Luck Card Hulk"
"Hardly-Dry Hal"
"Harp-Lots Lathrop's"
"Herr Mac, Charmer"
"Hi-Lafs Al Fish"
"Hi-Snark Krishna Rashkin-Harkins"
"Hilarious Isaih Rulo"
"Hilarious Luis O'Hair" []
"Huck Taft" [x: REDACTED]
"Hysterical [if player is male]Rich Staley[else]Alyce Hirst[end if]"
"I-For-Fun Ruffino"
"Idle Raw Wired Al"
"Ill Joky Killjoy Jilly Ko"
"Imitator Mariotti"
"Immature Tim Mauer" []
"Immodest Tim DeMos"
"Immoral Omar Lim"
"Impish Hip Sim"
"In-Jokey [if player is male]Ken Yoji[else]Joni Key[end if]"
"In-Your-Face [if player is male]Royce Finau[else]Francie You[end if]" []
"Inebriated [if player is male]Deren Taibi[else]Nia Deibert[end if]"
"Inexcusable Alexis Bunce"
"Infamous Musin['] Oaf Mia Fuson"
"Insane Sienna"
"Insolent Lon Stein"
"Insult Lustin['] Stu Lin"
"Insulter Ernst Liu"
"Irate Artie"
"Jape Errien Jeanpierre"
"Jape Luna Jeanpaul"
"Jape Ren Prejean"
"Jasper Japers"
"Jaunty Nut Jay"
"Javier Jarvie, a Jiver"
"Jeer-Mo['] Jerome"
"Jester JT Rees"
"Joking King OJ"
"Josephina 'Josh' Paine"
"Jovial Ol['] Javi"
"Juvenile Vile June"
"Kid C"
"Kidder Bloom Middlebrook"
"King Rebel Kleinberg"
"Kitschier Shtickier [if player is male]Seth Irick[else]Cris Keith[end if]"
"Kitschy Shticky Ty Hicks"
"La Corny Carolyn" []
"Larky Karly-Karyl"
"Laughy Guy Hal"
"Launch-a-Lunch [if player is male]Al Chun[else]Lu Chan[end if]"
"Lawly Wally"
"Le Shiv Elvish"
"Leet-Rip Peltier"
"Les 'Laff' Saffell"
"Lew Notch the Clown"
"Limner Merlin" []
"Linn 'Baha' Hannibal"
"Lis 'Baha' Shalabi"
"LMFAO-Mo['] Alf"
"Lo-Key Yokel Kooky Lyele"
"Logician Icon Gail"
"LOLster Stoller"
"Loon Alf O'Fallon" []
"Loon Ames Salomone"
"Loon Deidra DiLeonardo"
"Loon Del Odonell"
"Loon Don Londono"
"Loon Earl Orellano"
"Loon Ed Doolen"
"Loon Elmira Romaniello"
"Loon Eric Cornelio"
"Loon Fred Florendo"
"Loon Ham Holoman"
"Loon Lev Novello"
"Loon Levi Noviello"
"Loon Mac Coolman"
"Loon Matt Montalto"
"Loon Ned O'Donnel"
"Loon Pia Paolino"
"Loon Rust Roulston"
"Loon Sam Salomon"
"Loon Seth Hoselton"
"Loon Tora Ortolano"
"Loon Vik Nikolov"
"Loopy Alec Claypoole"
"Loopy Cal Claypool"
"Lout Alice Caillouet"
"Lout Amos Tomasulo"
"Lout Behring Lightbourne"
"Lout Belen Buentello"
"Lout Chae Latouche"
"Lout Cora Curatolo" []
"Lout Dan Daulton"
"Lout Dashner Southerland"
"Lout Eric Cloutier"
"Lout Erich Clouthier"
"Lout Erma Realmuto"
"Lout Gil Guillot"
"Lout Hicks Tucholski"
"Lout Lee Ouellet"
"Lout Manie Manuelito"
"Lout Maren Morneault"
"Lout Meri Moultrie"
"Lout Shah Holthaus"
"Lout Shea Althouse"
"Lout Welsh Southwell"
"Low-Gibe Bigelow"
"Loyal Wag Galloway"
"Luc 'Baha' Laubach"
"Lulsy Sully"
"Lush Co-Slouch Sol Chu"
"Madcap Cad Pam"
"Majestic-TIC James"
"Manic Del Mcdaniel"
"Manic Doe Domenica" []
"Manic Kari Marciniak"
"Manic-Leer Marceline"
"Manic Lew Mcelwain"
"Manic Ora Marciano"
"Manic Oretha Chiaramonte" []
"Manic Rhea Charmaine"
"Manic Trey Macintyre"
"Manly Lyman Lynam"
"Marian 'Baha' Abrahamian"
"The Max Ham Tex"
"Melange-Glee Man Lem Egan"
"Mia 'Razz' Maziarz"
"Mire Emir Meri Reim"
"Miscreant Marc Stein"
"Mo['] Ribald Lombardi"
"More-Acid Mordecai" []
"Mr. Acid-Mad Ric"
"Mr. It's-OK-To-Smirk Tom Risk"
"Natural-Rant Ula"
"Neat Guy Yue Gant"
"Nerd-Fool Florendo" []
"Nervy Ida Vineyard"
"No-Clue Luc Eno"
"No-Corn Connor"
"No-Duh Hound Duhon"
"No-Limits [if player is male]Tim Oslin[else]Lis Minto[end if]"
"No-Taste Sean Ott"
"Normal Guy Yul Morgan"
"Nostalgia Analogist Stagliano"
"Not-Deep DePonte"
"Not-Deep Peon Ted" []
"Not-Lame Al Moten"
"Not-Lame Tom Lane" []
"Not-Pious Pontious"
"Noticer Ron Tice"
"Nutcase Stu Cena"
"Nuts Al Sultan"
"Nuts Ariel Lauritsen"
"Nuts Belia Blaustein"
"Nuts Bo Butson"
"Nuts Chet Chesnutt"
"Nuts Dan Dunstan"
"Nuts Don Dunston"
"Nuts Echo Schouten"
"Nuts Elrod Osterlund"
"Nuts Erick Steinruck"
"Nuts Gia Agustin"
"Nuts Ken Knutsen"
"Nuts Kris Sistrunk"
"Nuts Larae Arsenault"
"Nuts Leo Uselton"
"Nuts Lora Raulston"
"Nuts Mae Musante"
"Nuts Page Sengupta"
"Nuts Paine Estupinan"
"Nuts Pio Pontius"
"Nuts Reba Eastburn"
"Nuts Rita Tuinstra"
"Nuts Rob Burston"
"Nuts Ted Student"
"Nuts Thor Thurston"
"Nuts Zach Anschutz"
"Nutty Echo Honeycutt"
"Nutty Ol['] Ty Luton"
"Oaf Ali Faiola"
"Oaf Andra Afanador"
"Oaf Berto Barefoot"
"Oaf Burl Balfour"
"Oaf Ed Dafoe"
"Oaf Eric Cafiero"
"Oaf Erick Kiracofe"
"Oaf Geri Figeroa"
"Oaf Gil Foglia"
"Oaf Lan Alfano"
"Oaf Lis Filosa"
"Oaf Lorrie Ferraiolo"
"Oaf Luc Coufal"
"Oaf Mort Formato"
"Oaf Orval Favaloro"
"Oaf Prasad Spadafora"
"Oaf Ren Farone"
"Oaf Rena Faraone"
"Oaf Renzi Fiorenza"
"Oaf Robt Barfoot"
"Oaf Rockwell Rockafellow"
"Oaf Rust Frausto"
"Oaf Sol Lofaso" []
"Obscene Ben Esco"
"Observant Bart Ovens"
"Observer Rob Evers"
"Observy Bry Vose"
"Offensive Sven O'Fife"
"Oft-Lame Tom Leaf" []
"Ol['] Bigot Gil Boot"
"Ola 'Razz' Lazzaro"
"Olin 'Laugh' O'Laughlin"
"On-a-Roll Ol['] Lorna"
"On-Stage Stan Goe"
"One-Liner Oren Neil"
"One-Man Show Noah Newsom"
"Orig. Igor Gori"
"Outraged Rod Tague"
"Overdone Devon Roe"
"Overdone Eve Doorn" []
"Pal Antonio Napolitano"
"Pal Bo Pablo"
"Pal Chas Paschal"
"Pal Danilo Palladino"
"Pal Deena De La Pena"
"Pal Don Poland"
"Pal Drew Waldrep"
"Pal Dustin DuPlantis"
"Pal Eli Paille"
"Pal Erasmo Palomares"
"Pal Ines Espinal"
"Pal Lane Panella"
"Pal Lena Panella" []
"Pal Maclean Campanella"
"Pal Maren Pearlman"
"Pal Merna Pearlman" []
"Pal Neal Panella" []
"Pal Niles Spillane"
"Pal Olinda Palladino" []
"Pal Omer Palermo"
"Pal Remy Parmley"
"Pal Rey Player"
"Pal Rhea Raphael"
"Pal Roy Paylor"
"Pal Silas Pasillas"
"Pal Simona Palmisano"
"Pal Sol Allsop"
"Pal Tera Peralta"
"Pal Thor Lathrop"
"Pal Toni Lapoint"
"Pal Tonie Lapointe" []
"Pal Trey Tarpley"
"Parody-Pro Day"
"PC Ara Capra"
"PC Oreo Cooper" []
"Pert Wit Prewitt"
"Phallic Li'l Chap Cap Hill"
"Pithy Hip Ty"
"Play-Act Pat Clay"
"Play-Dumb Bump Daly"
"Portray-Parroty Apt Rory"
"Potrzebie Tobi Perez"
"Preposterous Petro Sprouse"
"Prime Time Mimi Peter"
"Profane Fran Poe"
"PUA Apu"
"Raconteur [if player is male]Curt Roane[else]Una Rector[end if]"
"Racy Cary Cray" []
"Rad Bo Bardo"
"Rad Chet the Card"
"Rad Gent Ed Grant"
"Rad Hot Dortha Hotard"
"Rad Jon Jordan" []
"Rad Man Armand Manard"
"Rad New Raw Ned"
"Rad Nut Durant"
"Rad Ol['] Lardo Al-Rod Doral"
"Rad Rad Dr. Dara Ard"
"Radical Clarida" []
"Rake Kera Aker"
"Random Jerk Jarred Monk"
"Random Mad Ron"
"Random Man Rod" []
"Ranting Trina Ng"
"Rantly Tarlyn Rylant"
"Rash [tt] Tashiro"
"Rash Abe Beshara"
"Rash Allan Nasrallah"
"Rash Bud Bushard"
"Rash Byrne Hansberry"
"Rash Clem Chalmers"
"Rash Dan Hansard" []
"Rash Dee Rasheed"
"Rash Dina Sardinha"
"Rash Dion Hardison" []
"Rash Ed Sheard"
"Rash Eldon Rosendahl"
"Rash Elton Rosenthal"
"Rash Enid Sheridan" []
"Rash Ewan Earnshaw" []
"Rash Gena Sanghera"
"Rash Gus Shugars"
"Rash Hobert Haberstroh"
"Rash Inez Zahniser"
"Rash Ken Shanker"
"Rash Les Hassler"
"Rash Lew Wahlers"
"Rash Loren Harrelson"
"Rash Lu Shular"
"Rash Marti Arrasmith"
"Rash Mcneese Essenmacher"
"Rash Moe Ashmore" []
"Rash Moffet Hoffmaster"
"Rash Monte Hosterman-Matherson"
"Rash Nat Strahan"
"Rash Ned Dashner"
"Rash Neil Linhares"
"Rash Noe Shearon"
"Rash Nola Haralson"
"Rash Rector Carrothers"
"Rash Red Sherard"
"Rash Robt Barhorst"
"Rash Ron Sharron"
"Rash Signe Hassinger" []
"Rash Sobeck Hassebrock"
"Rash Su Hussar"
"Rash Tad Harstad"
"Rash Tanna Stranahan"
"Rash Theron Hartshorne"
"Rash Thuy Hayhurst"
"Rash Toni Hairston"
"Rash Tyron Strayhorn"
"Rash Wit Swihart"
"Rash Woznick Chrzanowski"
"Raunchy [if player is male]Ryan Chu[else]Caryn Hu[end if]"
"Raw Don Rowand"
"Raw Eve Weaver"
"Raw Gene Wagener"
"Raw Lance Lawrance"
"Raw Ren Warner" []
"Raw Shane Earnshaw" []
"Rebellious [if player is male]Ollie Suber[else]Rosie Buell[end if]"
"Red Nose Don Rees" []
"Refined Ned Frei"
"Reid 'Laff' Raffield"
"Repartee Repeater Peter Rea"
"Revolting Nevil Gort"
"Ribald Al Bird"
"Riffing Griffin"
"Rimshot Tom Rish"
"Rioter Torrie"
"Rioter Torrie Terrio" []
"Ripe Cat Patrice"
"Roaster Art Rose"
"Rob tha Hat-Bro Hobart" [p]
"Ron 'Laugh' Loughran"
"Rough-Edge Greg Houde"
"Rubbish Bri Bush"
"Rude Adella Lauderdale"
"Rude Al Lauder"
"Rude Alan Landauer"
"Rude Ash DeRusha"
"Rude Bao Bordeau"
"Rude Ben Bendure"
"Rude Boy Bud Oyer"
"Rude Cal Caulder" []
"Rude Dale DeLauder"
"Rude Galvin Vanguilder"
"Rude Gena Gendreau"
"Rude Geri Ruediger"
"Rude Gia Guidera"
"Rude Gina Guderian"
"Rude Gino Gourdine"
"Rude Girl Lu Grider"
"Rude Ines Redenius"
"Rude Jana Jandreau" []
"Rude Leanna Landreneau"
"Rude Les Lueders-Duesler"
"Rude Leta Delauter"
"Rude Lina Lindauer" []
"Rude Lisa Urdiales" []
"Rude Marg Magruder"
"Rude Min Dunmire"
"Rude Nat Durante"
"Rude Nilsa Lauridsen" []
"Rude Noe Derouen"
"Rude Oma DeMauro"
"Rude Ona Rondeau"
"Rude Pa Pardue"
"Rude Rob Brodeur"
"Rude Ron Rednour"
"Rude Roni Ridenour"
"Rude Sal Lusader"
"Rude Sam DeRamus"
"Rude Sap Persaud"
"Rude Son Duerson" []
"Rude Sot Stouder"
"Rude Tana Urdaneta"
"Rude Teri Deruiter"
"Rude Trey Deruyter"
"Rude Verla Laverdure"
"Rude Yan Reynaud"
"Sailor Lorisa Larios-Solari"
"Sardonic Rico Sand"
"Sauced Su Cade"
"Send Life, Snide Elf"
"Shallow-LOL Shaw" []
"She-Lout Sue Holt"
"Shlocker Sherlock"
"Shockin['] Hickson"
"Sick Arie Sieracki"
"Sick Asa Isaacks"
"Sick Benet Steinbeck"
"Sick Blue Cebulski"
"Sick Bran Brackins"
"Sick Cher Schicker"
"Sick Don Dickson-Dockins" []
"Sick Dona Dickason"
"Sick Earle Kilcrease"
"Sick Eli Cieslik"
"Sick Eva Vasicek"
"Sick Hilma Michalski"
"Sick-in-Head [if player is male]Dice Haskin[else]Cindi Hakes[end if]"
"Sick-in-Head [if player is male]Hans Dickie[else]Niki Schade[end if]" []
"Sick Kyla Skalicky"
"Sick Lea Cieslak-Lasecki"
"Sick Lech Schickel"
"Sick Leo Solecki"
"Sick Les Sickles"
"Sick Leta Kastelic-Eastlick"
"Sick Lew Elswick"
"Sick Lon Nickols"
"Sick Luna Nicklaus"
"Sick Marg Grasmick"
"Sick Mel Mickles"
"Sick Miko Kosmicki"
"Sick Nola Nickolas"
"Sick Omar Mocarski"
"Sick Oren Erickson"
"Sick Reba Raisbeck"
"Sick Ren 'Snicker' Resnick"
"Sick Rene Ericksen"
"Sick Rob Bosrick"
"Sick Ron Corkins-Rickson"
"Sick Thoman Mackintosh"
"Sick Val Slavick"
"Sickhead Dick Ashe"
"Sicko Bent Bienstock"
"Sicko Dan Dickason" []
"Sicko Hank Kochanski"
"Sicko Kim Kosmicki" []
"Sicko Lan Nickolas" []
"Sicko Mey Comiskey"
"Sicko Ned Dickeson"
"Sicko Nerd Dickerson"
"Sicko Osick Cokis"
"Sicko Ren Erickson" []
"Sicko Wilham Michalowski"
"Silly Big Len Billingsley"
"Simplifier Filip Miers"
"Sin Guy Gus Yin"
"Sin-Laced Snide Cal"
"Sir Des, Disser"
"Slammer [if player is male]Mr. Salem[else]Ms. LeMar[end if]"
"Slangier Signaler [if player is male]Al Grines[else]Ilse Garn[end if]"
"Slo-No-Mo['] Solomon"
"Smarmy [if player is male]Mr. Mays[else]Ms. Mary[end if]"
"Smarmy-Hit Mary Smith"
"Snappier [if player is male]Pip Arens[else]Erin Sapp[end if]"
"Snot Al Slaton"
"Snot Albert Rosenblatt"
"Snot Amie Maisonet"
"Snot Angela Santangelo"
"Snot Bo Boston"
"Snot Butcher Cuthbertson"
"Snot Caleb Constable"
"Snot Cherri Chronister"
"Snot Erick Ricketson"
"Snot Erma Osterman" []
"Snot Ernie Orenstein"
"Snot-Hammer Smotherman"
"Snot Hanna Nathanson"
"Snot Harry Strayhorn" []
"Snot Ian Nations"
"Snot Ida DiSanto"
"Snot Irma Stromain"
"Snot Kia Atkison"
"Snot Lehi Holstein" []
"Snot Lew Townsel"
"Snot Lila Santillo" []
"Snot Mack Stockman" []
"Snot Marie Sarmiento"
"Snot Mirna Martinson"
"Snot Nigel Singleton"
"Snot Petra Patterson" []
"Snot Rager Garretson"
"Snot Roger Torgerson"
"Snot Ruth Thurston" []
"Snot Tami Mattison"
"So-Basic [if player is male]Bo Issac[else]Abi Coss[end if]"
"So-Crude Doc Reus"
"So-Drunk Don Rusk"
"So Dry Dr. Soy"
"So-Frank-of-Snark Ron Fask"
"So-Funny Sonny Fu"
"So-Normal Moron Sal"
"So-Nutty Tony Tsu"
"So-Nutty Ty Uston" []
"So Random Rod Mason" []
"So Trashy Troy Hass"
"So-Trite Rosetti"
"So Vulgar Gus Orval" []
"So-Well-LOL Wes" []
"Stupefier Rupe Feist"
"Sturdy Dry Stu"
"Sweary Ray-Wes Sawyer"
"Tactless Cass Lett"
"Tasteless Tess Astle"
"Tawdry Ty Ward"
"Tawdry Wry Tad"
"Teasing Angie St. Gaitens"
"Teasy Yates" []
"Ted 'Laff' Affeldt"
"Terrible Bret Iler"
"Too-Dark Tad Rook"
"Too-Dry [d-t] Roy"
"Too-Early Ray Toole"
"Too-Glib Gio Bolt" []
"Too-Rowdy Troy Wood"
"Too-Silly [if player is male]Solly Ito[else]Lily Soto[end if]"
"Trashy Rash Ty" [r]
"Trashy Sy Hart" []
"Trendoid [if player is male]Erin Todd[else]Ted Rodin[end if]"
"Trey 'Laff' Lafferty"
"Trey Cohn the Corny"
"Trite Hawk Whittaker"
"Trite King Kittinger"
"Trite Rollo Tortorelli"
"Triteness-Resistent Tess Tiner" []
"Triter Ritter"
"Twee Arch Waechter"
"Twee Gil Weigelt"
"Twee Rich Weichert"
"Twee Shani Nesheiwat"
"Twee Shar Weathers" []
"Twee Sly Westley"
"Tyner 'Baha' Abernathy"
"Un-Rad Darun Duran" []
"Un-Stale Les Tuan"
"Uncensored Corene Sund"
"Unhinged Inge Hund"
"Universal Sin Valuer [if player is male]Raul Nevis[else]Luna Revis[end if]" []
"Unlikely Yul Klein"
"Unrated Rude Nat" []
"Updated Dude Pat"
"Verbose Bev Rose"
"Very Rude Eve Drury"
"Visceral [if player is male]Carl Ives[else]Cris Vela[end if]" []
"Vulgar Enid VanGuilder" []
"Wag Annis Swanigan"
"Wag Anya Ganaway"
"Wag Bell Bagwell"
"Wag Brinton Warbington"
"Wag Enid Wiegand" []
"Wag Erin Winegar"
"Wag Erinn Wangerin"
"Wag Ernie Wierenga"
"Wag Genaro Gongaware"
"Wag Hilde Wadleigh"
"Wag Katia Kitagawa"
"Wag Lara Agarwal"
"Wag Layla Gallaway"
"Wag Letner Greenwalt"
"Wag Lin Lawing"
"Wag Lina Liwanag"
"Wag Macon MacGowan"
"Wag Mena Wageman"
"Wag Mensch Schwegman"
"Wag Mona Magowan"
"Wag Ranae Wagenaar"
"Wag Red DeGraw"
"Wag Rob Grabow"
"Wag Rodin Winograd"
"Wag Sorkin Gawronski"
"Wag Tien Wingate" []
"Wag Tyner Gwartney"
"Wag Zorn Granzow"
"Way-Drunk Rudy Kwan"
"Whitmans, Ham Twins"
"Wild Anne Wineland"
"Wild Edgar Waldridge"
"Wild Fine Winfield"
"Wild Gran Ringwald"
"Wild Hedstrom Middlesworth"
"Wild Larson Willardson" []
"Wild Len Dwinell"
"Wild Lira Williard"
"Wild Maren Wilderman"
"Wild Merlin Windmiller"
"Wild Noakes Lewandoski"
"Wild Ren Windler"
"Wild Rena Reinwald"
"Wild Rolf Willford"
"Wilder Drew Li"
"Wit Anne Antwine"
"Wit Caston Wainscott"
"Wit Cher Wichert"
"Wit Chere Wiechert-Weichert" []
"Wit-Clad Wildcat Walt Cid"
"Wit Dell Tidwell"
"Wit Elfreda Waterfield"
"Wit Elsy Wiltsey"
"Wit Ender Dewinter"
"Wit Ethyl Whittley"
"Wit Gena Wingate" []
"Wit Glen Wiltgen"
"Wit Glenn Wentling"
"Wit Greenan Weingarten"
"Wit Heller Witherell-Wetherill"
"Wit Hollie Willhoite"
"Wit Homer Whitmore"
"Wit Inge Wieting"
"Wit Ira Tiwari"
"Wit Karson Tarnowski"
"Wit Langdon Wadlington"
"Wit Len Wintle"
"Wit Lin Litwin"
"Wit Lise Wiltsie"
"Wit Lon Wilton"
"Wit Lyle Twilley"
"Wit Mana Waitman"
"Wit Meghan Weightman"
"Wit Oren Ortwein"
"Wit Rae Wiater"
"Wit Rathke Whittaker" []
"Wit Rees Siewert-Seiwert"
"Wit Regan Weingart"
"Wit Ren Winter"
"Wit Rene Weinert"
"Wit Renna Wirtanen"
"Wit Ros Ristow"
"Wit Roskos Ostrowski"
"Wit Savannah Viswanathan"
"Wit Sen Westin" []
"Wit Sera Waiters"
"Wit Shanon Washinton-Whisonant"
"Wit Sharon Ainsworth"
"Wit Sheena Nesheiwat" []
"Wit Shenna Whisenant"
"Wit Shera Wisehart" []
"Wit Shon Whiston"
"Wit Slater Stirewalt"
"Wit Tesha Thwaites"
"Wonderful Fun Low Red"
"Word Fool Woolford"
"Word-Shout Hurstwood"
"Wordless Lewd Ross"
"Wrapped-Up Warped Pup Peppard Wu"
"Wry Abel Brawley"
"Wry Adah Hayward"
"Wry Alda Aylward"
"Wry Alec Crawley"
"Wry Amie Waymire"
"Wry Ben Berwyn"
"Wry Cole Crowley"
"Wry Ed Dwyer"
"Wry Elmo Wormley"
"Wry Lea Rawley" []
"Wry Leo Worley"
"Wry Moe Mowery-Wymore"
"Wry Ole Rowley Lowery" []
"Wry Red Drewry"
"Wry Theo Worthey"
"Wry Thorson Norsworthy"
"Yob Al Laboy"
"Yob Leo O'Boyle"
"Yob Les Boyles-Bosley"
"Yob Lew Bowley"
"Yob Mel Mobley"
"Yob Ned Boyden" []
"Yob Shakia Kobayashi"
"Yob Tran O'Bryant-Brayton" []
"Yob Vera Overbay"
"Yuck-Bleh Huckleby"
"Zanier [if player is male]Ezra Ni[else]Inez Ra[end if]" []
"Zingier Ziering"
"Zora 'Laff' Lazaroff"

table of elmo emo [xxm5]
blurb
"Abi's bias"
"Amelia's malaise"
"Barb's abbrs"
"Beau's abuse" []
"Bob's Lie-Lobbies"
"Cathy's yachts"
"Celine's silence"
"Charlie's arch lies" []
"Dreamin['] Merinda" []
"Eli's Lies"
"Elly's yells" []
"Eve's wrath: whatevers"
"Fancier Francie"
"Hurt Ruth" []
"Inane Annie: her pics, ciphers, her slow howlers"
"Kim's grins, smirkings"
"Libeler Brielle" []
"Luann's annuls"
"Margie's mirages" []
"Melinda's [d-word] lies"
"No-Telling Ellington"
"Pam's spam"
"Rene's sneer"
"Richer Cherri"
"Shanice's achiness"
"Stinker Kristen" []
"Susie's issues"
"Taky Katy"
"Taxin['] Xtina"
"Tessa's assets"
"Wantier Terwina" []
"a weekend, weakened"

table of lame computer games [xxm6]
blurb
"Abuser-Girl/Bruiser-Gal Burglaries"
"Ace For a Force" []
"Ace From Eco-Farm"
"Ace Vs. Caves"
"Ad-Rid Air Raid" []
"Adrenaline-Lined Arena" []
"Ah, Gut a Thug"
"Air Wolf Fail Row"
"Airmen Remain"
"Alien Orbit Liberation" []
"Alien Sports: It's Personal"
"All the Lethal at Hell"
"Alpine Leapin"
"And Spies in Spades"
"Ant-Folk to Flank"
"Antiques in a Quest"
"APB: Bap"
"Arfy Fray"
"Arid Raid" []
"Arlena's Arsenal"
"Armada Boss Ambassador"
"Art Show Host War"
"Assert Tasers" []
"Autopilot-Utopia Lot"
"Awe, Havoc, Have a Cow"
"Awe Tourney: One True Way"
"Awestriking Waterskiing"
"Ax of a Fox"
"Ax Them the Max" []
"Ay, Fists Satisfy"
"Ay, Lots to Slay"
"Ay, Lots to Slay: Yo, Last"
"Baby Orcs So Crabby"
"Bad Cop Pod-Cab"
"Bad Game XI: a Mixed Bag"
"Bad Tin Bandit"
"Bag More, Mega-Bro"
"Balder Al, Bred Blader"
"Bane Cartel Tabernacle"
"Bang, Out, Gunboat" []
"Bang, Tilts, Battlings"
"Bantam Batman"
"Barbarian Brian Raab"
"Base Itch: Cab Heist"
"Basest Beasts"
"Battles of Left Boats"
"BBL, O Blob"
"Be-Dry Derby"
"Be Foes of Bees"
"Be Grown, New Borg"
"Beating Big [n-t]"
"Beer-Clash Bleachers"
"Behold a Bad Hole"
"Bilk [']N Blink"
"Blam, Set, Bam, Let's Blast [']Em"
"BLAM! The Meth Lab" []
"Bling/Rug Burgling"
"Blings O['] Goblins"
"Bold Moves Mobs Loved"
"Bomber Mobber"
"Bonk Castle Blackstone"
"Bonus Bo'Sun"
"Bops to Po['] Bots"
"A Bounce on a Cube"
"Box the HexBot"
"Break Into Oteri Bank"
"Breakout Outbreak"
"A Bridge Brigade"
"Bronze Zen Orb"
"Bruiser Gal Burglaries"
"Bum-Wrath Thumb War"
"Bungle-Hit Blue Thing Bilge Hunt"
"Burst-Sea Brutes as Abstruse"
"Bust King Stinkbug"
"Bust-O-Bouts"
"A Byte Thug: Be That Guy"
"Cadet Acted"
"Cage Fight: Fetch a Gig"
"Call the Hellcat"
"Canniest Ancients Instance"
"Canvased Sandcave Advances"
"Captive Cave Pit"
"Captives['] Cave Pits"
"Car Hits: Crash It" []
"Car Wash Cash War"
"Carl, Mini-Criminal"
"Cash-Riot Chariots"
"Casted Cadets"
"Cave-In Ave., Inc"
"Caves and Advances" []
"A Celt's Castle"
"Cheops Epochs"
"Chips Real Spherical"
"Chore Gang Org Change"
"Clash for Half-Orcs"
"Clasp Nine Pinnacles"
"The Cliffs: Filch Fest"
"Clout a Couatl"
"Colgate Cage Lot"
"Colonize Coil Zone"
"Commander Mac Redmon"
"Commodore's Cosmodrome"
"Comrades to Motorcades"
"Console O['] Clones"
"Consume One Scum" []
"Cop Ode, DopeCo Cooped"
"Cop Raid Picador"
"Cop-Riven Province"
"Corner a Rare Con"
"Counter-Spies['] Persecutions"
"Crash-Fine Franchise" []
"Craterlet Clatterer"
"Cream Mr. Ace McRae"
"Create My Cemetary"
"A Cricket's Ice-Tracks['] Ace Tricks"
"Crime-Org Grim Core"
"Crop-Meet Competer"
"Cry Duel Crudely"
"A Cyanotic Action Cay"
"D'oh, Get the Dog"
"Dang Let's Get Lands"
"Dang Our Gun Road: No Guard Aground" []
"Dare-Port Predator"
"Daring Test: It's Granted"
"Dawn's Wands"
"Dean's Andes Sedan" []
"Death Rink in the Dark"
"DeathCo: the Coda-Cathode"
"Defilin['] Infidel"
"Delish Delish Shield is Held--Eh, Slid"
"Demolish His Model" []
"Demon Monde"
"Destroyer Orders Yet" []
"Destruction-Inducer Tots"
"Dice-Roll Collider"
"Dime Hunt in the Mud"
"Discover Irv's Code"
"Disembark, Mad Bikers"
"Divas: Sad Vi Davis Vs. Ida"
"The Dive, Thieved"
"Do for Frodo" []
"Do Spar So, Pard"
"Doglegs Slogged"
"Don't Have a Death Nova"
"Doorstep Torpedos"
"Dopest Despot Depots"
"Dr. Dale's Addlers-Ladders"
"Drag Those Goatherds"
"The Dragon: Hot Danger"
"Dread Holt, Death Lord"
"Drop Low, Do Prowl"
"Dub Rivers, Bus Driver"
"Duels Led Us"
"Dungeoner Gone Under"
"Dungnose Dungeons"
"Dyad D-Day"
"Dynamicer Dry Ice Man"
"Earth Two: Hot Water"
"Earthdune Deathrune"
"Eek, Trap a Parakeet"
"Egerton's Ogre Nest"
"Electorship Helicopters"
"Elf Crone Florence" []
"Elf Folk Hit: the Kill-Off"
"Elfling Felling"
"Elim-Mile"
"Embargo: Bag More" []
"Enchanter, Moo More Than Once"
"Ent Net Ten"
"Ents Sent: Tens"
"Epic Rash Parchesi"
"Erase, Kill, Laser Like"
"Err, Nag Ranger Garner"
"Espionage: a Genie's Op"
"Euro Sect to Rescue"
"Explo-O-Plex"
"Fabled Bad Elf"
"Far Totem of Matter"
"Farce-Hit Car Thief"
"Faria's Safari Is Afar"
"Fast-Clone Felon Acts" []
"Fast Free Fear Fest"
"Faster Strafe-Afters"
"Fate Row: a Two-Fer of Water"
"FBI Gun Big Fun"
"Fembots Mob-Fest"
"Filch [']N Flinch"
"Find Thee the Fiend"
"Fire-Torn Frontier"
"First-Place Fist Placer"
"Fit-Core Ice Fort: Force It"
"Five-Star Fit-Raves"
"Flee Crypt Perfectly"
"Flick the Thick Elf"
"Flo's Elf Sell-Off"
"Foil Dr. Ilford" []
"Forceful Cruel-Off"
"Four-Day Duo Fray"
"Frame [']Em Far"
"Franchsied Arch-Fiends"
"Freakworm Framework"
"Free Capt. Fatcreep" []
"Frightened Freed Thing"
"FUBAR, Ur-Fab"
"Fun Zone of Un-Zen"
"Furies of Our Fiefs"
"Gah, Ply a Glyph"
"Games O['] Omegas"
"Gas [']Em Games"
"Gee, Math: the Game"
"Gen. Bloody, Golden Boy"
"Gerardo's Rad Ogres"
"Get Half the Flag" []
"Get Him: Ban the Big Man"
"GI Fort of Grit"
"Gillmore Ogre Mill"
"Go-Lame-a-Golem Ol['] Game"
"Go Mental to Mangle"
"Go Snipe Pigeons"
"Go Soil Igloos"
"Go, Wrath Warthog: a Growth"
"Gogar's Aggros"
"Gold Pot: Plot, Dog"
"Gold-Tiara Gladiator Triad Gaol"
"Gore Cave Coverage"
"Gory Huns So Hungry"
"Gory Orgy" []
"Got a Row, Go to War"
"The Grand Prix: Next Hard Grip"
"Grim Mr. GI"
"Gringo Goring"
"Groin-Gorin['] rig: ON" [p]
"Gross, Inc. Crossing"
"Grotesque Ogre Quest"
"Grueling Luge Ring" []
"Grues['] Urges Surge"
"Guam's Magus"
"A Gun By Any Bug"
"Gun Down Dung Now"
"A Gun Raid Guardian"
"Gunner Idly Lying Under Enduringly"
"Gyms for My Frogs"
"Half-Pipe Flip Heap"
"Halt, Briny Labyrinth"
"Happier's Sapphire"
"Hate Shotgun, Hostage Hunt, the Hangouts: That's Enough"
"Hater-Slug Slaughter"
"Have Wands Wave Hands"
"Hector the Orc"
"Heel-Post Pest-Hole"
"Heist Done on the Side"
"Heist-Op: It Hopes? Oh, Spite" []
"Helidromes Demolisher"
"Hell-Dirt: The Drill Thrilled" []
"Help Gut the Plug"
"Help Us U Shlep"
"Here Fill Hell Fire"
"Hero Nat: No Heart, Nor Hate" []
"Hero Rohe-Oher"
"Heroes Rose, Eh" []
"Hew Past the Wasp"
"Hidings Dishing Shindig"
"Hip Bistro Orbit Ship Prohibits"
"Hire One Heroine"
"His Car I Crash II"
"Hit and Run Darin['] Hunt"
"Holy Fiord Hydrofoil"
"Holy Fist, Oh, It's Fly"
"Hoodlums['] Slum Hood"
"Horridest Horde, Stir" []
"Horridest Short Ride"
"Hot Dare or Death" []
"Hot Dome: the Doom"
"Hot Gas: a Ghost to Gash at, Gosh"
"Housefly: Uh, Sly Foe"
"Hovercars Crash Over"
"How-Snug Gun Show"
"Hurt, Pow, Throw Up"
"I Debut But Die"
"I Fry a Fairy"
"I Maim Miami"
"I, Norman, Iron Man"
"I Prevent ViperNet"
"I Push Up His U-Ship"
"I Raze Zaire"
"I Shaft at Fish" []
"I Spoon Poison" []
"I Thud it, Duh"
"I, Trojan Janitor"
"I'll Skunk Skull Kin"
"I'm-Gorier Grimoire"
"I'm My-T-Timmy"
"I'm Tough: Go Hum It" []
"Ian Chung's Chain Guns"
"Ice World: Wild Core"
"If Den Fiend, I Fend: Endif"
"Imhotep's Time Hops" []
"Imperialist Primalities"
"Imps W/Wimps"
"Infidel Fieldin[']" []
"Insatiable Alien Baits"
"Insular Sail Run"
"Intense Nine-Set Tennies"
"Ion Rig Origin"
"Iron-Clad Clorinda Alcindor" []
"It's Near, Antsier, Nastier: Snare It"
"Ivana, a Vain Avian"
"Jostler-Jolters"
"Jungles or Jongleurs"
"Junta Jaunt"
"Kill-Back Kickball"
"Kill Him, Kim Hill"
"King is Skiing"
"A KO Brute Outbreak" []
"Land Rover Raven Lord"
"Lane of a Felon"
"Lard-Dork, Dark Lord"
"Las Vegas Salvages"
"Lasered Leaders"
"Lasers['] Rassle"
"The Last Stealth"
"Latescent Tentacles"
"Le Scum Muscle"
"Le Turbo-Trouble" []
"Leap on One Alp"
"Let's Find Des Flint"
"Lich-Nerd Children"
"A Lie Clan Alliance"
"Lo, Dwarves, Save World: Loved Wars"
"Log a Hit, Goliath"
"Loki's Kilos"
"Loogy-Ology"
"Loose-Scum Colosseum" []
"Lord W.'s Worlds"
"Lost City Coy Tilts"
"Lost Pig Pit Slog"
"Lotion Lootin[']" []
"Lou, Swat Outlaws"
"Lurk, Spy, Sulk, Pry"
"Lyssa Slays Alyss"
"Mac Reest Creamtes Meercats"
"Macabre Beam Car Race, BAM"
"Machines, Ani-Mechs" []
"Mad Slime Dilemmas"
"Mad Strike Master Kid"
"Magic GI Mac"
"Magus Net Mutagens"
"Maint-a-Mint at Min"
"Majestic Cami-Jets" []
"Malibu's Bums Ail"
"Manic, I Gas Magicians"
"Manor's Ransom"
"Manticore Cremation"
"Marry Mr. Ray Rymar"
"Mars Arms"
"Martians A-Smartin[']"
"Marv's Tin Varmints"
"Mastering Emigrants" []
"Mean Ex-Axemen"
"Mega GI Maggie"
"Minotaur-Roam Unit"
"Mm Yeah Mayhem"
"Mob-Cast Combats"
"Mock a Whale, Whack a Mole"
"Mom's Rune Summoner"
"Mope South, Shoot [']Em Up"
"Mort's Storm"
"Mr. Ice's Crimes"
"Mr. Rope-Romper"
"Mr. Rude Murder"
"Mr. Stone's Monsters"
"Mr. Vine Vermin"
"Mt. Akers/Maker St. Markets"
"Mug Cabs, Scumbag"
"Mug the Gem Hut"
"Mum Dan and, Umm, Mud Man"
"Mutilation Unto a Limit"
"Myth Court: Much to Try"
"Nail-Ops So Plain" []
"Narc Pad and [crap-u]"
"Nasty Foe, No Safety"
"Nations Merit Terminations"
"NatureNauter"
"Neanderthal Earthen Land"
"Neutronic Continuer Centurion"
"Next Wave: Vex a Newt"
"Nifty Fytin[']"
"Night Foe in the Fog"
"No Magic? Go Manic"
"No-Nudge Dungeon" []
"No-Warez War-Zone: Raze Now"
"Non-Sacred Ordnances"
"Now-Proud Pro-Wound Downpour"
"Oarless Lassoer"
"Oddric's Discord"
"Ogre Ergo Gore"
"Ogre Hut: Tougher"
"Oh, Madder Hard Mode"
"Old Gods['] Odd Slog"
"Old Guard Drug Load"
"Omega God: Agog Demo"
"Omerta: a Metro To Ream"
"OMG Rue Morgue"
"One Foot Onto Foe"
"Or Fly Combat Comfortably"
"Orbits Bistro" []
"Orcy Cryo-Cory"
"Outslay You Last"
"Ovals Salvo"
"Paint a Pinata"
"Palace Spy Playspace"
"Panic-Mosh Champions"
"Parking Lot Patrol King"
"Pas-Mal Plasma"
"Pasted Adepts" []
"Pelt Em Temple"
"Pesterous Proteuses"
"Petrel Pelter"
"Physical Yip-Clash" []
"Pick the Pit, Heck"
"Picross So Crisp"
"A Pilot's Top Sail"
"Piranha [']N Pariah"
"Pistol Pilots" []
"Pit Four: Up for It"
"Pivotal Oval Pit"
"Place Six Lax Epics"
"Planet Ten, Pal"
"Planetarium Manipulater"
"Pods [']N Ponds"
"Poke-[']Em-Mo['] Keep"
"Pop's Rat Roast: a Sport to Spar"
"Porkshow Workshop"
"Ports-O-Troops"
"PPV PVP"
"Primates-Spar Time"
"Pro Style Prey Lots"
"Pro-Wars Spar Row"
"P.S. Tom, Stomp Ms. Top." [p]
"Puke-Race Up a Creek"
"Punk-Car Crank-Up"
"Push Out Up South"
"Put a Horde Up the Road"
"Queer Best Beer Quest"
"Quell This: Hill Quest" []
"Quest O['] Quotes So Qute"
"Quieter Requite"
"Quonset Quest: On"
"Raiders Dare, Sir"
"Raiders of Fire Roads"
"Raids On Inroads"
"RamTek Market"
"Rapidest Pest Raid"
"Reach Thy Hatchery"
"Reamings, Smearing" []
"Recessed Seceders"
"Red Air Raider"
"Red Thing, Nth Dirge"
"Reds [']N Nerds"
"Redshirting Night Riders"
"Refine Op, Open Fire"
"Regentship Spree-Thing"
"Reichs['] Riches"
"Retool, Looter"
"Ribs Gone? Sobering"
"Rid a Raid" []
"A Rider-Raider" []
"Rifle Op Profile of Peril"
"Ring of Forgin[']"
"Risk, Set, Strikes"
"A Risky Sky Air"
"Risky Vale Valkyries"
"River Road Rover Raid"
"Roach-Post Crapshoot"
"Roads So Rad"
"Robo-Boro"
"Robustly Lost Ruby"
"Rod W. Bass, Ward Boss"
"Rodent Tendor"
"The ROM-Mother"
"Rooftops of Troops"
"Rouge Rogue"
"Rube's Rebus"
"Rude Tavern Adventurer"
"Rudest Cabin Disturbance"
"Rush Ten Shunter-Hunters"
"Sabotage a Beast! Go"
"Sailors['] SOS Lair" []
"Saint Al, Lanista"
"Salutations Into Assault"
"Save Eva's Vase"
"Scalper Parcels"
"Scry Up Cyprus"
"Scum Path Matchups" []
"Sea Trip Pirates"
"Sedentary Try-and-See" []
"Seeing Genies"
"Seek Tony Keystone"
"Senshi Shines"
"Set Elf Fleets"
"A Setup Up East"
"A Sexy Ax, Yes"
"Sharpie Harpies"
"A Shmup Mashup"
"Shoot Down Hood Towns"
"Sidecar Is Raced"
"Simoni's Mini-SOS Mission"
"Sing Loud, Solid Gun"
"Six-Gun Heat: Exhausting"
"Skylord, KO Dr. Sly"
"Slap-[']Em Sample"
"Slathering Earthlings"
"Slay-Um Asylum"
"Slayer Relays/Slayer Layers"
"Slice On In Close"
"Slime-Ops So Simple"
"Slimy Cop Olympics"
"Slippery Peril Spy"
"Slobb-Blobs Lob BS"
"Slopy Ploys, Po['] Sly Ol['] Spy"
"Slur the Hustler"
"Smack [']Em Down, Scammed Wonk"
"Smokin['] Hot Mosh-Tokin[']"
"Sniper En Pris"
"Snipers or Prisoners"
"So Draw a Sword"
"So, Fright or Fights"
"So Ply, Ol['] Spy" []
"So-Retro Rooster"
"Soho Bay Booyahs"
"Some Fair of Armies"
"Sonar Arson" []
"Sorcerer Rescorer"
"Sought-After Hostage Turf"
"Soul Fight: Foil Thugs"
"South-Wind Whodunits: WITH SOUND"
"Southland Duathlons"
"Sparest Pasters"
"Speed Pedes"
"Spider Net President"
"Splat or Portals"
"Splay-Plays"
"Splot Plots"
"Spook KO Ops"
"Sporadic Picadors"
"Spot Clue Couplets/Octuples"
"Sprint [']N Trips" []
"Spyplane Playpens"
"Squire and Quandries"
"St. Thief the Fist" []
"Stage One: Gone East"
"Stagin['] a Sting"
"Stampier Primates"
"Steal From Soft-Realm Lame Forts"
"Stilt Tilts"
"Stimulation Mutilations"
"Stop Elk Kleptos"
"Stop the Hot Pest"
"Storming Mr. Stingo: I'm Strong" []
"Strangle Les Grant"
"Strateg-Targets: Get, Star"
"Strateg-Targets: Test Rag" []
"Streak-Skater"
"Street Setter"
"Streetcar Scatterer"
"Stun Gun, Nun Guts"
"Super Macho Campus Hero"
"Super-Quick Quip Sucker Squire Puck"
"Superstar Pasturers" []
"Surgeon, Nurse, Go"
"Swat it: a Twist"
"Swervyn['] Wyverns"
"Swordman, Sandworm"
"Tactile Lattice Ace Tilt"
"Tame Meat, Mate"
"Tan it, Titan"
"Tank Raid: in at Dark"
"Tar [']Em, Tamer"
"A Target Regatta"
"Tastes Like Elite Tasks"
"Team Drill Treadmill"
"Tear [']Em Up Pure, Mate"
"Test Pod Spotted"
"Testin['] Ettins"
"Theif of Hot Fief"
"Theobald Bothdale, Hot Blade"
"Thief Ordeal: Life or Death"
"Thingies Heisting"
"Threat Epoch: Reach the Top"
"Thugster Gets Hurt"
"Thy Pro Trophy"
"Thy Seek: the Keys"
"Tia Quern, Quainter Antiquer"
"Tiny Axe Anxiety"
"To Break Beak Rot, TAKE ORB"
"To Crash Hot Cars" []
"To Fights, Fit Ghost"
"To Kill Till OK"
"To Progress: Gore Sports"
"To Ship Hit-Ops"
"To Stab at Bots"
"To Swarm at Worms"
"Toastin['] Station" []
"Too-Hard Hot Road" []
"Top Cars to Scrap: Captors or Pacts" []
"Top Games: Most Gape"
"Toros['] Roost"
"Traffic Car Tiff"
"Trained Foe Federation"
"Trash Coop Crapshoot" []
"Tree Plot Teleport"
"Trikes Strike"
"Troop'n Proton" []
"Trucks Struck"
"Truster Turrets"
"Try Fo['] Forty to Fry"
"Tuf-Range: Gun After Great Fun"
"Turn One Neutron"
"A Twig: Wag It"
"Ug, Funk Kung Fu"
"Ugh, Test the Guts"
"Uh, Cult, Cthulu"
"Uh, Tag a Thug" []
"Ultmut Tumult"
"Um an Nth Manhunt"
"Un-Reserve Revenuers"
"Underling: a Lair, Gunned"
"Unearthly Hunt Relay"
"Unnatural Lunarnaut"
"Unresting Insurgent"
"The Urn Hunter"
"Us, Bloody Body, Soul: Doubly So"
"Virtual Ritual V"
"Wall it at Will"
"War Nine: a Winner"
"War of Dr. Forward"
"The War W/Earth"
"Ward Off Dwarf of Fafword"
"We Found Feud Now"
"Weapons Ops Anew: Snap Woe" []
"Weavers Aswerve"
"Wet Ogres Get Worse"
"Whelp Bout: The Blow-Up"
"Where Did Drew Hide"
"A Wild Crazy Clay Wizard"
"Wisdom Crag Magic Sword"
"Wood, Barns, Snowboard"
"Worldsong Longsword"
"Ye Thug Huge Ty: Hey, Gut the Guy"
"Yes to Dr. Destroy"
"Yo, Cars So Racy"
"Yon Ops Snoopy"
"Yon True Tourney"
"Yow, a Thug Way Tough"
"Zero-Harm Remorhaz"
"Zombie: a Bio-Maze"

table of lame movies [xxm7]
blurb
"[if player is male]Burt Oakes[else]Tresa Kubo[end if] Breaks Out"
"[n-t]'s Pets: Past Tense"
"Abdul's Bud Sal"
"Abysmal Amy's Lab" []
"Admiral Dalarmi"
"Aforementioned Foe, Renominated"
"Ages of Safe-Go"
"Ail by Libya"
"Alias Alisa"
"Alien Trove Revelation"
"Android Dorinda" []
"Anger Set, Sergeant"
"Annoying Nanny, I Go"
"Ape, Colt, Capt. Leo, Ace Plot"
"Arriba, Ibarra"
"Arsenic Carnies"
"Art Reid Tarried Tardier"
"Arv, Be Brave"
"Ay, Mild, Milady"
"Ay, Sir, Syria"
"Ayoub Bayou"
"A B-Day by Ada"
"Back Me, Ma Beck"
"Bad Run, Dunbar"
"Band, Slime Mandibles"
"Basement Beast Men"
"Be Around a Dune, Bro"
"Be Calm, McBeal"
"Be Sick, Si Beck"
"Be Wed, Dweeb"
"Beetle Le Bete"
"Belly Up, PE Bully"
"Betrayal-Later Bay"
"Big Bang Bib Gang"
"Black Spot Plots Back"
"Blackout at Club KO"
"Bland Hero Bohlander"
"The Blob Lobbeth"
"Blumsted Stumbled"
"Bo's Pluck Blocks Up"
"Bods Can Abscond" []
"The Bold Bot Held"
"Boor Jeff's Job Offers"
"The Borg Got Herb"
"Born Yet, Rent Boy"
"Bot Tot Bob"
"Break Bad, Dark Babe"
"Bring Hot Brighton"
"Broodiest Robots Die"
"The Buck Huck Bet"
"Bus Day: Dubya's Sad Buy"
"Cadavers As Carved"
"Caress-Scares"
"Carnivorous Coronavirus"
"Cash in, Mr. Chrisman"
"Castle Den: Let's Dance and Select"
"Cay Fort Factory"
"Cesium Miscue"
"Chad Bogue, Douchebag"
"Chamber Pot Camp Bother"
"Chet's Ma Matches the Scam"
"Chicken-Pot Kitchen-Cop Checkpoint"
"Chum in Munich"
"Cis-Male Scam Lie"
"The Claws Chew Last"
"A Clip: I Clap"
"Clochard Dr. Cal Cho"
"Clone is In Close" []
"Cold Ones So Cloned" []
"Colin Is Silicon"
"Con Five: Vince of Fin Cove"
"Con Pete, Teen Cop"
"Constarn Scranton"
"Corpse Scoper Crespo"
"Countess Contuses"
"Coward War Doc" []
"Crank Up, Punk Car"
"Crave, Sad Cadavers"
"Creep St. Specter"
"Creepier Creperie"
"Crept a Carpet"
"Crisp Blue Republics"
"A Crown's Snow-Arc"
"Cults O['] Clouts"
"Cute Romp, Computer"
"Dad, Ann and Dan"
"Danseur Asunder" []
"Dark Side Adds Erik" []
"Darker Red Ark"
"Darn Big Brigand Barding"
"Dear San Andreas"
"Death is His Date"
"Death Toll at the Doll"
"Deathless, These Lads"
"Deed of Mr. Deformed"
"A Def Cop, Po-Faced"
"Deja Jade"
"Delicate Cadet Eli"
"DeRossi Rides So"
"Derp, Dr. Epperd"
"DethsCo: The Docs"
"Dinesh Shined"
"Dis Qua? Quaid's a Squid"
"Disadorn Androids"
"Discarnate Eradicants"
"Dishes Hissed Ssh, Die"
"A Ditz's Sad Zit"
"Do Fall, Old Alf"
"Doc Ade's Odd Case"
"Doc's Err-Records" []
"Done-For Roof-Den"
"Dr. Egan's Dangers"
"Dr. Geist Gets Rid"
"Dr. I Play Rapidly"
"Dr. Idle-Riddle"
"Dr. Neo's Drones" []
"Dr. Roach-Orchard"
"A Driver's Rare Vids"
"Duffers Suffer'd"
"Dugger's Grudges"
"Dullard Dr. Udall"
"East to O-State"
"Ecker Creek"
"Eclosion Colonies"
"Effigy Giffey"
"Eggplant-Pelt Gang"
"Eh, Boring Neighbor Hoinberg"
"Elf T Felt Left"
"Endurers Sunderer Nurse Red"
"Engquist's Questings"
"Enquist's Inquests"
"Entreat Ratteen"
"Epstein's Ten Spies"
"Espana Paeans"
"Etheredge: The Degree"
"Ethereous Treehouse"
"Evie's Sieve"
"Evil Lag Village"
"Excuse Us, Exec"
"Fast Moving Vomit Fangs"
"Favorites for Evita's" []
"The Fear's Here Fast"
"Fearing Fangier Fergina"
"Felix's Elf Six"
"Ferengi Freeing"
"Fiddler Dr. Field"
"Figure Out: I Go Future" []
"Filler: Re-Fill"
"Final Girl: Grain-Fill Lair Fling"
"Flavor For Val"
"Flawless Wes's Fall" []
"Fly Me My Elf"
"Foley's Sly Foe So Elfy"
"Formulated Artful Demo" []
"Foul Sour Soul Four"
"Foundlings['] Unfoldings: Gold, Fun, Sin"
"Frau Rauf"
"Frayed Dr. Faye"
"Free Pop For Pepe"
"Freedom From Dee"
"Fretting Gent Rift"
"The Frogs Got Fresh"
"Front Line: None Flirt"
"Frosh Lick Rich Folks"
"Fruits Rift Us"
"The Fun Fen Hut"
"Furnaces-Scare Fun"
"Gals, Save Las Vegas"
"Garbled Lad Berg"
"Gee, Sal's Ageless"
"Genetics Gets Nice"
"Genuine Ingenue Un-Genie"
"Give Back, Gabe Vick"
"Glam Reb Gambler"
"Glean His Healings, Hang Lies"
"Glow-Fang Wolfgang"
"Gnomish Moshing"
"Go Hug Gough"
"Go Surf for Gus"
"The God-Goth, Ed the Dog" []
"Godlike Lego Kid"
"Gonk Kong"
"Good Night, Doting Hog"
"Goon Ted Got Done"
"Gory Ygor" []
"Grade-A Dreg" []
"Greaser Regears"
"Green Miss Messinger"
"Grim Old Lord Mig"
"Grow Up to Group Two"
"Guess Why Yews Gush"
"Gutman's Mustang Stung Ma"
"Guts Lie Ugliest" []
"A Hack, Mr. Rackham"
"Hades Has Ed: Eh, Sad"
"Halloween: a New Hello"
"He's Murphy Humphreys"
"Heel Quest: the Sequel"
"Hep Rolf: Help for Her Flop"
"Hero Dr. Herrod"
"His Paw Was Hip"
"Hot/Cold Doc Holt"
"Hugo St. Toughs"
"A Hunted Haunted Un-Death"
"Hup, Lord Rudolph"
"Hurr, Ooze Zero Hour"
"Hut, Fear the Frau"
"Hutless Lushest Hustles"
"Hypocentral Lycanthrope"
"I Drove Over Di"
"I Nuke Unkie"
"I Swap a Wisp"
"I Votes Soviet"
"I Wear a Wire"
"I, Wrath Wraith"
"I'd Scream I'm Scared"
"I'm Part Armpit"
"Id-Cures: Scuderi Cruised"
"If Afar, Affair"
"Inceptions Inspection"
"The IRS Riseth"
"Is Prom So Prim"
"It Opts to Spit"
"Jacobson: a Con's Job"
"Jem or Mr. Joe"
"Jim's Boy is My Job"
"Joe Bay's Easy Job"
"Kept From Fort Kemp"
"Kid of OK Dif"
"Kill-Em-Tons Motel Links"
"Koop's Spook" []
"Kostner Treks On"
"La Grange's Real Gangs"
"Lab Tot Talbot"
"Lamia Malia"
"Lanyard Lad Ryan"
"Larceny-Cry Lane" []
"Last-Fog Gas Loft"
"Last King Talkings"
"Last Stop Lost Past"
"Last Time Mist Tale"
"Latte St. Tattles"
"Law Firm Raw Film" []
"Le Con-Clone"
"Le Doc Dolce"
"Le Fief Eiffel"
"Le Star Staler"
"Le Wolf-Fellow"
"Lech Wes Welches"
"Li'l Pip's Lip Slip"
"Like Mr. Kilmer"
"Likely, Kelly, I Kill Ye"
"Lion Gang's Sing-a-Long"
"Loss-Cite Solstice"
"A Lost Buck Blacks Out"
"Low Budget but Glowed"
"Lupe Can Clean Up" []
"Luther Ruleth: Le Hurt" []
"Macky's Sky-Cam"
"Magical Gal Cami"
"Maimed Maid Em"
"Maniacs in a Scam"
"Mars MRSA/SRAM" []
"Marty, My Rat"
"Masoning Moanings" []
"Max's XMas Xams"
"Maybe Be Amy"
"Meds and Demands"
"Mehmet, Them, Me"
"Melt-So Motels"
"Merriest Triremes"
"Mesmerist Mimesters"
"Met Sir Mister"
"Milo Lin's Millions"
"Mind Meld, Mild Mend"
"Misha Has [']Im"
"Mo['] So Cute Outcomes"
"Moanins Mansion"
"Mob Boss Bob Moss Bombs So"
"Mod Man and Mom"
"Mom Ices Commies"
"Mom, Us: Cinque Communiques"
"A Mongo Goo-Man"
"Moonlet Toolmen"
"Morphia's Aphorism"
"Most Care to Scream"
"Mr. Bulgy-Grumbly"
"Mr. Cartoon Cormorant"
"Mr. D & Dr. M"
"Mr. Demise-Immersed"
"Mr. Eno's Sermon"
"Mr. Kagin's Markings"
"Mr. Psi-Prism"
"Mr. Thief Herm Fit the Firm"
"Ms. Kelli Kills [']Em"
"Ms Murder-Drummers"
"A Much Fun Fu Manchu"
"My Calf's Fly Scam"
"My Death on the Monday"
"My Depth is Dim: the Spy" []
"My Li'l Milly"
"My Org is So Grimy"
"My Pal's Sly Map"
"My Sis Missy"
"Nasty Dice Syndicate"
"Ned Chute, the Dunce"
"Neighbors Be Horsing"
"Neolith Hotline" []
"Newlywed Wendy Lew"
"News Rally, Yell Warns, Swell Yarn"
"The Next Tent Hex"
"Nick's Go Socking KingsCo"
"No, Dr. Nord-Dorn"
"No Fuss of Suns"
"Non-Insect Innocents"
"Nope, Dr. Penrod"
"Now Mac Can Mow"
"Noxious Sioux? NO"
"Nuts St. Stunts"
"Of Fans So Naff"
"Of Stu Foust" []
"Oh, Bring Big Horn Nigh, Bro"
"Ol['] Bart's Borstal"
"Old Seer Delores"
"Old Theo's Toolshed"
"Olin's Losin['] Lions"
"Olsen's Lesson"
"One Jury Journey"
"Or Scape a Corpse"
"The Org Got Her"
"Our Frat's Four Star"
"Our Jr. Juror"
"Outsider Suitor Ed"
"Pagan Hero Orphanage"
"Palmetto Meta-Plot"
"Paltrier Pre-Trial"
"Papers of Oaf Perps"
"Parkin[']: I Prank"
"Path Set: the Past"
"Payphone Hypopnea"
"Pediatric Patricide"
"Pepe Wu's Wee-Pups Sweep-Up"
"Perraut's Raptures"
"Persevere, Rep. Reeves"
"Pip the Hip Pet"
"Pip's Gig: Gip Pigs"
"Pip's the Hippest"
"Plan Eight: Night Plea"
"Plan Nine: Linen Nap"
"Pluto's Up Lost"
"Pockets, Sock Pet"
"Poshie Sophie"
"Potent Top Ten"
"A Potty-Yap Tot"
"Powell's Swell Op"
"Prat-Trap Part-Tarp"
"Precursor Procurers"
"Predictable Debacle Trip"
"Prepski Skipper" []
"A Pro Cynic's Conspiracy"
"Prophecy-Cypher Op"
"Quinn's Mean Mannequins"
"Quotes-O-Quest"
"Raffia Affair" []
"Ram Out a Tumor, Mr. Auto"
"Ramires Marries"
"Raw Clinks Skin-Crawl"
"Reed's Seder"
"Remedies Seem Dire"
"Renege, Greene"
"Retains Nastier Retinas" []
"Reviser Reivers"
"Riley's Sly Ire"
"The Rink Thinker"
"Riptide Die-Trip"
"Risen-Field Friendlies"
"Rockin['] on: Rick or Nick" []
"Rubbery Rube Bry"
"Sabkha, Kasbah"
"Sad Lev Valdes Slaved"
"Same Blind Semi-Bland Mandibles" []
"Say, Rude Duryea's Rues Day"
"A Scent Can Set"
"A Scion's Casinos" []
"Scoffin['] Coffins" []
"Scumball Cam's Bull"
"See Our Rousee"
"Seed-Pod, Deposed" []
"Seine's Sensei is Seen"
"Senor Norse" []
"Sensing Ensigns"
"Shafter-Fathers" []
"She Leads, Headless"
"Sheikh's Shikseh"
"Sherice's Richesse"
"Shriek, Hikers"
"Shrivelled Hell-Divers"
"Shy Pet the Spy"
"Six Pie Pixies"
"Six Ref Fixers"
"Sky Ace Caskey"
"Sleepy Spy Lee"
"Sloppy Plopsy-Polyps"
"Sly as Lyssa" []
"Sly Pig, Spy Gil"
"SMH to Moths"
"So-Deep Seed Op"
"So-Pretty Pet Story" []
"So-Pudgy Pod Guys"
"Soldier Deloris"
"Solstice: It's Close"
"Sombrest Mobsters"
"Some Iced Comedies"
"Spooks KO Sops"
"Spooky Sky Poo"
"Sportier Pierrots"
"Springhouse Surgeonship"
"Sputnik Stink-Up"
"Spy Ring Pryings"
"Squeak-Rat Aqua Treks"
"Squick-O So Quick"
"St. Lucian Lunatics"
"Starriest Sister-Rat Traitress"
"Starship Harpists"
"STD & TDs"
"Stickball Blacklist"
"Stone Cold Oldest Con"
"Stray Bot So Bratty"
"Stu-Not-Stout [']N Sutton"
"Styrofoam Toys From a Soft Mayor"
"Super Rod Orders Up"
"A Sure Hood Road House"
"Switching Witchings"
"Ta, Mrs. Smart" []
"Tall Lt. Al"
"Tarantino Art Nation"
"TARDIS Triads"
"Teen Mom Memento"
"Ten Pals['] Planets"
"Ten Tons Not Sent"
"Terrapins Transpire"
"Terrify-It Ferry"
"Tess Brom, Bert Moss: Mobsters" []
"Tex: the Hextet"
"Theda's Deaths" []
"Threaten'n Theater"
"Tim's Ten Mittens"
"Tip Top Tot Pip"
"A Title-It Tale"
"To Ape a Poet"
"To Bro Robot"
"To Mr. Mort"
"To Prowl Plot Row"
"To Wharf of Wrath"
"Top Ace Pat Coe"
"Tot Spy Ty Post"
"Toupees Seep Out"
"Trailer Retrial" []
"Traitor Rat Trio"
"The Trap at Perth"
"Troll Two's Worst Toll"
"True Tanks Take Turns"
"Twin-Gun Wingnut"
"Twistin['] Nitwits"
"Uglier Rue Gil"
"Unmotivated Mutant Video" []
"Us of UFOs"
"Vast as TV"
"Vestral Varlets"
"Vi IV"
"Via Scout Octavius"
"Vigorous Goo-Virus"
"The VIP's Hip Vest"
"The Wad Thawed"
"Wagered Ragweed"
"Wan Tot at Town"
"We the Bland Bend the Law"
"Wendigo Widgeon"
"Wes: His Wishes"
"Westin's Witness"
"Wild Cards Did Scrawl"
"Wild Del Did Well"
"Will He Hew Ill"
"Wimpy Art's Swim Party"
"Wong is Sowing Owings"
"Wood of Mr. Worm Food" []
"Yes, Meld Smedley"
"Yet Quiver Very Quiet"
"Yet Them, They Met My Teeth"
"Young Sage Synagogue"
"Yup, Bell-Pull, Bye" []
"Yup, Dr. Purdy, Dry Up"
"Zombies: Some Biz"
"Zone One-Z"
"The Zoo Oozeth"

table of lame talk shows [xxm8]
blurb
"[if player is male]Elmo Stark[else]Selma Tork[end if] Talks More"
"[if player is male]Gene Vest[else]Eve Tseng[end if] Gets Even"
"[if player is male]Mr. Easy-Smeary[else]Smeary Ms. Raye[end if]" []
"[if player is male]Mr. Tso's[else]Mrs. Tso[end if] Storms"
"Abi Gide's Big Ideas"
"Ace Nutter's Utterances"
"Adie's Ideas" []
"Adulatory, Laudatory [if player is male]Aldo Autry[else]Laura Doty[end if]"
"Advise, Davies, Advise"
"Again W/Gawain Wigana-Agwani"
"Aha, Dire Airhead"
"Al Berg's Garbles"
"Alterer Relater Art Leer"
"Answer to Art Owens"
"Apprise, Sappier"
"Apt Pat"
"Arendt Ranted Ardent"
"The Arg Rageth" []
"Arnett's Natters"
"Arnott's Rants to Start On"
"Artie's Satire" []
"As Brent Banters"
"As Trent Natters" []
"Ask-[']Im Sikma"
"Ask Lupi Pulaski"
"Ask Mr. Marks"
"Ask Rep. Kasper-Parkes"
"Ask Ye Kasey"
"Asker Akers"
"Asky Kay's Yaks"
"Aspirant Partisan Nat Paris"
"At Hyper Therapy"
"At It, Tait"
"Avid Al Davila"
"Avid Allen Villaneda" []
"Avid Cris Viscardi"
"Avid Dina Davidian"
"Avid Earl Delariva"
"Avid Ervin Vandivier"
"Avid Eryn Vineyard" []
"Avid Gia Gavidia"
"Avid Lea Deavila"
"Avid Len Ledvina"
"Avid Les DeSilva"
"Avid Olin Vindiola"
"Avid Otto Dottavio"
"Avid Sal DaSilva"
"Avid Sol DiSalvo"
"Avid Son Davison"
"Avid Vern Vandiver"
"Aw, I've a View"
"Bad Dog's Odd Gabs"
"Banter at Bren: Rant, Be"
"Bantery Nat Byer"
"Barthel's Blathers"
"Beau's Din, Unbiased"
"Being Nosy Begins Yon"
"Berg 'Sayin' Baysinger"
"Bess Rove Observes"
"Beth Gil the Glib"
"Bettina's Neat Bits" []
"Big E's Gibes"
"Big Herb is Gibberish"
"Big Loud Glib Duo"
"Big-Slant Blasting"
"Bleat Mo['] Blame to Tom Bale"
"Bleat St. Battles"
"Blount's So Blunt"
"Blowing Glib Now"
"Bo Raves So Brave"
"Bother [']Em More, Beth"
"Bouncing Buncoing"
"Brilliant [if player is male]Bill Train[else]Lili Brant[end if]" []
"Caffee Carr, Farce Facer"
"Candra's Canards"
"The Cart: Rec That Chatter"
"Carthage Rage Chat"
"Charismatic [if player is male]Mitch Sciara[else]Marti Chicas[end if]"
"Charlotte's Ol['] Chatters"
"Chastity is Chatty"
"A Chat At['] Cha"
"Check Out Chuck Te'o"
"Chester: The Recs/Retches" []
"Chet Ros Hectors Ochre St" []
"Chortle at Charlotte"
"Chum Abe Beachum"
"Chum Akers Schumaker"
"Chum Annese Schueneman"
"Chum Baba Baumbach"
"Chum Barb Brumbach"
"Chum Enid Duchemin"
"Chum Gillan Mclaughlin"
"Chum Ida Michaud"
"Chum Irons Murchison"
"Chum Kabir Krichbaum"
"Chum Lita Matulich"
"Chum Loreta Crouthamel"
"Chum Mae Meachum"
"Chum Omer Muchmore"
"Chum Reda Ducharme" []
"Chum Rod Murdoch"
"Chum Serena Scheuerman"
"Chum Tarra Macarthur"
"Chum Tim Mitchum"
"Chum Xia Michaux"
"Chum Yael Mulcahey"
"Cluey Mr. Crumley"
"Complain-Moan Clip"
"Complainer Icon Marple"
"Conrad's Candors"
"Consulting Gus Clinton"
"Costillo's Cool Lists"
"Cry at Tracy"
"Current Curtner"
"Curt Ain't Taciturn" []
"Curt Yin's Scrutiny"
"Curtest Cutters: Tut's Rec"
"Daily Lydia" []
"Day-Maker May Drake"
"Daytime [if player is male]Tim Eady[else]Mia Dyte[end if]" []
"Dibbler's Dribbles"
"Diety Deity Ted Yi"
"Dinner of Nerd Info"
"Doc's Fine Confides"
"Dr. Cat is DRASTIC"
"Dr. Fine Friend"
"Dynamicer Mandy Rice" []
"Ears-Sear Ares"
"Egotheism Eightsome"
"Eh, Nag Hagen"
"Elston Lets On"
"Em 'Sayin' Yasmine"
"Emme's Memes"
"Emote to MEE"
"Empathic Emphatic [if player is male]Tim Paech[else]Pam Teich[end if]"
"Enquire, Enrique"
"Eric [']N Nicer Recin[']"
"Erik 'Jaws' Rajewski"
"Essie Fitt Testifies Feistiest"
"Factoids: Tad's Foci"
"The Facts: Chat Fest"
"Fans Love Nova Self"
"Fave List Festival"
"Figueras Argufies"
"Flip Stu Uplifts"
"Futsal Faults"
"FYI IYF"
"Gee! Vent! Get Even"
"Get Asa a Stage"
"Gibe Man Gabe Min"
"Gilman's Maligns"
"Glavine's Leavings" []
"Gossiper Peg Rossi"
"Goucher's Grouches"
"Grable's Garbles" []
"Gravest TV Rages"
"The Grills Get Shrill"
"Grumpy Guy Mr. P"
"Gushing Huggins"
"Hey, Ms. Hymes"
"Hey, Rate the Year" []
"Hogarth's Got Harsh"
"Hoist Yr History"
"Homies['] IMHOes"
"Hone Wit to Whine With Noe"
"Hot-News-Now Seth" []
"How-Stale Late Show"
"Howard's Rad Show" []
"I Ask Saki" []
"I Bug U Big"
"I Hatch Chat! Hi"
"I React at Eric" []
"I Watch [']N Win Chat"
"I'd Rant Darnit"
"I'm Carlton Clairmont" [too many of these so I just threw in a few]
"I'm Darrell Remillard"
"I'm Drew Widmer"
"I'm Elton Montiel"
"I'm Fonder Informed"
"I'm Goldie Dimeglio"
"I'm Hope Opheim"
"I'm Irate Amirite Airtime"
"I'm Karin Minarik"
"I'm Laurel Aumiller"
"I'm Lisa Ismail"
"I'm Lorna Molinar"
"I'm Pablo Palombi"
"I'm Paul Lipuma"
"I'm Reed Diemer"
"I'm Regina Mangieri"
"I'm Rhonda Hardimon"
"I'm Ron Minor"
"I'm Sean Maines"
"I'm Selena Milanese"
"I'm Seth Smithe" []
"I'm Tasha Mathias" []
"In-Touch [toti] Chu" []
"Industrial Diurnalist [if player is male]Dustin Rail[else]Trudi Nails[end if]"
"It's Clear Articles"
"It's EZ: Seitz Sez It"
"It's Jen in Jest"
"It's Len: Listen" []
"Jed, Gus: Judges"
"Jigsawn Jawings"
"Just-Bec's Subjects"
"Karn's Ranks"
"Kaye 'Jaw' Jakeway"
"Keen Ray Kearney"
"Keira's Askier" []
"Kit Snow Knows It"
"Kolb 'Sayin' Yablonski"
"Late Hours Shouter Al"
"Laufer's Earfuls"
"Layla's Say-All"
"Le Chat Chalet"
"Le Tart Tatler"
"Le Yack-Lackey"
"Lemburg's Grumbles"
"Lens on Nelson"
"Les Barth Blathers" []
"Let Gil Get Ill"
"Let Mel Tell [']Em"
"Li'l Argue Guerilla"
"Lieb's Biles" []
"Loyd 'Jaw' Wojdyla"
"Lusk's Sulks"
"Mandatory Dynamo Art"
"Manolo's Ol['] Moans" []
"Marm's Smarm"
"Mart's Smart" []
"MC Spike Picks [']Em"
"Misc-Mics"
"Miss Sims-Isms"
"Mo White's Showtime"
"Moi, IMO"
"Mordant Rantdom"
"Moreno: On More"
"Mouth'n Dr Thurmond"
"Mr. I-Nag Ingram"
"Mr. Mass-Smarms"
"Mr. Taste-Matters"
"Ms. Ram-Smarm" []
"Muse, Mr. Summer, Ms. Reum." [p]
"My Bit by Tim"
"Nag [']Em, Megan"
"Nag Dr. Grand"
"Nasty Quick Quackin['] Sty"
"Nat's Glib Blasting" []
"Neil's Lines" []
"No-Bias Sabina Bisono" []
"No-Rot Orton"
"Normative Movie-Rant [if player is male]Ervin Mota[else]Vi Armento[end if]"
"The Nosy Honesty" []
"Not Fair: For, Anti"
"Now That Whatnot"
"Nut Marge's Arguments"
"O, Express Exposers"
"On So Soon"
"Ooh, Pal, Hoopla"
"Our Prof Den, Profounder"
"Pa Seter Repeats a Pester"
"Pal-Lord Pollard"
"Parking Lot Talking Pro" []
"Parroting-Rating Pro Torri Pang"
"Pass Out a Toss-Up"
"Patrice's Practise"
"Patterer Perretta"
"Pattie's Eat Tips"
"Pedant Pentad"
"Pep Pro Popper"
"Personable [if player is male]Bren Pesola[else]Opal Berens[end if]"
"Pert Cid's Scripted Predicts" []
"Petra's Prates" []
"Piers Pries"
"Pingley's Yelpings"
"Plainest Panelist [if player is male]Les Patin[else]Pat Niles[end if]"
"Po['] Stu Pouts"
"Pointmaker [if player is male]Kip Morante[else]Kim Paterno[end if]"
"Popinjay Joni Yapp"
"Porky's a Spark, Yo"
"Pouring-in Group"
"Prattle Platter"
"Pressnik Perkins's" []
"Pretty Loud [if player is male]Loyd Pruett[else]Dotty Luper[end if]"
"Prolly Pry LOL"
"Pryer Perry"
"Pseud-Dupes"
"PTI Pit"
"Pundits [']N Stupid"
"Ragy Gary 'Yarg' Gray" []
"Rah, it's Trisha"
"Raising Airings"
"Rapp's Parps"
"Rate the Theater"
"Raving Ingvar Garvin"
"Raw Rant Warrant"
"Raw Tech Watcher Art Chew" []
"Raw Torn Rant Row"
"Reap Thy Therapy"
"Rec What, Watcher" []
"Replicant Clint Earp"
"Rhee Here"
"Ring Pam Ramping"
"Riper Prier Perri"
"Rod's New Wonders"
"Rolf's ROFLs"
"Ron 'Jaw' Wojnar"
"Rooney's One Rosy Noser, Yo" []
"Rooney's Yes or No"
"Roush Hours"
"Ruffino's Ruin-Offs"
"Sadie's Asides"
"Sal Pape Appeals"
"Salov's Salvos"
"Sane Irv Van Ries Raves In"
"Sasses Assess"
"Says Brent Stansbery"
"Says Burl Salsbury"
"Says Karin Sarkisyan"
"Says Rubin Sainsbury"
"Scorner Corners"
"Scour Ideas: a Discourse"
"Scratchy Cry-Chats"
"Secret-Rec Set"
"See Arron Reasoner"
"See Art Easter-Trease" []
"See Bert Steeber"
"See Bill Belisle"
"See Birch Scheiber"
"See Bub Busbee"
"See Burt Steuber"
"See Caron Escareno"
"See Cary Creasey"
"See Clint Celestin"
"See Colt Telesco"
"See Dirk Dierkes"
"See Don Sedeno"
"See Dorris Desrosier"
"See Garth Geathers"
"See Gil Siegel" []
"See Glinda DeAngelis"
"See Grant Sergeant"
"See Houston Stonehouse"
"See Irvin Severini"
"See Karl Keasler" []
"See Karyl Kearsley"
"See Kurt Kuester"
"See Linford Rosenfield"
"See Ling Inglese"
"See Link Kneisel"
"See Linn Nielsen"
"See Logan Eagleson" []
"See Lon Olesen" []
"See Lyn Ensley"
"See Mina Eiseman"
"See Minna Eisenman"
"See Myron Meyerson" []
"See Raul Leasure"
"See Rich Scheier" []
"See Rod DeRose"
"See Rog Goeser"
"See Ron Sereno-Rosene"
"See Ronald Rosendale"
"See Scott Cossette"
"See Simon Messineo"
"See Storm Somerset" []
"See Tim Estime"
"See Toney Eyestone"
"See Trev Everest" []
"See Us Hit the Issue"
"See Wilkins Lesniewski"
"Self-Vote Love-Fest"
"Sensei Sinese" []
"Septimus Spumes It"
"Shearer Re-Hears"
"Sheerest Seethers"
"Shiller Sherill"
"Shout-So Hut"
"Shout'n Huston"
"Sindi's Dissin[']"
"Sir Hank Krishna, a Shrink" []
"Sirs, Pure Surprise"
"A SJW Jaws"
"Slay Tact Catalyst"
"Smeariest Masteries"
"So, Cop: Coop[']s Scoop"
"So, Ms. Moss"
"So-Railing Originals"
"So Vent to Sven"
"Sociable [if player is male]Basil Coe[else]Casi Loeb[end if]"
"Speak: the Hep Takes"
"Spiel Piles"
"Stand in and Snit"
"Star-Like Talk, Rise"
"Steamiest Estimates"
"Step In [']N Spite"
"Stew is Wisest"
"Stipe's Spites"
"Strom's Storms" []
"Swank Doc M's Smackdowns"
"Swerdon Wonders" []
"Tact? Ohh, Hot Chat"
"Talk to Kat Olt"
"Talkative Vital Kate"
"Talking Gil Kant"
"Tell [']Er, Terell"
"Tell Ya Lately"
"Tessie Sees It"
"That's-Nice Chat Nites"
"Thea's Hates" []
"Theresa Reheats the Ears" []
"This Do: to Dish"
"Throw in with Ron"
"TMI Tim"
"To Hatch Hot Chat"
"Told You Too Duly"
"Topher Pother, the Pro"
"Tracy's Scry-At"
"Trite-Matters Streitmatter"
"A True Go to Argue"
"True to Re-Tout"
"Twee Fan Nate Few"
"Um, Roar a Rumor"
"Uncensored Denouncers" []
"Up-Late Pat Lue"
"Updater Rude Pat"
"Urban Lit Tribunal"
"Urging Gugnir"
"Ventess Stevens"
"Vespertine Presentive"
"Vibrant Brat Vin" []
"The View With Eve"
"Visitant Nativist Tat Ivins"
"Walk With Wilt Hawk"
"Watch a Chat, Aw" []
"Watch Me, We Match"
"Way-Cool Lacy Woo"
"We Dig Edwig"
"We Nag Agnew"
"We Think With Ken"
"Weeniest Tweenies"
"Wes Iver Reviews"
"Who's Rad: Rod Shaw" []
"Winchester Wrenches It" []
"Word Up W/Proud Po['] Dr. Wu"
"Worser Rowers"
"Wry Eve is Very Wise"
"Yacking Nick Gay"
"Yang is Saying"
"Ye Kewl Weekly"
"Yeller Ellery"
"Yen With Whitney"
"Yenta Teyna Taney"
"Yo, Hi, IYHO"
"Yo, Out to You"
"Yo, Rant to Ryan, Not Ray"
"Yo, Rat to Ray"
"Yo, Topics Too Spicy"
"Zesty Ty Sez"

table of lame tv shows [xxm9]
blurb
"[if player is male]Mr. Simes[else]Ms. Rimes[end if] Simmers"
"Abe's Base"
"Add Dad"
"Agent Tegan"
"Ah, Mrs. Marsh"
"All Cheer Rachelle"
"Angi Li's Ailings"
"Anthoney Annoyeth"
"Apt Chum Match Up" []
"Arbiter Rarebit"
"Aw, Dr. Ward"
"Aw, Li'l Willa"
"Ay, Mr. Army" []
"Bad-Odor Boor Dad"
"Bad Velour Boulevard"
"Baking Chum Buckingham"
"BBL: a Blab"
"Be Smart, Mr. Bates"
"Beilman's Minables" []
"Being Dr. Big Nerd"
"Besty Betsy"
"Big Ken Be King"
"Black Ops Slob Pack"
"Booker's So Broke"
"Boy, Mr. Byrom"
"Bub Chun's Bus Bunch"
"Cake Boss Beck Sosa"
"Can't Hate Etta Chan"
"Castor's StarsCo"
"The Cat Acteth"
"The Cats at Chet's"
"Cats Like Kastelic" []
"Cesar Arce's Acres" []
"Chef King Keg Finch"
"Chief Chef, I"
"Common Con Mom"
"Conway Can, Yow"
"Cool HS School"
"Cops O['] PCs"
"Corey, He's So Cheery" []
"Counseling Cousin Glen"
"Crazy Things Zach's Trying"
"Cris the Richest"
"Cue Mr. Crume"
"Damphier's Dream Ship"
"Dan'l's Lands" [p]
"Daring By Big Randy"
"Dater Trade/Tread"
"Days Off So Daffy"
"Deft Rod's Odd Frets"
"Det. Ted"
"Detective Evette Cid"
"Dixon's So Nix'd"
"Doc Got a Good Act"
"Dolts of Flood St"
"Don't Mind Todd Minn"
"Don't Miss Don Smits"
"Doods So Odd"
"Dr. Nessa Sanders"
"Dr. Seidl Riddles"
"Dr. Spino Drops In"
"Dr. Viledrivel"
"Drab To Bod-Art"
"The Drama-Dream Hat"
"Dud Spy Spuddy"
"Dude, Bring Brundidge"
"Dufe-Feud"
"Durablest Lad Buster"
"Dyson Synod"
"East Howl Late Show" []
"Ed Nurses Rudeness"
"Ed's Rec Screed"
"Erwin HS Whiners" []
"Everdaunt's Undersea TV Adventures"
"Everyday Davey Rey"
"Exciter Tex Rice"
"EZ With the Wiz"
"Faboo Oaf Bo"
"Felicity's City Files"
"A Filmy Family"
"Flossie's SOS Files"
"For-Peril Profiler"
"A Fortune of Nature"
"Garbled Dr. Gable" []
"Gasp, Mr. Gramps"
"Gee, So Go See"
"Gentler Lt. Green"
"Gerber, Berger: Err, Beg"
"GI Coach, Chicago"
"The Gods of Goods-Heft"
"Goob [']N Bongo" []
"Grampa Pagram"
"Greasiest Stageries"
"Gus [']N Guns"
"Gus Reno, Surgeon"
"Gwyn Luis Wins Ugly"
"Hal Gets the Gals"
"Hearst Hearts Sather" []
"Heck, it's Chetski the Sick"
"Herb at the Bar: Be Thar"
"Hev-Gut the Guv"
"Hey Dr. Hyder"
"Hey, Twin Whitney" []
"Horrid Dr. Hiro"
"Horse Dr. Sherrod"
"Hot News Show Net" []
"Hot Rough Goth Hour"
"I Bet on Benito" []
"I Know Dr. Dworkin" []
"I-Swerve Reviews" [] []
"I'm Joe Emoji"
"Icky Bugs, Big Yucks"
"Initiated Dietitian Nidia Teti"
"Ira and Adrian" []
"Join Sam Jamison"
"Karim's Mark is a Smirk"
"Keen Dr. Denker"
"Keep Quinn, Pink Queen"
"Know Eric's Nice Works"
"Lafs With Half-Wits"
"Lawyer Rawley" []
"Le Kid, Liked"
"Lea's BFF Baffles"
"Learned Lad Rene" []
"Leavitt's Vital Set" [] []
"Let's Be Mr. Trembles"
"Let's Ring Sterling"
"Li'l Ms. Mills"
"LOL My Molly"
"Loni-Lu's So Illun[']"
"Look at a Lot, OK"
"Lu's the Sleuth"
"Ma's Row So Warm"
"Maggie's Same Gig"
"Mailman Ian Lamm"
"Majority: Tim or Jay"
"Make Fun, Ma Funke"
"Man, Pour a Pun-O-Rama"
"Mathew is the Swami" []
"Me: the Theme"
"Mean Dr. Cho, Macho Nerd"
"Mediocre Doc Meier"
"Meet Rex Extreme"
"Men Dig MD Inge Deming"
"Merchant Mart Chen"
"Mishta Mathis"
"Mo Cuts Scum to Custom"
"Mo['] Cats to Scam"
"Mo['] Files of Slime"
"Molly is Mo['] Silly"
"Mr. Casa's Sarcasm"
"Mr I-Stop-Imports"
"Mr Sosa & Ms Rosa" []
"Much-Apt Matchup" [] []
"My Bro Mr. Yob" []
"New Kid Ed Wink"
"Newsgirl Swingler-Wersling"
"Nick, Beam it Back in Time"
"No-Lie Leoni"
"No Sharp Orphans"
"Non-Stud Dunston" []
"Not-So Toons"
"Nurse Unser"
"Odd Teen Ted Oden"
"Of Rides So Fried"
"Oh Noes Mr. Hormones"
"Oh, Saw a Show" []
"Ol['] Mac's So Calm"
"Ol['] Pat is a Pistol"
"Olof Dover, Food Lover"
"On Swell Swollen New LOLs"
"Or Be OK, Booker" []
"Osby Boys"
"Phear Her Pa"
"Pip Carlin, Principal"
"Pip Loves Evil Opps"
"Police of Co-Op Life"
"Pop's Fear of Papers"
"Prep Show Whoppers"
"Prepost-Popster"
"The Prick's Hep Tricks"
"Prior Pirro"
"Pure Chaos Space Hour"
"Rag of Fargo"
"Rasheed: He Dares" []
"Rathbone The Baron" []
"Real Spy Players"
"Real Wives, Wee Rivals"
"Real World or, Well, Rad"
"Realistic Ice Trials"
"Reg and Danger"
"Reluct-Cutler" []
"Reset, Tour Our Street"
"Resident Red Stein"
"Rhoads Hoards So Hard" []
"Rifts First"
"Rip Them Off, Mr. Fop-Thief"
"Risk It, Kristi"
"Road to Too Rad"
"Robert or Bret B Retro"
"Roche's Chores"
"Rod Be Bored" []
"Romantic Mr. Action"
"Rosena's Reasons"
"Rotten Tot Ren Retton"
"Roy Can Crayon"
"Rucci's Circus"
"Sam's Epic Escapism"
"Sanders['] Radness" []
"Sandy and Sy"
"The Sarge: He's Great" []
"Science and a Scenic Den"
"Scrumptious Sitcom-Usurp"
"See Al Lease" []
"Seek With Stew: Hike This Week"
"Self Made MAD Feels"
"Seppala Appeals" []
"Shamus Sam Hsu"
"Sheriff Shiffer"
"Shift Work With Forks"
"Simon's Gig: Go Missing"
"Skit Row Works It"
"Slapstick Tasks Clip"
"Smug Edina, Mad Genius"
"Snore at One Star? No, Stare"
"Snyder's Dryness"
"So Ed Does"
"Sod, Bum, Mo['] Buds So Dumb"
"Sokol Looks"
"The Sop's Poshest Spots, Eh"
"SOS Fort of Sorts"
"A Spoof of Soap"
"Sue Dern Endures, Ensured"
"Sun Kid in Dusk"
"Supa-PUAs"
"Tad Lance Can't Deal"
"Tastin['] Titans"
"Tate Had the Data"
"Ted's Van Advents"
"Tepper's Prep Set"
"To Plan an['] Plot Not, Pal"
"Toby Keough, the Book Guy"
"Tons-O-Toons" []
"Toshiko is HOT, OK"
"Tot-Can-Act-Not Octant"
"Tots Lyin['] Snottily"
"Train [']Em, Martine" []
"Trek Show: the Works"
"A Troll's LOL Arts"
"Trooper Portero"
"Trounce-Counter" []
"Trouper Ruperto" []
"Turner's Returns" []
"U of UFO"
"Ugly-Side Idle Guys"
"Uh, Let's Sleuth" []
"Ulf at Fault"
"Um, Aunt Autumn"
"Um, Don't, DuMont"
"Un-Tribal Lunar Bit" []
"Up-Gro Group"
"Vallero All Over" []
"Voisin-Vision"
"Wallace's Case Wall"
"Weak-Bosh Bo Hawke's Bake Show"
"Weatherly The Lawyer"
"Weird Wired Dr. Wei" []
"Whenever Vern, WHEE"
"Whittle With Tel"
"Whoa, Dr. Howard, How Rad"
"Wilder Dr. Liew" []
"Wish Me to Showtime"
"With a Wit, Ah" []
"Wizardly Liz Wydra"
"Xia's Axis"
"Ye Chap Peachy: Ach, Yep"
"Yo, Dares So Ready"
"Your Big Guy-Bro, I"
"Yr. Odd, Roddy"
"Zandor and Roz Zordan"
"Zhang Hangz"
"Zoom As Somoza"

table of laughhouses [xxm0]
blurb
"Ace LOL Locale" []
"Ahh, Met the Ham"
"Alf's Lafs"
"All Yo['] LOL, Ya"
"Amusing Mungia's" []
"Anguish-Jolt Laughs Joint"
"Anti-Jokes Sake Joint"
"Assorted Roasteds"
"Ballsy Al Bly's"
"Bang-Up Pun Bag"
"Best Gags Run Gangbusters"
"Big-Snark Barkings"
"Bold Mock Mod Block"
"Brace for Farce, Bro"
"Bringin[']-Grin Bin"
"Busting-Guts Bin" []
"Cheap-Shots Sachet Shop"
"Comedian-Do Cinema" []
"Corniness Non-Crises" []
"The Crass Scathers" []
"Dim Stooge Good Times"
"A Dis Dais" []
"Dis-Out Studio"
"Dope Ira's Parodies"
"Drek-Show Workshed"
"Fast Pound of Stand-Up"
"Floors So ROFL"
"Forge Yo['] Goofery (Or Go Fey)"
"Fun Bros of Burns"
"Gag-Bullish Glib Laughs"
"Glib-Gush Blush-Gig"
"Gosh Mega Gags Home"
"Got-Gasps Gags Post"
"Gribbins Ribbings"
"Grin Ring"
"Groaniest Got Arisen" []
"Guys With Gushy Wit"
"Hep Clamour/Humor Place"
"Her Famous Safe Humor Farmhouse"
"Hot Firm of Mirth"
"A Humor-Gala Laugh-O-Rama"
"Impersonate-Permeations"
"Innuendo-Union Den"
"Ire/Wit: I-Write-It Wire"
"Jail-Nought Laugh Joint"
"Jerks-Foam Jokes Farm"
"JestCorp Projects" []
"Jester Jeter's" []
"Jesting/Jig Nest"
"Jon Baker's Jokes Barn"
"Josh'n John's" []
"Jot-Ye-Sick-Jokes City"
"Just-for-Me Jest Forum"
"Karl's Larks"
"Laughs-Gush Al"
"Like, Grin Kinglier"
"Live Swear Reviewals" []
"Lochter's Chortles"
"A Log Hut to Laugh"
"LOLZOR Rollo'z"
"Lon Lew's New LOLs"
"Mandel's Slam Den"
"Mass Glib Big Slams"
"No-Strings Snortings"
"Noisier Ironies"
"Norm Gage's Groan Gems, Gags [']N More"
"Not-Ruff Fun Fort" []
"Offend-Off Den"
"Oh, Forum of Humor"
"OK-Jest-Now Jokes Town"
"Older Slier Drolleries"
"Ole Sinner One-Liners"
"Pa's Cut-Up Acts" []
"Pat Buck's Bust Pack"
"Pat Sund Stand-Up"
"Pat's Slick Slapstick" []
"Phinney Hype Inn"
"Play-Dumb-Madly Pub" []
"Pullman Pun Mall"
"Pun Meet Umpteen"
"Punster Punters[']"
"A Pup's Clean Puns Palace"
"Ralf's Larfs"
"Rare Steep Repartees"
"Raw Bro Barrow"
"Rending-Grin Den"
"Repartee Repeater Pear Tree" []
"Ribaldest Listed Bar"
"Rip-All Pillar"
"Rum-Sort Rostrum"
"Russell Lulsers"
"Sardonic Corinda's" []
"Satiric Tricia's" []
"Satirical Racialist Latricia's"
"Saucy Rant Sanctuary"
"Slam of LMFAOs"
"Smirkin['] Mr. Niki's"
"Snark Ranks" []
"The Snark-Shark Net"
"Snarkier Karrine's"
"Snarky Karyn's"
"Sneerin['] Ol['] One-Liners" []
"So-Campy Coy Pam's"
"So-Dry Dory's"
"So-Fresh Shofer's"
"So Full of LULS"
"So-So MC Cosmo's"
"So-Trendy Story Den"
"Sour Shaken Sneak-Hours Snark House"
"Spring to Grin Spot" []
"Srejko Jokers"
"Stall of Fast LOL"
"Still of LOL Fits"
"Supr-LOL Rollups"
"Swearin['] Warnie's" []
"Tritest Titters"
"Tusslin['] Insults"
"Two-Puns-Up Towns"
"Ungodly Rap Playground"
"UpFront Funport"
"Wild Rod's Dis World"
"Wildest-Led Wits: It's Lewd"
"Wit as it Was" []
"Wry Folks['] Fly Works"
"Ye Luls Be Bullseye"

table of lousy hit songs [xxm01]
blurb
"[d-word-u], Be Bad Men"
"A-OK We Awoke" []
"Abby, Baby"
"About Me: Mo['] Beaut"
"Above Must Bust a Move"
"Ace Hit the CIA" []
"Act When We Chant"
"Adores So Dear" []
"Ah, Cap a Chap"
"Ah, Gutsy Hat Guys"
"Ah, I'd of Got Good Faith"
"Ah, Knots To Hank's Stank Ho"
"Ah, Sow a Show" []
"AKA Mr. Karma"
"Al Gots Gloats to Gals"
"Ale Fill All Life"
"All Chix Chillax"
"All In an['] Ill"
"All Rod's Dollars"
"Anarchy Ranch, Ya"
"And I Hymn In My Hand"
"And I'm Mad in a Mind"
"Annoy, Yodel, One Day Only"
"Anti-Rhyme in My Heart" []
"Any Cuter Racy Tune"
"Arousal So Aural"
"As I Love So Alive"
"Autoing to a Gun, I Outgain"
"Aw, Lilt at Will" []
"Aw, Rec a Crew"
"Aw, Ye Diss Sideways"
"Aw, Yup, Way Up"
"Aww, Even New Wave"
"Bad Kids Did Bask"
"Baggiest Beats Gig"
"Ball Very Verbally"
"Bard So Adorbs"
"Barmy in My Brain"
"The Bass Has Best"
"Be Down: We Bond" []
"Be Punk or Broken Up"
"Be Via a Vibe"
"Beastly Sly Beat" []
"Beatdowns Won't Be Sad"
"Beats or a Strobe"
"Beef Not, Bent Foe"
"Bet Guys Get Busy"
"Bid a Scum Bad Music"
"Biggest Gig Best"
"Bilkin['], I Blink"
"Bill's Ill BS"
"Bit of Fib to Fob It"
"Bite, Bite, I Bet it Be"
"Blood is So Boil'd"
"Blood's So Bold"
"Bod Hit Low with Blood"
"A Body: Bad, Yo"
"Bold Cutie Could be It"
"Bold Hours['] Blood Rush"
"Bomb Mobb"
"Boo, Damn, Bad No Mo[']"
"The Boon Be on, Tho[']"
"Boy, Mr., My Bro" []
"Bozo MC Comboz"
"Brawling Warbling" []
"Broads So Drab"
"The Bros Be Short"
"Budapest: a Dubstep"
"Buenos Be on Us"
"Butterier Re-Tribute"
"Call Out a Cut, LOL"
"Called Da Cell"
"Can't Smile Lest Manic"
"Cap the Hep Cat"
"Cat, Kite a Ticket"
"Cede Us Deuces"
"Charisma is a Charm"
"Christen Snitcher Retchins[']"
"City Is Our Curiosity"
"City, Love Velocity"
"Close but Cute Slob"
"Close to Coolest"
"Cloy to Yo['] Colt"
"Co-Fend, Def Con"
"Combos So BMOC"
"Come On Once Mo[']"
"Come Work [']Em, Ow! Rock"
"Comfy? Yo, CFM"
"Command MC Damon"
"Compiled Clip Demo"
"Consoli-Coolins"
"Cool Down Now O Clod"
"Cool Rap Carpool"
"Cooling and Canoodling"
"Cop Push Chops Up Such, Pop"
"Copies So Epic"
"The Cops Scopeth"
"Crack Pipe Price Pack"
"Crazy Cryaz"
"Crib Here be Richer"
"Crisp Scrip, Crips"
"Crooked Rock Ode"
"Crowd [']Em Mod Crew"
"Crowns or Cornrows"
"A Crunk Pit: Crank it Up"
"Curfew FU Crew"
"Cus I'm Music"
"Da Bass Badass"
"Da Biz Iz Bad"
"Da Bones, Bad Ones"
"Da Juve Deja Vu"
"Da Life Failed"
"Da SOB So Bad"
"The Daily Dealy Hit"
"Dam U a Dum Muda. U Mad" []
"Dam Up a Dump"
"Dame, Thy Death? My, They Mad"
"Dang! I R Daring" []
"Dank Slum Slam Dunk"
"Darn, Mo['] Rad, Mon" []
"Dat's New, We Stand"
"Days of Fads, Yo"
"Dead Harm Made Hard"
"Dear Ma: a Dream"
"Death Tub Bath Duet"
"A Def Fade"
"Demerit Merited"
"Desultory Sultry Ode"
"Devour-Zens Rendez-Vous"
"Dim Sky, My Kids"
"Dimetown Downtime"
"Do Ghettos To the Dogs"
"Do Seep So Deep"
"Do The Hot Ed"
"Do This Hot Dis" []
"DOA Ado"
"Dog, Ride Dodgier"
"Dog Went GET DOWN"
"The Dogs Get Shod"
"Don't Play, Nod Aptly"
"Dope, Wry, We Do Pry"
"Dopeness Speeds On" []
"Dork U Not Too Drunk"
"Dorkiest Skirt-Ode"
"Down at Da Town"
"Down Pro Drop Now"
"Dr. Cho's Chords"
"Dr. Cooke's Rock Odes"
"Drastic-Distrac[']" []
"Drawl of Rad Flow"
"Drums of Surfdom"
"Drunkest Dunkster" []
"Dump the Thumped"
"DuraGold Drug Load" []
"Dust, Pain: I Stand Up"
"Earn Soul: Our Elan's So Unreal"
"Earworm, Arrow Me"
"Ee Squirm Requiems"
"Egoism Art: I'm So Great"
"Eh, So [d-word-u] Handsome"
"Ehh, Yo, Hey, Ho"
"EKG Keg"
"El Via Alive" []
"Elwood's Low Odes"
"Emend Bliss: Be Mindless"
"Eminem's Immense"
"Emit Lethal All the Time"
"Empty Jug? Get Jumpy"
"End of Def? No"
"Entirety, Eternity" []
"Enviable Elan Vibe"
"Equine Queen, I"
"Even More Emo Nerve"
"Every Fellow Yellow Fever"
"Excitation, Intoxicate"
"Exert it: My Extremity"
"Exorcism-Mix Score"
"Fakin['], a Fink"
"Far Punk Rap Funk Fun Park"
"Fat Chance Chant Cafe"
"Fat Duck" [x: REDACTED]
"Fear Me, Framee"
"Feel a Cup, Peaceful" []
"Feel, Hit: the Life"
"Feelins O['] Felonies"
"Feels Like Sleek Life"
"Fills Like Life Skill"
"Filthy Fly Hit"
"Finest Festin[']" []
"Fit? Uck, Ick, Tuf"
"Floor Seven: Loons Fever"
"Fly Shirt, Shy Flirt"
"Flyest Flytes"
"Fo['] a Oaf"
"Fo['] Erin, Fine or on Fire"
"Fob Any Fanboy"
"A Fob of Bass So Fab"
"FOOM, Mofo"
"For Pa: Rap of a Prof"
"For She's So Fresh" []
"For Those Too Fresh"
"Foxiest, I Sex Oft"
"Foxy FX, Yo"
"Free Fond Offender"
"From Mo, For Mom"
"Fun Style Fly Tunes"
"Funk Row Fun Work"
"FunkCo" [x: REDACTED]
"Funkiest Tikes['] Fun"
"Fur Aline, Fraulein"
"The Fury Turf, Hey"
"Gaijin in a Jig"
"Gal, Hit a Light" []
"Game to Go at [']Em"
"Gamin['] the Hang Time"
"The Gang is [']Neath Gigs"
"Gas Tank Ganksta"
"Gash Boom Goombahs"
"Get Shaw the Swag"
"Ghetto is Gothiest"
"Ghetto? LOL, Got to Hell"
"Gild the Delight"
"Given LOL, Live Long"
"Go, Bump, Bop, Mug"
"Go Eff Geoff"
"Go Forward, Dog, Row Far"
"Go Hit It, Hog"
"The Gold Got Held"
"Good [']N Goon'd"
"The Good Goth Ode"
"Good Try, Tyro Dog"
"Goonin['] Goin['] On"
"Gosh, Nuts, Gunshots"
"Got Heat? Ah, Get to a Ghetto"
"Got Lies So Legit"
"Got Sin to Sing"
"Got Soul, Lo, Gusto"
"Got The Ghetto"
"Got Thin, On Tight Tonight" []
"Got Weed, Get Owed"
"Gots Rap to Grasp"
"Granpa's Nag-Raps"
"Greef's Free, G's"
"Grief's Rife, G's"
"Grit, Bass, Big Stars"
"The Grit, Tighter"
"The Group's Pusher Got Purge-Shot"
"Groupies, It's Prestigious"
"Guns, Ho: No Hugs"
"Ha, I Rap, Pariah"
"Halls O['] Hollas (Ah, LOLs)"
"Halt, Long-Gone Hate"
"Hands Up And Push"
"Hard As Rashad"
"Hard to Be Hated, Bro"
"Hat Crew We Chart" []
"A Hat Hata[']"
"Hat Men Anthem: Meh, Tan the Man"
"Hate-Word Wrath-Ode"
"Haters in Hairnets" []
"Haters Met the Master"
"The Hats That She Hath Set"
"He Tags the Gas"
"He Yells Hell Yes" []
"He'd Got the Dog" []
"He'd Net the End" []
"Heather, Hear the Heart, Eh"
"Heh, to Do the Hood"
"Heinous In-House, Uh, NOISE" []
"Hello Wife, Whole Life"
"Hey, Men, to the Money"
"Hey Mr. Rhyme" []
"Hey, USA, Us, Yeah" []
"Hi, Low, I Howl"
"Hi, Stout? Shout It"
"His Take: Shake It" []
"Hit Some Semi-Hot Times, Ho"
"Hit Song Thingos" []
"A Hit-Us Hiatus"
"Hm, Yo, Oh, My"
"Hm, You? Oh, Yum"
"Hola Mo['] Moolah"
"Hole to the Loo"
"Holla, LOL, Ha"
"Honest, Wham, Who's the Man" []
"A Hook, Ho! A-OK"
"Hoopla Loop, Ah" []
"Hot Into Too Thin"
"Hot Rex Rox the Exhort"
"Hotting Tonight"
"How Long I Go Howlin[']"
"H/T for Froth" []
"Hysteria is Hearty This Year" []
"I Accent Nice, Cat"
"I Alter a Liter" []
"I Break a Biker"
"I Can Off a Coffin"
"I, Cat Ever Creative"
"I Chafe a Chief"
"I Cream a Crime" []
"I Cred Dr. Ice" []
"I Dis and Disdain"
"I Dis To Idiots"
"I, Down to Do it Now"
"I, Er, Max a Remix"
"I, Flaunter Ultra-Fine" []
"I Fold, Foil'd, if Old"
"I Found Fun I Do"
"I, Gangster, Stagger In"
"I Gank a King"
"I Go Scam So Magic"
"I Go Wut, Wig Out"
"I Got Hot To Go Hit"
"I Got Net Get-It-On"
"I Grab a Airbag"
"I Hack a Hick"
"I Had To Do It, Ah"
"I Leak Like a Alkie"
"I, Liver, Virile"
"I Melt [']Em [']Til I'm Let"
"I Neva Naive"
"I, Null-Illun"
"I Opt a Patio"
"I Pack a Pick"
"I Perform For Prime"
"I Prank Rap Kin" []
"I Prosper. Is Proper"
"I Pull Up Ill"
"I Pump U, Pimp"
"I, Punk, Pukin['] Up Ink"
"I Rap Oft: A Profit"
"I Re-Tag a Tiger" []
"I Shatter a [s-w]ter"
"I Smack Down Wacko Minds"
"I Smoked Some Kid"
"I Snatch a Snitch"
"I-So-Deep Episode"
"I So Gone, Ego is On"
"I So Pwn Win-Ops"
"I Splash His Pals"
"I Stop to Sip"
"I Tag a Git"
"I Track a Trick"
"I Trust It's Tru"
"I Went it New"
"I'd Beat a Bidet"
"I'd Ghost This Dog"
"I'd Got to Dig It, Dog"
"I'll Ask Killas A Skill"
"I'll Try Trilly"
"I'm a Rec a Crime"
"I'm Blues, Sublime"
"I'm Boo--I Boom Mo['] Bio"
"I'm Happy, Pimp, Yah" []
"I'm Lost to Slim" []
"I'm Shot: Mo['] Hits"
"I'm Young, in Yo['] Mug"
"Ice Has His Ace" []
"Icon's Tune Continues"
"If U Don't Find Out"
"Ill a Moron: I'm on a Roll"
"Ill AKA a Killa"
"Ill Dr.'s Drills"
"Ill, or I Roll"
"Ill Pun Pullin[']"
"In Rout to Ruin" []
"In the Now With Neon"
"In Your Ruin, Yo"
"Inn's Gigs: Sing, Sing"
"Is We Wise"
"It Rocks So, Trick"
"It's BAD, Bastid"
"It's Good to Go Dis"
"It's Po['] to Sip" []
"July Be a Bluejay"
"Junkier Re-Jukin[']"
"Kapow, Wap, KO"
"Keep it Real, Like, Repeat"
"King Hit In, I Thinking"
"La Palace A Capella"
"La Vie Alive" []
"Lackeys Be Black-Eyes"
"Lads Can Scandal"
"Lash Out Tha Soul"
"Laws So Low-[a-word-u]"
"Le Rock Locker"
"Lead Pipes Paid Sleep"
"Leg Two Get Low"
"Less Lout Sellouts"
"Let Go, Get Lo"
"Life'z Feliz"
"Limos Be Mobiles So--BLIME"
"The List of Fliest, Hot"
"Littlewood's Wild Tootles"
"Loads-O-Lads Sad, Lo"
"LOL, Dice Collide"
"LOL, Rave All Over" []
"Long Ago Goon Gal"
"Lose Chops, Close Shop"
"Lost Rap Portals" []
"Lots of Soft Ol['] Fool St"
"Loud Enough, Ooh, Unglued"
"Loud Mosh Hoodlums" []
"Loud Snap Sound, Pal"
"Loudest Lust Ode"
"Love Dat I Violated" []
"Love is So Vile" []
"Low Rap: a Prowl" []
"Loyal Perp, Alley Prop"
"Lucrative Ultra-Vice"
"Lust, Pain, Nuptials"
"Luv Moe Volume"
"M, Sexier Remixes"
"Mad Jef's Def Jams"
"The Main Aim Then: Mean Hit"
"A Manic Maniac"
"Many Chose Cash Money Scam, Honey"
"Many Get My Agent"
"Many Roll Normally"
"Mate, R U Mature"
"Mate, She Heats Me the Same" []
"Maxine's Sane Mix"
"MC Boast Combats" []
"MC Boo's Combos" []
"Me [']Til I Melt" []
"Me and Ed, Man, Damned Mean"
"Me, Thrice the Crime"
"Me-Town: Two Men Went Mo[']"
"Mean Dog Gone Mad: Damn Ego"
"Melt Ice, Elite MC"
"Menu For More Fun"
"A Method Made Hot: Tha Demo"
"Mff It's a Mastiff"
"Mine of Mo['] Fine"
"Mis-Doer, Dis More"
"A Misstep Pastes [']Im" []
"Mista G's Stigmas"
"Mixed Bag Maxed Big"
"Mm Boi Mob [']Im"
"Mo['] Arson: Arm Soon, Maroons"
"Mo['] Ballsy Small Boy"
"Mo['] Honesty: Money's Hot"
"Mo['] Hos? Oo, SMH"
"Mo['] New Women" []
"Mo['] Nice Income"
"A Modern Redo, Man" []
"Moet to Me"
"A Mofo O['] Foma"
"Monied, in Mode, I'm Done" []
"Mopy Loon Monopoly on My Pool"
"More Fine, Me, on Fire"
"More Phat Metaphor"
"Mr. Foe for Me"
"Music Noted Undomestic"
"Must-Love-Volume St"
"Mutt by My Butt"
"My Dour Drum, Yo"
"My Fortune: Money Turf"
"My Noise is Money"
"My Passion: Noisy Amps"
"My Shoes Mosh, Yes"
"Nah, Got to Hang" []
"Nashty Shanty"
"New Ego Now, Gee"
"New Gibe We Begin"
"New, Youngish, When You Sing"
"A Night Be in the Bag: Bang it, Eh"
"A Night's Thang is Sting, Ha"
"Nil-Gloom Long-Limo Goon Mill"
"Nippers['] Perpins"
"Nite Joy: Enjoy it, Tiny Joe"
"No-[crap] Rap-Con"
"No Be Icy Nice Boy"
"No Crap Con Rap" []
"No Deffer Offender" []
"No Face of Acne"
"No Hermits is the Norm"
"No Hoes Oh Noes"
"No Luster? Lose, Runt"
"No Trub to Burn"
"Not Quiet Quotient"
"Not Right Nor Tight"
"Not Yet Tonyte"
"Now Is So WIN"
"Now Proud Downpour" []
"Now This Win Shot"
"Now Turn, Worn Nut"
"Now Wish Who Wins"
"Number Six Burn Mixes"
"O It's the Hotties"
"O Town to Own"
"Oaths by Hats Boy"
"Odd [a-word-u] Saddos"
"Off Lewd Def Flow"
"Oh, All Holla" []
"Oh Dog It's THIS Good"
"Oh, Her Gig? Go Higher"
"Oh, Li'l Holli, Ill Ho"
"Oh, Local Alcohol"
"Oh Mega Homage"
"Oh My My Ho" []
"Oh, Smite This Emo" []
"Oh, Super Rue Posh" []
"Oh, Tim! I'm Hot to Him"
"Oh, Top to Hop"
"Oh, Us Got So Tough" []
"OK, Am Amok"
"OK Crew We Rock"
"OK, Go Do Ol['] Look-Good"
"Omigod I'm Good"
"On Track to Crank"
"Once I'm Mo['] Nice"
"One Fly Felony"
"One Good Goon Ode"
"One Kiss Skies On"
"One Self Guy Feels Young"
"One Slick Close Kin"
"One So I'd Die Soon"
"Only Big Bling, Yo" []
"Oo Thugs Go Shout So Tough" []
"Ooh If I Hoof"
"Ops to Stoop to, Sop"
"Or Gun So: Our Song"
"Or I Thug it Rough"
"Or I'd Know Doin['] Work"
"Or Speed Up, Super Dope Dour Peeps"
"Oral Hypes Horseplay"
"Otto's Toots"
"Our Bass Sub Rosa"
"Our Blast So Brutal"
"Our Game a Morgue"
"Our Meter More True" []
"Our Play Your Pal"
"Our Posse Uprose So"
"Our Styled Sultry Ode" []
"Pace is a Spice"
"Pardon Me Doper Man"
"Parpin['] Rappin[']"
"Parping Rapping"
"Payback by a Pack"
"PDA Pad"
"Peace? Silly, Especially"
"Perhaps-Hep Raps"
"Phat Kilos: I Talk Shop"
"Phat Nites in the Past"
"Phatman's Phantasm"
"Pimp Row? Pro-Wimp"
"Pimp Soul Populism"
"Pimped [']Um, I'm Pumped"
"Play Strong, Party's Long"
"Poised is Dope"
"Pop the Hot Pep"
"Pose On So Open"
"Posh Yard Rhapsody"
"A Posse's So Passe"
"Pow! Hurt! Throw Up"
"Powdery, Dope, Wry"
"Prep, Coy Cop Prey"
"A Prince's Nice Raps"
"Pro-War Rap Row"
"Prod [']Em, Mr. Dope Poem Dr"
"Pump Iron or Un-Pimp"
"Pushin['] is Phun"
"Pushing Hip Guns"
"Queer as E-Square"
"Rad Pink Kind Rap"
"Rad Song So Grand"
"Rakeem's Remakes"
"Rap Magnet Pentagram"
"Rap's True Raptures" []
"Real APB Parable"
"Real City Literacy"
"Recs With This Crew"
"Regrown Wronger"
"Remainy in My Ear"
"Rep and Pander"
"Reppin['] Perpin['] Nipper" []
"Ribald Gs['] Bad Girls"
"The Riffs: Fit, Fresh"
"Ripe-Ass Praises"
"Rock a Car, OK"
"Rock Can Crack On"
"Rock on or Conk"
"Rock Out, Ruck Too"
"Rock Solid Crook Slid"
"Rouse Euros"
"Rouses So Sure"
"Sad Lu Lauds U Lads"
"Say Now Sway On"
"Scan, Hit a Snitch" []
"Scram, Foes of Screams"
"Screwdom Crowds Me"
"Scum-Aid Ad Music"
"The Scum Chum Set"
"See What We Hates"
"Seek, Plow, Keep Slow"
"Seen Him? He's Mine"
"Senorita, I Stare On"
"Sharp Cad Crash Pad"
"She Beat the Base"
"A Sheer Hearse"
"Shook Up Hook Ups" []
"A Shot at Hos"
"Should Mo['] Hoodlums Slum-Do, Ho" []
"Shove in One Shiv"
"Shove Me, He Moves"
"Shove Ya So Heavy" []
"Sic [']Um Cus I'm Scum, I" []
"Side, Get Edgiest"
"Sight Me on Some Night" []
"Silent Tinsel" []
"Simply My Lips"
"Sing on in Song"
"Sing or Be Sobering" []
"Sip Malts, Psalmist"
"Sit, Brag, Big Star"
"Slam U a Slum"
"Slammin['] Man Slim"
"Slew a Cop Slow-Pace"
"A Sly Slay Says Y'All"
"Sly, We Net New Style"
"SMH a Sham"
"Smoove Mooves"
"Snap, So, Pass On"
"Snog Song"
"So [d-word-u] Mad, Son"
"So Bored Bro's Ode"
"So Bump Mo['] Pubs, Po['] Bums"
"So Gank Nags, OK"
"So Get [']Em Most, Gee"
"So Glad as Gold"
"So-Hot Hos to Shoot"
"So Pact To Caps at Cops"
"So Pissed Posse Dis"
"So Tell Us, Sellouts" []
"So Timid? Dis it Mo[']"
"So Witty Twist, Yo"
"Soft Glow Gots Flow"
"Some Dog Goes Mod"
"Some Hack's Mass Choke"
"Some Lithe Homeliest Elite Mosh"
"Some Spy My Posse"
"The Song Goes Nth"
"Song O['] Goons"
"Soothing Hootings"
"Soothing This Goon" []
"SOS-Berg Be Gross"
"Soul Ever Revelous"
"Soul Funk Sunk Foul"
"Spar-Raps"
"A Spur-Us Rap"
"Spy, He Hypes"
"Stab Mo['] at Mobs"
"Stalking [']Til GANKS" []
"Stank Ho to Shank" []
"Stay[']n Nasty"
"Stayin['] in Insanity"
"Step That Phattest"
"Stephan's Phatness"
"Strong Leet Long Street" []
"Styled Mo['] Modestly"
"Stylish Sly This"
"Sub-Trite Tributes"
"Sumpyn['] Unsymp, Puny Ms"
"Sunniest Sin-Tunes"
"Surely Fo['] Yourself"
"Surly Chant, Runty Clash" []
"Surreal Big Burglaries" []
"Swiftie if I Stew"
"A Swigger, I Swagger"
"A Swing in Swag"
"T-Money: My Tone"
"Take Mo['] to Make"
"Tally Yo['] Loyalty"
"Tasha's [a-word-u]hat"
"Teenage? Gee, Neat"
"Tha Hat: a H/T"
"That Ego Got Heat"
"That Good at Hot, Dog"
"That is at This"
"That Song: Hot Angst"
"Thin, Cute, in the Cut"
"A Thing O['] Hot Gain"
"This Cat, His Tact"
"This Fellow's Fliest Howls"
"This Goon Goin['] Host" []
"This Got So Tight"
"This Keg By the Big Sky"
"This Love Lives Hot"
"This Lung's Hustlings"
"This Man Has Mint"
"This One So Thine"
"This Punk Thinks Up"
"This Wolf Howl Fits"
"Throwing Right Now"
"Thug Life: Huge Lift"
"A Thump, Um, Phat" []
"Tight, Tiger, Get it Right"
"A Time I Mate" []
"Tiny Harem in My Heart" []
"To Enjoy on Yo['] Jet"
"To Fade Dat Foe"
"To Flay Yo['] Flat"
"To Hit it, Tho[']"
"To Hos So Hot" []
"To I the Hottie"
"To Make OK, Mate, Take Mo[']" []
"To Mash Mo['] Hats"
"To Rip it Pro"
"To Sift Fo['] Tits"
"To Slug Ol['] Guts"
"To Sow Woots"
"To Swing Wit['] Song Gots Win"
"Toast of Too Fast"
"Tonight's Hot Sting"
"Tons On St"
"Too-Low Ol['] Woot"
"Toss Me Mo Sets"
"A Toy to Ya"
"Trade Mo['] to Dream"
"Trapped Dat Perp"
"Trick, We Wreck It"
"Trim Shy Rhymist"
"Trop Fun Up Front" []
"Tropic Days Disco Party"
"Tuff, Lean, Affluent"
"U GOTS GUSTO"
"U No Be Bueno"
"Uh, A Lover Overhaul"
"Uh, Gots to Gush So, Thug: Ho, Guts" []
"Uh, Tip, Hit Up it, Hup"
"Um, Be Stout, Bust [']Em Out"
"Um, Bla Album"
"Um, Love Volume" []
"Um, This, it Hums"
"Umm, Mix a Maximum"
"Un-Dorks So Drunk" []
"Undergoing Guerdoning"
"The Urge Hurt, Gee"
"Us Boys So Busy"
"Us Got Gusto" []
"USA Be Top, So Upbeat"
"USA Vibe: IB Suave, Abusive"
"V-Square Quavers"
"Very Suave Verve, Us? Ay"
"A Vibe Hour Behaviour"
"VIP Only Vinyl Op"
"VIP Seen Pensive"
"A Vision: I So Vain"
"Voice O['] Vice"
"Volunteers Unto Revels"
"Way Up Aw Yup" []
"Ways to Swat, Yo"
"We All Love a Low Level"
"We Band to Beat Down"
"We Mark Mr. Weak"
"We Pros['] Powers"
"We Say Aw Yes"
"We Sear a Sewer Raw, See"
"We Storm [']Em Worst"
"We Style Sweetly" []
"We're Back. Er, Be Wack"
"Wham, Note the Woman" []
"What a Ride With a Dare"
"What No Hat Now"
"Where Can I Care, Whine"
"Where I Hew Ire"
"Where is His Ewer"
"Who Felt the Flow"
"Who Gets It? We Got This"
"Why Not Be By the Now" []
"The Wild Lewd Hit" []
"Wino Hither, Inherit How"
"Wins Got to Swing" []
"A Wise Memo: I'm Awesome"
"With Mean White Man"
"The Wolf Who Left Floweth" []
"Woof, Pull, Follow Up"
"WootKru Workout: OK or Wut"
"Wounded, Down, Due"
"A Wreck, Wacker"
"Wrek-Krew"
"Y'Start a Tryst"
"Ya Best Stay Be Beasty"
"Yah, Live Heavily"
"Yawl as Always"
"A Yellow Woe, Y'all"
"Yer Ma is a Misery"
"Yes, Boom Some Yob"
"Yes, Flow, We So Fly"
"Yes, Porous Your Posse: Yo, Poseurs"
"Yes to Yo['] Set Yet, So"
"Yo All Loyal Lay Lo" []
"Yo, Bam, Ya Mob"
"Yo, Be With White Boy"
"Yo, Bop, Po['] Boy"
"Yo, Cap a Copy-Cop, Ya"
"Yo Czars So Crazy"
"Yo Dames Someday Say Do Me"
"Yo Fueling Young Life"
"Yo Girl I Glory"
"Yo, Glee, Fun: Feel Young"
"Yo, Hater, a Theory" []
"Yo, He's So Hey-Oh-Yes"
"Yo, Hikes is Hokey"
"Yo, Hurl Hourly"
"Yo, Jet In, Enjoy It" []
"Yo, Luke, I Like You"
"Yo, Mesh, Homeys"
"Yo, My Sign: Noisy Gym Misogyny"
"Yo, Pals, Play So"
"Yo, Spark KO Spray"
"Yo, Thirst's This Story"
"Yo, What? Way Hot"
"Yolo'n Loony"
"Yon Ol['] Loony" []
"You Ain't in, Ya Out"
"You Be Aft of Beauty"
"Your Voice, I Cover You"
"Youth is Thus, Yo, I"
"Yum Lick I'm Lucky"
"Zip as I Spaz"
"Zone-Out Zoo Tune"
"Zucchini Iz Un-Chic"

table of mob chants [xxm02]
blurb
"'Adventurous? Suave? ROTUND!'"
"'And shout thousand daunts, ho!'"
"'Astoundingly sludgy nation!'"
"'BS! Low blows!'"
"'Cur, to court!'"
"'Dictator! Acrid tot!'"
"'Diluted luddite!'"
"'Dusty icon: IN CUSTODY!'"
"'Easy, poseur! Europe says you're passe!'"
"'Ehh, still the shill!'"
"'Era's ill! Rallies!'"
"'Evil-gripe pig, revile privilege!'"
"Furores for sure." []
"'Graded now: Dead wrong! Downgrade!'"
"Hear out our hate!"
"'Hegemon? Meh, gone!'"
"'Hypnotism-smit phony!'"
"'In your shell? Sly, unholier!'"
"'Insulated sultan, die!'"
"'Lackin['] a Clink!'"
"'Leading? Dang lie!'"
"'Lecherous Recluse, oh!'"
"'Let's war, wastrel!'"
"'LIAR LAIR!'"
"'Maestro? Some rat to smear!'"
"Marchers. Charmers!"
"'Mass idol? So dismal!'"
"'Mediators? Amortised!'"
"Mo['] pupils['] populism." []
"Mobile lie mob."
"Mobs['] cries. 'Some cribs, crime boss!'"
"'Moralist? Liar, most!'"
"'More spew EMPOWERS!'"
"'Neutrals run stale!'"
"A new role: learn woe!"
"No saint: sin a ton!" []
"'Not happy, phony? Apt!'"
"'Obtuse, be? OUST!'" []
"'Oily low nut, you will NOT!'"
"'One-ups us? Nope!'"
"Outraged, rude goat!"
"'Pig! Rouse groupies?!'"
"'Pour ires or rise up, superior!'"
"'Pred? Derp!'"
"A protest, pro-state."
"'Push in! PUNISH!'" []
"'RADICAL! CAD! LIAR!'" []
"'Remand ME?! Darn!'"
"'Rep, tots! Protest!'"
"'Roguery now! You're wrong!'"
"'Sad soon, so-and-so!'"
"Saint? A snit!"
"'Say, chop a psycho!'"
"'Say no to a snot, yo!'"
"'A seedy story! So yesterday! Destroy easy!'"
"'So, a turnip, in our past!'"
"So corny? Yo, scorn: cry soon!"
"'Soft? Rosy? So frosty!'"
"'Solitude's dissolute!'"
"Spaciest escapist!"
"Surging Urgings."
"Tourist, stir! Out!"
"'Treed! Deter!'"
"'TYRANT'S RANT STY!'"
"'Ungrateful, rueful gnat!'"
"'Upstaged? Upset? Gad!'"
"'Venerable? Never able!'"
"'Violated! Violated! Dovetail, vile toad!'"
"'Viper to tip over!'"
"'We throng the wrong!'" []
"'We trap a twerp!'"
"'Wordsmith? Worth's dim!'"
"'Yes, bandit! Stay in bed!'"
"'Yesterday's strayed, yes?'"
"'You fell off! Fly, foul foe!'"

table of oldies singers [xxm03]
blurb
"Abe 'Chum' Beachum"
"Abject Cat Jeb"
"Absurd Bard Su"
"Actual Herb Lauterbach"
"Actual Rene Laracuente"
"Actual Sina Santalucia"
"Al 'Chump' Mcphaul"
"Al 'Hips' Haslip"
"Alec 'Yum' Mcauley"
"Allen 'Yum' Mullaney"
"Alto Ben Labonte" []
"Alto Bo Lobato"
"Alto Cyr Claytor" []
"Alto Hilburn Halliburton"
"Alto Minh Hamilton"
"Alto Nevin Valentino"
"Alto Toal"
"Andra 'Yum' Muradyan"
"Angsty Ty Gans"
"Ann 'Yum' Munyan"
"Annese 'Chum' Schueneman"
"Any-Clot Clayton"
"Ara 'Dish' Rashida" []
"Arnett 'Dish' Steinhardt"
"Aron 'Dish' Hardison" []
"Avid Diva Vida"
"Avowedly Way-Loved Davy Lowe"
"Bad-Shape-Bashed Pa"
"Banjo Rae Bejarano"
"Barb 'Chum' Brumbach"
"Bass Ely Bayless"
"Bass Haugen Sensabaugh"
"Bearded Bard Dee" []
"Bent Ol['] Belton-Noblet"
"Big-Song Boggins"
"Bleak Ry Barkley"
"Bleary Al Byer"
"Blue Al Uballe"
"Blue Art Breault"
"Blue Ava Labauve"
"Blue Bert Luebbert"
"Blue Boy Bub Oyle"
"Blue Chara Laubacher"
"Blue Cher Buechler"
"Blue Daron Abdelnour"
"Blue Don Boulden"
"Blue Eloisa Beausoleil"
"Blue Elton Buentello" []
"Blue Elvia Belliveau"
"Blue Evia Beliveau"
"Blue Farah Faulhaber"
"Blue Gita Gibeault"
"Blue Grant Altenburg"
"Blue Lea Belleau"
"Blue Ma Elbaum"
"Blue Mattie Teitelbaum"
"Blue Norme Melbourne"
"Blue Rae Bauerle"
"Blue Sona Banuelos"
"Blue Tam Bultema"
"Boomer Rob-Moe Broome" []
"Boy Del Bodley"
"Boy Ed Dobey"
"Boy Gil Gilboy"
"Boy Len Boylen"
"Boy Leo O'Boyle" []
"Boy Mel Mobley" []
"Boy Ned Boyden" []
"Boy Son Boyson"
"Breathy Beth Ray Bayther"
"Broke Claud Louderback"
"Broke Dee Boedeker"
"Broke Donna Bondarenko"
"Broke Elma Blakemore"
"Broke Mel Bloemker"
"Broke Mercy Brockmeyer"
"Broke Rhonda Hardenbrook"
"Broken Abe Bonebrake"
"Broken Bo Benbrook"
"Broken Ced Rodenbeck"
"Broken Chery Hockenberry"
"Broken Dona Bondarenko" []
"Broken Gal Longbrake"
"Broken Leif Fiebelkorn"
"Broken Lui Kilbourne"
"Broken Sigg Konigsberg"
"Broken Tresa Stonebraker"
"Broody Boy Rod"
"Bulbous Bob Sulu"
"Bulbous Soul Bub" []
"Cain 'Hips' Schipani"
"California [if player is male]Olin Faraci[else]Fiona Clair[end if]"
"Careworn [if player is male]Owen Carr[else]Cora Wren[end if]"
"Cheated Cath Dee"
"Chiptune Ute Pinch"
"Chronic-Chic Ron"
"Clair 'Dish' Schiraldi"
"Clear Al Carella"
"Clear Alva Caravella"
"Clear Bo Barcelo"
"Clear Cecil Ceccarelli"
"Clear Celine Cancelliere"
"Clear Deon Calderone"
"Clear Diana Candelaria" []
"Clear Dina Cardinale" []
"Clear Don Calderon" []
"Clear Dona Colandrea" []
"Clear Ed Recalde" []
"Clear Em Mcaleer"
"Clear Evan Carnevale"
"Clear Evia Cavaliere"
"Clear Ewen Lawerence" []
"Clear Gail Callegari"
"Clear Gia Graciela"
"Clear Ham Lamarche" []
"Clear Ida Caldeira" []
"Clear Isa Aracelis"
"Clear Ismail Masciarelli"
"Clear Iva Cavalier"
"Clear-Key Ackerley"
"Clear Kip Pickeral"
"Clear Lad Cardella" []
"Clear Lina Racanelli"
"Clear Lis Carlisle" []
"Clear Lois Caroselli"
"Clear Lon Colleran"
"Clear Lu Cuellar"
"Clear Malia Ciaramella"
"Clear Mel Marcelle"
"Clear Micah Carmichael" []
"Clear Mick Carmickle"
"Clear Mike Mielcarek"
"Clear Ned Calender"
"Clear Nigel Gencarelli"
"Clear Odis Decarolis" []
"Clear Old Cardello-Delcarlo" []
"Clear Rob Berrocal"
"Clear Ros Corrales"
"Clear Sol Calleros"
"Clear Stan Lancaster"
"Clear Su Clauser"
"Clear Sybert Castleberry"
"Coherent [if player is male]Chet Oren[else]Cher Eton[end if]" []
"Comely Moe Cly"
"Common Sal Malcomson"
"Cool Amend Delmonaco"
"Cool Angel Colangelo"
"Cool Ann Colonna"
"Cool Brasky Claybrooks"
"Cool Darcel Dellarocco"
"Cool Dora Colorado"
"Cool Dowling Collingwood"
"Cool Edward Calderwood" []
"Cool Eric Locicero"
"Cool Erin Cornelio" []
"Cool Finer Florencio"
"Cool Gina Cogliano"
"Cool Han Calhoon"
"Cool Iona Loiacono"
"Cool Kevin Kolenovic"
"Cool Kid Doolick"
"Cool Lev Covello"
"Cool Levi Coviello"
"Cool Lyn Conolly"
"Cool Lynn Connolly"
"Cool Man McAloon" []
"Cool Merk Morelock"
"Cool Meryl Collymore"
"Cool Mona Lomonaco"
"Cool-Name [if player is male]Alec Moon[else]Loo Mance[end if]"
"Cool Paley Claypoole" []
"Cool Sam Mascolo"
"Cool Si Colosi"
"Cool Sinner Cornelison"
"Cool Star Locastro" []
"Cool Vita Colavito"
"Cora 'Hips' Schapiro"
"Cristen 'Hope' Stonecipher"
"Croonings Consignor Ron Scogin"
"Croony Conroy"
"Cry-Sob Crosby"
"Cute Ard Decatur"
"Cute Arlena Laracuente" []
"Cute Barton Betancourt"
"Cute Breton Bonecutter"
"Cute Corina Tucciarone"
"Cute Dora Courtade"
"Cute Dori Coudriet"
"Cute Fae Fecteau"
"Cute Ham Cheatum"
"Cute Hoston Touchstone"
"Cute Iona Aceituno"
"Cute Isa Escutia"
"Cute Kerr Rueckert"
"Cute Len Lucente"
"Cute Loghry Clougherty"
"Cute Lon LeCount"
"Cute Lora Lucatero" []
"Cute Lori Cloutier" []
"Cute Loura Lacouture"
"Cute Misha Schuitema"
"Cute Nanci Antenucci"
"Cute Norman Counterman"
"Cute Orr Courter"
"Cute Rash Tauscher"
"Cute Robnett Bettencourt"
"Cute Ron Cureton" []
"Cute Ryon Courtney"
"Cute Sala Lacuesta"
"Cute Seth Schuette"
"Cute Shea Eustache"
"Cute Sher Teuscher"
"Cute Shon Schouten" []
"Cute Sky Stuckey"
"Cute Tora Crotteau"
"Cute Ula Cuautle"
"Cyril's Lyrics"
"Dan 'Yum' Munday"
"Dang-Dim Madding"
"Darling Lingard"
"Darn Fly Fryland"
"Darn Glib Girl Band"
"Daron 'Yum' Raymundo"
"Dashing Dan Gish" []
"Dear Amy Demaray-Maready"
"Dear Arch Hardacre" []
"Dear Bryn Bernardy"
"Dear Cal Lacerda" []
"Dear Carin Carradine" []
"Dear Chum Ducharme" []
"Dear Clem Mercadel"
"Dear Flo Alfredo" []
"Dear Gil Daigler" []
"Dear Herb Eberhard"
"Dear Hong Hagedorn"
"Dear Laci Caldeira" []
"Dear Len Anderle" []
"Dear Lev Velarde-Laverde"
"Dear Lila Dallaire"
"Dear Lin Ireland" []
"Dear Lis Sadlier"
"Dear Lon Leonard" []
"Dear Luanne Landreneau" []
"Dear Luc Caulder" []
"Dear Luna Landauer" []
"Dear Marek Rademaker"
"Dear Mia Madeira"
"Dear Moll Delmoral" []
"Dear Nell Allender"
"Dear Nicola Candelario" []
"Dear Nino Orendain" []
"Dear Olga Regalado"
"Dear Olin Andreoli" []
"Dear Ren Rearden"
"Dear Rich Reichard"
"Dear Scot Decastro"
"Dear Su Sauder"
"Dear Syble Beardsley"
"Dear Telma Delamater"
"Dear Tot Doretta"
"Dear Trish Hardister"
"Dear Tuan Urdaneta" []
"Death-Lorn Dale North"
"Debonair [if player is male]Rob Daine[else]Andi Boer[end if]"
"Deep Alan De La Pena" []
"Deep Ara Paradee"
"Deep Ira Pereida"
"Deep Josh DeJoseph"
"Deep Lis Speidel"
"Deep Lorri Delpriore"
"Deep Ly Pedley"
"Deep Lyn Pendley"
"Deep Ray Pereyda"
"Deep Tori DePietro" []
"Derelict Del Trice"
"Desperate [if player is male]Ted Pearse[else]Tera Speed[end if]"
"Destroyed [if player is male]Teddy Rose[else]Dede Story[end if]"
"Dim Amee Miedema"
"Dim Ana Madani" []
"Dim Aron Mirando"
"Dim Asha Shimada"
"Dim Breanne Biedermann"
"Dim Brooks Dombroski"
"Dim Coe Medico"
"Dim Connie Mendicino"
"Dim Cora Dimarco" []
"Dim Darla Lamadrid"
"Dim Don Dimond"
"Dim Dona Diamond" []
"Dim Elena Madeline"
"Dim Elvin Mendivil"
"Dim Ernest Edminster"
"Dim Ester Edmister"
"Dim Fran Fridman"
"Dim Hanner Hinderman"
"Dim Ice Medici"
"Dim Icon Dominic"
"Dim Kena Dikeman"
"Dim Kenna Diekmann"
"Dim Lance Mcdaniel" []
"Dim Lea Delima" []
"Dim Len Meindl"
"Dim Leona Mendiola"
"Dim Lon Modlin"
"Dim Lora Milardo"
"Dim-Lore Dilmore"
"Dim Luna Mauldin"
"Dim Neal Idleman"
"Dim Noe Domine" []
"Dim Norah Hardimon" []
"Dim Noreen Merendino"
"Dim-Now Windom" []
"Dim Ora Moradi"
"Dim Rae Admire"
"Dim Renita Demartini"
"Dim Reyna Deyarmin"
"Dim Rhea Hermida"
"Dim Rina Miniard"
"Dim Rolf Milford"
"Dim Roper Pridmore"
"Dim Rose Dismore" []
"Dim Rosen Mondesir"
"Dim Rote Tidmore"
"Dim Ryan Minyard"
"Dim Sara Madaris"
"Dim Sean Seidman"
"Dim Serina Demarinis"
"Dim Seth DeSmith"
"Dim Shon Dishmon"
"Dim Slate Milstead"
"Dim Star Ditmars"
"Dim-Sung Sigmund" []
"Dim Tana Diamant"
"Dim Tart Dittmar"
"Dim Teena Mendieta-Tiedeman" []
"Dim Trena Demartin"
"Dim Zane Zeidman"
"Dim Zora Dimarzo"
"Dingy Eli Yielding"
"Dire Bo Brodie"
"Dire Euna Riendeau"
"Dire Hans Sheridan" []
"Dire Jan Jardine" []
"Dire Lew Weidler"
"Dire Luna Lindauer" []
"Dire Minta DeMartini" []
"Dire Mose Medeiros" []
"Dire Pam Dampier"
"Dire-Rock Roderick"
"Dire Rolf Reliford" []
"Dire Tom DeMitro" []
"Dire Wen Weidner" []
"Dire Wm Widmer" []
"Dirge-Led Eldridge"
"Disheartened Deidre Athens"
"Diva Al Davila"
"Diva Allen Villaneda"
"Diva Cris Viscardi"
"Diva Dina Davidian"
"Diva Earl Delariva"
"Diva Ervin Vandivier"
"Diva Eryn Vineyard" []
"Diva Gia Gavidia"
"Diva Lea Deavila"
"Diva Len Ledvina"
"Diva Les Desilva"
"Diva Olin Vindiola"
"Diva Otto Dottavio"
"Diva Sal Dasilva"
"Diva Sol Disalvo"
"Diva Vern Vandiver"
"Doom Mood Odom"
"Doyle's Yodels"
"Drab Bard Brad"
"Drawlin['] Lin Ward"
"Drawling Ward Ling" []
"Drawly Ly Ward"
"Dreamlike Mike Adler"
"Dreamy May Erd"
"Dreary Red Ray Ardrey"
"Dulce Ced Lu"
"Earnest Gil Easterling"
"Earnest Leigh Siegenthaler"
"Ella 'Dish' Dashiell"
"Emmitt 'Hope' Petithomme"
"Emo Boy Bo Moye"
"Emo Moe"
"Ena 'Yum' Mauney"
"Enid 'Chum' Duchemin"
"Enormo-Mooner Ron Moe" []
"Enos 'Yum' Mounsey"
"Exploited Po['] Idle Tex"
"Failed Luc Caulfield"
"Fair Allen Farinella"
"Fair Brian Fairbairn"
"Fair Che Fichera"
"Fair Eli Alfieri"
"Fair Enid Frediani"
"Fair Enos Serafino"
"Fair Erlene Lafreniere"
"Fair Fidel Fairfield"
"Fair Hilde Hairfield"
"Fair Ines Serafini"
"Fair Jo Fraijo"
"Fair Ken Frankie"
"Fair Loreta Taliaferro"
"Fair Ned Defrain"
"Fair Pat Parfait"
"Fair Rod Raiford"
"Fair Shon Forinash"
"Familiar Fair Liam"
"Five Sorta Favorites" []
"Flowery Rolf Wye"
"Foreigner Rene Frigo"
"Freer Old Doerfler-Releford"
"Friendly Fly Derin"
"Funk Loser Fulkerson" []
"Gamed Madge"
"Gena 'Dish' Headings"
"Glittery Ly Rettig"
"Good Time Diego Tom"
"Gramophonist-Monographist Gari Thompson"
"Green-Rid Ned Grier-Deringer"
"Griefy Ferg Yi"
"Grim Alda, Madrigal"
"Grim-Luck Glum Rick"
"Grungiest-Gut Singer Gus Ginter"
"Hackneyed [if player is male]Chad Keeny[else]Dyan Cheek[end if]"
"Hades Heads" []
"Hae 'Yum' Mayhue"
"Hangdog Dan Hogg"
"Hard-Luck Chad Krul" []
"Hard Rockin['] [if player is male]Darrin Koch[else]Darci Krohn[end if]"
"Harmonic Choirman Mica Horn"
"Harmonistic Harmonicist [if player is male]Mo Christian[else]Simona Richt[end if]"
"Haunted Tan-Hued [if player is male]Ned Auth[else]Eda Hunt[end if]" []
"Hearty Ty Hare"
"Hector 'Hips' Christophe"
"Helpless Shep Ells"
"Hick Alma Michalak"
"Hick Bart Bickhart"
"Hick Bowles Chlebowski"
"Hick Burma Krichbaum" []
"Hick Elma Michalek"
"Hick Elva Havlicek"
"Hick Ernst Schnitker"
"Hick Ian Chaikin"
"Hick Joan Hojnacki"
"Hick Jovan Jankovich"
"Hick Kraus Kucharski"
"Hick Leone Kincheloe"
"Hick Les Schilke"
"Hick Lon Kinloch"
"Hick Lyne Hinckley"
"Hick Mila Michalik"
"Hick Neil Kichline"
"Hick Red Hedrick"
"Hick Reid Heidrick"
"Hick Ron Hornick"
"Hick Salim Michalski" []
"Hick Stan Stachnik"
"Hick Sun Huckins"
"Hick Ward Hardwick"
"Hip Alton Oliphant"
"Hip Arlen Halperin-Lanphier"
"Hip Cat Pat Chi"
"Hip Cora Porchia"
"Hip Crothers Christopher"
"Hip Dora Prihoda"
"Hip Duane Dauphine"
"Hip Elsa Heaslip"
"Hip Elsy Shipley"
"Hip Elza Hazelip"
"Hip Erma Ephraim"
"Hip Esta Hietpas" []
"Hip Gent Thigpen"
"Hip Lan Alphin"
"Hip Lecy Chipley"
"Hip Lee Heiple"
"Hip Lisa Haislip"
"Hip Long Golphin"
"Hip Lyle Philley"
"Hip Macon Champion"
"Hip Maple Pamphile" []
"Hip Moe Opheim" []
"Hip Oscar Schapiro" []
"Hip Rosa Shapiro" []
"Hip Sal Haslip" []
"Hip Sol Hislop" []
"Hip Sung Shuping" []
"Hip Taubert Breithaupt"
"Hot Adler Aderholt" []
"Hot Akers Hoekstra"
"Hot Berna Rathbone" []
"Hot Bo Booth"
"Hot Clark Lockhart"
"Hot Cleo the Cool" []
"Hot Dan Donath"
"Hot Dyer Doherty"
"Hot Elbert Berthelot"
"Hot Elma Lamothe"
"Hot Gale Holgate" []
"Hot Glennis Shingleton"
"Hot Gus Stough" []
"Hot Huang Haughton"
"Hot Huong Houghton"
"Hot Jenson Johnstone"
"Hot Larsen Rosenthal" []
"Hot Len Helton"
"Hot Lester Hostetler"
"Hot Lon Holton"
"Hot Lyn Hylton"
"Hot Man Thoman"
"Hot Mason Thomason"
"Hot Milan Hamilton" []
"Hot Nasir Hairston" []
"Hot Nat Hatton"
"Hot Nigel Leighton"
"Hot Niles Holstein" []
"Hot Noe Hooten"
"Hot Norbert Brotherton"
"Hot Plain Oliphant" []
"Hot Ray Yorath"
"Hot Rey Yother" []
"Hot Samson Thomasson"
"Hot Satan Thanatos"
"Hot Soren Thoreson"
"Hot Su South" []
"Hot Trena Atherton"
"Hot Twin Whitton"
"Hot Warm Ma Worth"
"Hot Wells Shotwell"
"Hot Wren Worthen" []
"Howler Wohler"
"I-So-Hep Sophie" []
"Ian 'Dish' Nishida"
"Ida 'Chum' Michaud"
"Idle-Sob Seibold"
"Idol Ann Landino"
"Idol Anna Andolina"
"Idol Arlen Nardiello"
"Idol Aron Ardolino"
"Idol Art Altidor"
"Idol Beau Bilodeau"
"Idol Bren Reinbold"
"Idol Cain DiNicola"
"Idol Carl Cardillo"
"Idol Cesar Decarolis" []
"Idol Damon Lindamood"
"Idol Deb Diebold"
"Idol Ezra Elizardo"
"Idol Gena Diangelo"
"Idol Hess O'Shields"
"Idol Ivan Vindiola" []
"Idol Les Sedillo"
"Idol Lin Dillion"
"Idol Mae Damelio"
"Idol Marg Grimaldo" []
"Idol Mei Demilio"
"Idol Neal Daniello"
"Idol Olga Alligood"
"Idol Rae Deloria"
"Idol Rena Leonardi" []
"Idol Sana Saladino"
"Idol Serna Leonardis"
"Isolated [if player is male]Otis Dale[else]Leda Tsoi[end if]" []
"Jinxed Jed Nix"
"Jumbled Jed Blum"
"Kabir 'Chum' Krichbaum"
"Kao 'Yum' Yoakum"
"Kern 'Dish' Hendriks"
"Kewl Welk" []
"Kind Alber Birkeland"
"Kind Amos Domanski"
"Kind Azhar Zahradnik"
"Kind Bo Bodkin-Dobkin"
"Kind Cai Kincaid"
"Kind Cher Hendrick"
"Kind Elias Danielski"
"Kind Erwin Drinkwine" []
"Kind Geri Dierking"
"Kind-Heart [if player is male]Dirk Thane[else]Kit Harden[end if]" []
"Kind Hog Hodgkin"
"Kind Isabel Niedbalski"
"Kind Karl Kirkland"
"Kind Kia Kinkaid"
"Kind Lois Dolinski"
"Kind Ma Kidman"
"Kind Mac Dickman" []
"Kind Mace Dieckman"
"Kind Mae Diekman" []
"Kind Maren Kinderman"
"Kind Ochsner Hendrickson"
"Kind Reba Bednarik"
"Kind Rex Kendrix"
"Kind Rina Kinnaird"
"Kind Sam Madkins"
"Kind Si Diskin"
"Kind Sona Adkinson"
"Kind Su Duskin" []
"Klif's Filks"
"Lachrymose [if player is male]Myles Roach[else]Cary Holmes[end if]"
"Lad Nash Ashland"
"Lame Ada Alameda"
"Lame Addie Dealmeida"
"Lame Arch Lamarche" []
"Lame Arn Marlena" []
"Lame Aron Molenaar"
"Lame Ash Salameh"
"Lame Blair Mirabella"
"Lame Brito Baltimore"
"Lame Brock Blackmore"
"Lame Cari Maricela"
"Lame Carin Marcelina"
"Lame Carl Marcella"
"Lame Cash-in Aeschliman"
"Lame Colin Monacelli"
"Lame Corl Marcello"
"Lame Cristal Macallister"
"Lame Dan Adelman" []
"Lame Detra Delamater" []
"Lame Don Mendola"
"Lame Dona Amendola"
"Lame Dora Delamora"
"Lame Enid Madeline" []
"Lame Erick Mielcarek" []
"Lame Erin Eilerman"
"Lame Eun Emanuel"
"Lame Gandhi Leadingham"
"Lame Gil Millage"
"Lame Gino Maglione"
"Lame Ida Almeida"
"Lame Ines Milanese" []
"Lame Ira Laramie" []
"Lame Jorge Melgarejo"
"Lame Ken Kleeman"
"Lame Kin Kleiman"
"Lame Kyra Malarkey"
"Lame Lan Alleman"
"Lame Leon Mallonee"
"Lame Li Millea"
"Lame Lin Minella"
"Lame Lira Mariella"
"Lame Lis Maselli" []
"Lame Lois Masiello"
"Lame Londa Lamendola"
"Lame Mel Mellema"
"Lame Ned Edelman-Edelman" []
"Lame Niki Melikian"
"Lame Nikia Mikaelian"
"Lame Petra Palmateer"
"Lame Rae Laramee"
"Lame Rand Alderman" []
"Lame Ren Marlene"
"Lame Rey Remaley"
"Lame Rich Melichar"
"Lame Rio Romelia" []
"Lame Risa Marisela"
"Lame Rob Lombera"
"Lame Ron Monreal"
"Lame Ros Morales"
"Lame Sal Masella"
"Lame Signe Geiselman"
"Lame-Sing Seligman" []
"Lame So Salome"
"Lame Sona Salamone"
"Lame Star Lamaster"
"Lame Su Samuel" []
"Lame Sun Uselman"
"Lame Thor Lothamer"
"Lame Tora Altomare"
"Lame Tori Latimore"
"Lame Trent Letterman"
"Lame Trey Altmeyer"
"Lame Una Manuela"
"Lame Van Maneval"
"Len 'Yum' Munley"
"Leonor 'Yum' Mulrooney"
"Les 'Dish' Shields"
"Lev 'Yum' Mulvey"
"Levan 'Yum' Mulvaney"
"Li'l Bess Bissell"
"Li'l Kip Killip"
"Lita 'Chum' Matulich"
"Lively Vi Lyle"
"Lon 'Hips' Philson"
"Lone Wolf Flo Enlow"
"Loner April Parrinello"
"Loner Bast Albertson"
"Loner Cal Colleran" []
"Loner Cami Marcelino"
"Loner Dacia Candelario" []
"Loner Dahl Hollander"
"Loner Deb Bolender"
"Loner Debra Oberlander"
"Loner Ed Olender"
"Loner Estes Rosensteel"
"Loner Geist Oesterling"
"Loner Gil Ollinger"
"Loner Hal Holleran"
"Loner Hustad Southerland" []
"Loner Ida Leonardi-Andreoli" []
"Loner Ira Lorraine"
"Loner Jada Alejandro"
"Loner Keva Vanroekel"
"Loner Lara Arrellano"
"Loner Les Ellerson"
"Loner Lida Nardiello" []
"Loner Mack Lockerman"
"Loner Mila Romanelli" []
"Loner Ola Orellano" []
"Loner Patil Pontarelli"
"Loner Sade Rosendale" []
"Loner Sal Ornellas"
"Loner Shad Rosendahl" []
"Loner Silva Villasenor"
"Loner Sura Raulerson"
"Loner Tad Alderton"
"Loner Thad Leonhardt" []
"Loner Tim Tomerlin"
"Loner Tobi Bertolino"
"Loner Zana Lorenzana"
"Lonesome Mo Olesen"
"Long-Dim Modglin" []
"Loreta 'Chum' Crouthamel"
"Lorn Abe Lebaron" []
"Lorn Ahmed Holderman"
"Lorn Asha Haralson" []
"Lorn Caleb Carbonell"
"Lorn Codi Coldiron" []
"Lorn Eda Olander" []
"Lorn Elsa Ornellas" []
"Lorn Etta Tarleton"
"Lorn Gail Granillo"
"Lorn Gena Lonergan"
"Lorn Gil Rolling" []
"Lorn Larae Arrellano" []
"Lorn Leah Holleran" []
"Lorn Leigh Hollinger"
"Lorn Lois Rollison"
"Lorn Mae Monreal" []
"Lorn Meda Moreland" []
"Lorn Mei Merlino"
"Lorn Mia Molinar" []
"Lorn Oda Orlando" []
"Lorn Risa Larrison"
"Lorn-Sack Clarkson"
"Lorn Shera Harrelson" []
"Lorn Tesha Rosenthal" []
"Lorn Theda Leonhardt" []
"Lorn Zoe Lorenzo"
"Loser Ada Delarosa"
"Loser Alvin Villasenor" []
"Loser Ava Arevalos"
"Loser Bee Ebersole"
"Loser Dan Roseland"
"Loser Dario Delrosario"
"Loser Dawn Rosenwald"
"Loser Dean Rosendale" []
"Loser Dina Leonardis" []
"Loser Dunn Rosenlund"
"Loser Em Melrose"
"Loser Hy Horsley"
"Loser Iva Oliveras"
"Loser Kin Sloniker"
"Loser King Gilkerson"
"Loser Kyle Roskelley"
"Loser Laci Caroselli" []
"Loser Latin Santorelli"
"Loser Len Ellerson" []
"Loser Lev Servello" []
"Loser Ling Ingersoll"
"Loser Lis Rosselli"
"Loser Mo Morelos"
"Loser Odis De Los Rios"
"Loser Pat Portales"
"Loser Sanda Alessandro"
"Loser Sid DelRossi" []
"Loser Sina Israelson"
"Loser Su Roussel"
"Loser Van Alverson"
"Loser Wink Wilkerson"
"Lost Abe Seabolt"
"Lost Alec Castello-Costella"
"Lost Amee Altemose"
"Lost Arline Santorelli" []
"Lost Arn Ralston"
"Lost Ava Salvato-Stavola"
"Lost Bree Stroebel"
"Lost Brenda Balderston"
"Lost Carri Trosclair"
"Lost Clair Castrillo"
"Lost Cole Costello"
"Lost Cora Locastro" []
"Lost Crank Clarkston"
"Lost Dana Dalsanto"
"Lost Elmer Mosteller"
"Lost Gena Stangelo" []
"Lost Gene Egleston-Egelston"
"Lost Ian Soltani-Santoli"
"Lost Karmen Klosterman"
"Lost Ken Skelton"
"Lost Laci Castillo" []
"Lost Lance Castellon-Castellon-Collantes"
"Lost Leo Sotello"
"Lost Leon Tolleson"
"Lost Leta Stellato"
"Lost Lin Tillson"
"Lost Lina Santillo" []
"Lost Linnea Antonellis"
"Lost Lorie Torsiello"
"Lost Ludie Estudillo"
"Lost Nat Slatton"
"Lost Neal Stallone"
"Lost Neil Elliston" []
"Lost Nick Slotnick"
"Lost Ogden Goldstone"
"Lost Olin Tollison"
"Lost Regine Oesterling" []
"Lost Ron Rolston"
"Lost Rose Rosselot"
"Lost Si Soltis"
"Lost Val Stovall"
"Loudest Soul Ted" []
"Love-Drunk Don Kluver"
"Loving Gil Von Volgin"
"Low Sad Oswald" []
"Lyricist Cristy Li"
"Mae 'Chum' Meachum"
"Milksop Sim Polk"
"Miserable Reba Miles"
"Mod Len LeMond" []
"Moldiest Most-Idle Melodist [d-t] Miles" []
"Mondegreen [if player is male]Gene Redmon[else]Doreen Meng[end if]"
"Moonster Montrose" []
"Motley Tom Ely"
"Mr. Oh-Any-Harmony" []
"Mug Alan Mangual"
"Mug Ana Guaman"
"Mug Arie Maugeri" []
"Mug Barb Bamburg"
"Mug Bernard Bumgardner"
"Mug Bert Gumbert"
"Mug Chana Caughman"
"Mug Dara Madruga"
"Mug Denis Siegmund"
"Mug Dion Guimond"
"Mug Dione Domingue"
"Mug Dona Gaumond"
"Mug Ed Mudge"
"Mug Edison Domingues"
"Mug Eli Miguel"
"Mug Eric Mcguire" []
"Mug Erma Rummage"
"Mug Hal Mughal"
"Mug Hana Maughan"
"Mug Ian Mungia-Gumina"
"Mug Ione Minogue"
"Mug Ira Murgia"
"Mug Israel Margulies"
"Mug Jann Jungman"
"Mug Lacey Mcgauley"
"Mug Lanita Manigault"
"Mug Lettie Guilmette"
"Mug Linda Maulding"
"Mug Lori Gilmour"
"Mug Nat Gutman"
"Mug Nat Tugman" []
"Mug Oren Mounger"
"Mug Rae Gaumer"
"Mug Rana Grauman"
"Mug Rick Mcguirk"
"Mug Ronni Mourning"
"Mug Tana Tanguma"
"Mug Toni Guimont"
"Muse Roy Seymour" []
"Musical Ms. Lucia"
"Mutual Umlaut"
"Na 'Dish' Danish"
"Nat 'Chum' Tuchman"
"Natch-Loser Charleston" []
"Natural See Arseneault"
"Nervy Ervyn Vyner"
"New Fly Elfwyn"
"Next-Door [d-t] Oxner"
"Nigel 'Hope' Philogene"
"Nigh-Lame Hilgeman"
"No-Girl Loring Gorlin"
"No-Mates Stan Moe"
"Noble Star Albertson" []
"Nomad Damon Monda" []
"Nomady Dynamo Dan Moy"
"Nostalgic Gnostical [if player is male]Clint Gosa[else]Staci Long[end if]"
"Oddest Sod Ted"
"OK Rube Bourke"
"Ol['] Carny Carolyn" []
"Ol['] Max Lomax"
"Ol['] Tray Taylor" []
"Old Abel Bedolla"
"Old Aline Daniello" []
"Old Amanda Maldanado"
"Old Andreas Dalesandro"
"Old Angie Diangelo" []
"Old Anisa Saladino" []
"Old Ann Noland-Landon" []
"Old Anna Andalon" []
"Old Anne Donelan"
"Old Anson Donalson"
"Old Arline Nardiello" []
"Old Aron Orlando" []
"Old Asa Losada"
"Old Avis DiSalvo" []
"Old Barnes Balderson"
"Old Bart Bartold"
"Old Ben Bolden"
"Old Berna Bolander" []
"Old Bo Blood" []
"Old Bree Doebler"
"Old Caren Calderon" []
"Old Cari Dicarlo"
"Old Carin Alcindor" []
"Old Carl Collard"
"Old Case Salcedo"
"Old Chae Deloach"
"Old Clair Cardillo" []
"Old Clare Cardello" []
"Old Damion Lindamood" []
"Old Dan Donald" []
"Old Dawn Dowland"
"Old Debi Diebold" []
"Old Elma Mellado"
"Old Elza Dolezal"
"Old Ethan Odenthal"
"Old Eva Olveda"
"Old Fran Lanford" []
"Old Frank Lankford"
"Old Fred Ledford" []
"Old Gary Gaylord"
"Old Gena Dangelo"
"Old Gina Galindo" []
"Old Ginger Goldinger"
"Old Gino Dooling"
"Old Gus Dlugos"
"Old Hack Hadlock"
"Old Hagan Hoagland"
"Old Herman Holderman" []
"Old Ian Oldani" []
"Old Irma Milardo" []
"Old Iva Davoli"
"Old Karen Kolander"
"Old Ken Knodel"
"Old Kena Kolenda"
"Old Keren Knoedler"
"Old Lenny Donnelly"
"Old Leon Odonell" []
"Old Levan Loveland"
"Old Lin Dillon" []
"Old Lise Sedillo" []
"Old Lottie Doolittle"
"Old Lowe Woodell"
"Old Lucia Caudillo"
"Old Ly Lloyd" []
"Old Mae Olmeda"
"Old Mae Olmeda-Madole" []
"Old Manie Mendiola" []
"Old Maren Moreland" []
"Old Meagan Magdaleno"
"Old Meri Dilmore" []
"Old Moe Olmedo"
"Old-Name Mondale" []
"Old Nat Dalton"
"Old Neal Lalonde"
"Old Nina Landino" []
"Old Noe Doolen" []
"Old Oleg Goodell"
"Old Olga Goodall"
"Old Pierre Delpriore" []
"Old Rae Laredo" []
"Old Rambo Lombardo"
"Old Reba Laborde" []
"Old Reba Laborde-Belardo" []
"Old Rena Leonard" []
"Old Rene Delnero" []
"Old Retha Aderholt" []
"Old Reyna Reynaldo"
"Old Rina Orlandi" []
"Old Rita Altidor" []
"Old Rose Dolores" []
"Old Rupe Plourde"
"Old Sean Adelson"
"Old Serena Rosendale" []
"Old Serina Leonardis" []
"Old Sharen Rosendahl" []
"Old Sharon Haroldson"
"Old Sinner [if player is male]Red Nilson[else]Linn Erdos[end if]"
"Old Sona Soldano"
"Old-Song Logsdon"
"Old Trena Alderton" []
"Old Tuan Outland-Daulton" []
"Old Van Voland"
"Old Vera Velardo-Velador"
"Old Verna Overland"
"Old Wonda Woodland" []
"Old Yetta Aydelott"
"Omer 'Chum' Muchmore"
"On-Meter Emerton"
"Ona 'Yum' Youman"
"Operatic Pia Ector"
"Organist Rita Song"
"Outcast Stu Cato"
"Owen 'Chum' Muenchow"
"Plain Ace Palencia"
"Plain Aldo Palladino" []
"Plain Amos Palmisano" []
"Plain Cole Pellicano"
"Plain Errol Parrinello" []
"Plain Ester Pearlstein"
"Plain Gale Paganelli"
"Plain Genna Pangelinan"
"Plain Les Spinella" []
"Plain Sal Aspinall"
"Plain Sky Lapinsky"
"Plain Teo Lapointe" []
"Played-Out [d-t] Pauley" []
"Played-Out Ty DePaulo" []
"Po['] Bo Boop"
"Po['] Daniel Denapoli" []
"Po['] Diane Peinado" []
"Po['] Ernest Peterson" []
"Po['] Ruth Thorup"
"Poor [n-t] Tropeano"
"Poor Mance Cooperman"
"Poor Mey Pomeroy"
"Poor Stein Petrosino"
"Poor Tisa Saporito"
"Poor Vince Provencio"
"Posh [n-t] Stanhope" []
"Posh Al Opsahl"
"Posh Andres Shepardson"
"Posh Cari Schapiro" []
"Posh Carmen Macpherson"
"Posh Ewan Openshaw"
"Posh Geri Grieshop"
"Posh Ira Shapiro" []
"Posh Itcher Christophe" []
"Posh Kara Prohaska"
"Posh Lin Philson" []
"Posh Man Hampson"
"Posh Mona Shoopman"
"Posh Nola Alphonso"
"Posh Sherri Shropshire"
"Rana 'Dish' Sardinha" []
"Ray-the-Earthy Thayer" []
"Real Abe Larabee"
"Real Abel Abellera"
"Real Boyd Boardley"
"Real Buck Arbuckle"
"Real Cami Maricela" []
"Real Candi Cardinale" []
"Real Clem Marcelle" []
"Real Danica Candelaria" []
"Real Dean Ardelean" []
"Real Deb Baldree"
"Real Dion Leonardi" []
"Real Don Olander" []
"Real Ed Leader"
"Real Eddy Adderley"
"Real Gaby Graybeal"
"Real Gail Allgaier"
"Real Gal Allegra" []
"Real Gia Alegria"
"Real Greta Legarreta"
"Real Gus Glauser"
"Real Gwen Greenlaw" []
"Real Kym Markley"
"Real Len Llerena"
"Real Levi Valliere"
"Real Lin Rinella"
"Real Lips Piersall"
"Real Lorna Arrellano" []
"Real Luc Cuellar" []
"Real Lucila Lauricella"
"Real Lyn Yarnell"
"Real Mac Maracle" []
"Real Mae Laramee" []
"Real Mia Laramie" []
"Real Miles Marseille"
"Real Mona Molenaar" []
"Real Mort Rotramel"
"Real Ned Anderle" []
"Real Nigel Langelier" []
"Real Omar Laramore"
"Real Pat Peralta" []
"Real Peg Peagler"
"Real Reba Larrabee"
"Real Rich Charlier"
"Real Rolf O'Farrell"
"Real Roni Lorraine" []
"Real Sam Ramales"
"Real Sandi Saldierna" []
"Real Si Israel" []
"Real Sid Sadlier" []
"Real Sue Leasure" []
"Real Ted Aldrete"
"Real Tess Lasseter"
"Real Tim Latimer"
"Real Tom Lamorte"
"Real Tora Alatorre"
"Real Trudi Iturralde"
"Real Ty Ratley-Artley" []
"Real Vance Carnevale" []
"Real Vi Valeri"
"Real Vito Voltaire"
"Real Wade Delaware"
"Real Wm Walmer"
"Recreator Carretero"
"Red Hot Ed Roth" []
"Rejected Jed Crete"
"Ren 'Yum' Rumney"
"Rena 'Dish' Sheridan" []
"Rena 'Hips' Einspahr-Seraphin"
"Renae 'Yum' Neumayer"
"Renate 'Dish' Eisenhardt" []
"Renee 'Yum' Neumeyer"
"Rent Al Lenart"
"Rent Aldo Alderton"
"Rent Ali Lantier"
"Rent Alma Alterman"
"Rent Amie Tremaine"
"Rent Amos Sarmento"
"Rent Ara Terrana"
"Rent Arie Renteria"
"Rent Art Tranter"
"Rent Ava Taverna"
"Rent Bao Boatner-Bartone"
"Rent Belia Albertine"
"Rent Bill Britnell"
"Rent Bo Breton"
"Rent Brad Bertrand"
"Rent Cami Martinec"
"Rent Cara Tarrance"
"Rent Cesar Stracener"
"Rent Chia Cathrine"
"Rent Chris Christner"
"Rent Cora Torrance"
"Rent Deb Berendt"
"Rent Del Tendler"
"Rent Eli Leitner"
"Rent Elsie Esterline"
"Rent Em Merten"
"Rent Erasmo Monserrate"
"Rent Esau Saeteurn"
"Rent Evan Tavenner"
"Rent Gabor Bontrager"
"Rent Gal Largent"
"Rent Garson Rosengrant"
"Rent Gigi Girgenti"
"Rent Gil Tingler-Giltner"
"Rent Giles Letsinger"
"Rent Gisela Easterling"
"Rent Helga Engelhart"
"Rent-Huge Guenther"
"Rent Hye Nethery"
"Rent Hyo Northey"
"Rent Ian Tiernan"
"Rent Iesha Eisenhart"
"Rent Ilene Enterline"
"Rent Ira Trainer"
"Rent Kami Martinek"
"Rent Keli Kleinert"
"Rent Ken Kentner"
"Rent Kit Knitter"
"Rent Les Nestler"
"Rent Lin Lintner"
"Rent Lis Nistler"
"Rent Lise Leistner"
"Rent Lola Allerton"
"Rent Love Leverton"
"Rent Luisa Lauritsen"
"Rent Maile Leiterman"
"Rent Marta Ratterman"
"Rent Mason Ostermann"
"Rent Maye Marteney"
"Rent Meda Determan"
"Rent Mei Termine"
"Rent Mia Tremain"
"Rent Milo Tomerlin"
"Rent Mo Merton"
"Rent Moe Emerton"
"Rent Nga Gantner"
"Rent Omar Armentor"
"Rent Ora Treanor"
"Rent Oscar Contreras"
"Rent Otha Atherton"
"Rent Paoli Petronila"
"Rent Pat Prenatt"
"Rent Pia Painter"
"Rent Ray Trenary"
"Rent Renita Interrante"
"Rent Rico Correnti"
"Rent Risa Rienstra"
"Rent Rob Bortner"
"Rent Ros Torrens"
"Rent Rose Terrones"
"Rent Sabra Barrantes"
"Rent Sage Sergeant"
"Rent Sam Martens"
"Rent Sanda Santander"
"Rent Sau Transue"
"Rent Savant Vanstraten"
"Rent Sima Martines"
"Rent Telma Letterman"
"Rent Tenisha Hartenstein"
"Rent Thad Hardnett"
"Rent Theo Etherton"
"Rent Thi Hittner"
"Rent Tia Tainter"
"Rent Tisha Hartstein"
"Rent Tobi Robinett"
"Rent Tobie Robinette"
"Rent Tom Mottern"
"Rent Ula Lautner"
"Rent Vella Ventrella"
"Rent Veola Leaverton"
"Rent Veta Vernetta"
"Rent Wei Weinert"
"Rent Yuko Kourtney"
"Rent Zia Terzian"
"Resonant [if player is male]Stan Nero[else]Ann Oster[end if]"
"Retha 'Chum' Hutmacher"
"Retread Art Reed"
"Riven Ervin Viner"
"Rob-Ray Yarbro" []
"Rod 'Chum' Murdoch"
"Rolling Ron Gill" []
"Romantic Carin['] Tom" []
"Rose 'Yum' Seymour"
"Rowena 'Hips' Spainhower"
"Rube Aida Rabideau"
"Rube Al Lauber"
"Rube Amie Beaumier"
"Rube Chana Brancheau"
"Rube Ed Dubree"
"Rube Eugena Neugebauer"
"Rube Euna Neubauer"
"Rube Gala Balaguer"
"Rube Garth Traughber"
"Rube Helena Lehenbauer"
"Rube Ida Brideau"
"Rube Ken Burkeen"
"Rube Lea Bauerle" []
"Rube Liza Brizuela"
"Rube Logan Boulanger"
"Rube Londa Abdelnour" []
"Rube Lyn Burnley"
"Rube Marg Umbarger"
"Rube Mason Rosenbaum"
"Rube Meggan Brueggeman"
"Rube Ming Grumbine"
"Rube Myrl Mulberry"
"Rube Ned Bendure" []
"Rube Nell Brunelle"
"Rube Oda Bordeau" []
"Rube Raina Barrineau"
"Rube Ray Auberry"
"Rube Rena Bernauer"
"Rube Rey Bruyere"
"Rube Rico Bourcier"
"Rube Rod Brodeur" []
"Rube Roslyn Lounsberry"
"Rube Sal Blauser"
"Rube Shona Barnhouse"
"Rube-Soon Osbourne"
"Rube Stan Eastburn" []
"Rube Tad Daubert"
"Rube Thora Rothbauer"
"Rube Tia Urbieta"
"Rube Una Bruneau"
"Rude Tenor Roundtree"
"Sad Alan Saldana"
"Sad Alderson D'Alessandro"
"Sad Avril Saldivar"
"Sad Beryl Bardsley"
"Sad Caren Cardenas" []
"Sad Cole Salcedo" []
"Sad Curt Custard"
"Sad Dino Addison"
"Sad Drew Edwards" []
"Sad Ector Decastro" []
"Sad Elois Dalessio"
"Sad Emert Demarest" []
"Sad Gertie Eastridge"
"Sad Guy Gus Day"
"Sad Ilona Saladino" []
"Sad Ivan Vadnais"
"Sad Kami Adamski"
"Sad Laverna Van Arsdale"
"Sad Lavon Sandoval" []
"Sad Len Landes"
"Sad Leon Adelson" []
"Sad Leora Delarosa" []
"Sad Letha Halstead"
"Sad Levi Desilva-Vidales" []
"Sad Lin Landis"
"Sad Lina Saladin"
"Sad London Donaldson"
"Sad Lonnie Danielson"
"Sad Loren Landeros" []
"Sad Mei Demasi"
"Sad Minh Dishman"
"Sad Mona Adamson"
"Sad Moni Madison"
"Sad Neil Daniels" []
"Sad Nell Sandell"
"Sad Noe Deason" []
"Sad Nurse Saunders" []
"Sad Olga Salgado"
"Sad Orval Salvador"
"Sad Otto Tostado"
"Sad Reece Decesare" []
"Sad Rena Andreas" []
"Sad Rhee Rasheed" []
"Sad Rina Sardina"
"Sad Tera Estrada"
"Sad Toni Disanto" []
"Sad Tyler Stradley"
"Sad Wren Andrews"
"Sailor Meg Margolies"
"Sailor Mia Rosamilia"
"Sailor Ned Leonardis"
"Savory Ray Vos"
"Schmo Aline Michaelson"
"Schmo Anne Schoneman"
"Schmo Atkin Mackintosh" []
"Schmo Ella Moschella"
"Schmo Ellery Schollmeyer"
"Schmo Ian Maschino"
"Schmo Neil Michelson"
"Schmo Perna Macpherson" []
"Schmo Prieto Coopersmith"
"Schmo Rae Cashmore"
"Schmo Ree Chesmore"
"Schmo Tina Macintosh"
"Seductive Stevie Duc"
"Serena 'Chum' Scheuerman"
"Shmoe DeHart Mothershead"
"Shmoe Kera Shoemaker"
"Shmoe Lord Soderholm"
"Shmoe Luc Suchomel"
"Shmoe Nance Schoeneman"
"Shmoe Nat Matheson-Stoneham" []
"Shmoe O'Brien Boomershine"
"Shmoe Stan Thomassen"
"Shmoe Terri Strohmeier"
"Shmoe Terry Strohmeyer"
"Shmoe Tina Mathieson"
"Shmoe Twan Mathewson" []
"Shmoe Una Houseman"
"Silk-Banjo Jablonski"
"Simple Ann Spielmann"
"Simple Erick Picklesimer"
"Simple Gena Spiegelman"
"Sky-Rent Krysten"
"Sloshed Old Hess"
"Slow Andre Rosenwald" []
"Slow Cather Schowalter" []
"Slow Dann Lansdown"
"Slow Deakin Lewandoski" []
"Slow Deann Lansdowne"
"Slow Del Doswell"
"Slow Determan Westmoreland"
"Slow Etienne Loewenstein"
"Slow Evan Vanselow"
"Slow Kandi Landowski"
"Slow Kathern Walkenhorst"
"Slow Ken Knowles"
"Slow Kina Wolanski"
"Slow Kori Orlowski"
"Slow Len Wellons" []
"Slow Les Sowells"
"Slow Lin Willson"
"Slow Marth Wahlstrom"
"Slow Mikki Milkowski"
"Slow Miska Maslowski"
"Slow Nat Walston"
"Slow Ned Denslow-Lowndes"
"Slow Niki Wilkison-Wolinski"
"Slow Pattie Postlewait"
"Slow Rand Rowlands" []
"Slow Retha Showalter"
"Slow Rey Worsley"
"Slow Tad Ostwald"
"Slow Tennie Lowenstein"
"Slow Thayer Aylesworth"
"Slow Vaden Swoveland"
"Smooth Linn Thomlinson"
"Smooth Mia Shimamoto"
"Smooth Nat Thomaston"
"Smooth Price Coopersmith" []
"Snakebit Skint [a-b]"
"So-Alive [if player is male]Leo Avis[else]Eva Lois[end if]"
"So-Alone Neal Soo"
"So-Emo Moose"
"So-Gritty Troy Gist"
"So-Tender Ted Rosen"
"Soft Guy Gus Foyt"
"Solid Gold Dodo Gills"
"Somber Ol['] Mel Boros"
"Soon-Lame Salomone" []
"Sot-Ode DeSoto"
"Spry Kathe, the Sparky"
"Still-Young Tyson Ullig"
"Straining Artis Ginn"
"Stung Anisa Sanagustin"
"Stung Eric Cutsinger"
"Stung Kerri Krutsinger"
"Stung Tonia Tousignant"
"Su 'Hope' Shoupe"
"Sugary Gus Ray"
"Sulking Sunk Gil"
"Sulky Lu Sky"
"Swayer Sawyer" []
"Sweet Aldrich Walterscheid"
"Sweet Lonnie Loewenstein" []
"Sweet Nolin Lowenstein" []
"Sweet Richman Schwieterman"
"Swell Amy Walmsley"
"Swell Arch Schwaller"
"Swell Dina Willadsen"
"Swell Nenita Wallenstein"
"Swell-Note Wellstone"
"Swell Tea Sawtelle" []
"Tam 'Dish' Stidham"
"Teary Bert Atteberry"
"Teary Em Metayer"
"Teary Hack Thackeray" []
"Telma 'Dish' Delashmit"
"Tena 'Dish' Hiestand"
"Tena 'Hips' Stephani"
"Tenor Chris Chronister" []
"Tenor Dahl Leonhardt" []
"Tenor Dan Anderton"
"Tenor Gus Sturgeon" []
"Tenor Lash Rosenthal" []
"Tenor Levy Yelverton"
"Tenor Mo Montero"
"Tenor Sam Osterman" []
"Tenor Whiting Witherington"
"Terra 'Dish' Hardister" []
"Tiemless Lee Smits"
"Tim 'Chum' Mitchum"
"Tired Agnus Staudinger"
"Tired Arch Reichardt"
"Tired Bennis Bridenstine"
"Tired Bo DeBrito"
"Tired-Bones Doberstein"
"Tired Chi Dietrich"
"Tired Dan Trindade" []
"Tired Em Diemert" []
"Tired Flash Hartsfield" []
"Tired Howle Wiederholt"
"Tired Lee Dieterle"
"Tired Lev Rietveld"
"Tired Loo DiLoreto"
"Tired Man DeMartin" []
"Tired Mina Demartini" []
"Tired Mo Ditmore" []
"Tired Mouse Stoudemire" []
"Tired Poe DePietro" []
"Tired Rahn Rinehardt"
"Tired Rash Hardister" []
"Tired Raul Iturralde" []
"Tired Sage Eastridge" []
"Tired Sang Grinstead"
"Tired Shane Eisenhardt" []
"Tired Tango Dragonetti"
"Tired Tona Andreotti"
"Tired Vi Trivedi"
"To-Filk-It Folk"
"Toasting Tangoist [i-n] Gotts"
"Too-Dire Ode Trio"
"Top Loser Lopresto"
"Top-Ode Ed Toop"
"Tora 'Yum' Moutray"
"Tortured [d-t] Ruter"
"Tramp Chet McPhatter"
"Tramp Eli Palmiter"
"Tramp Ernie Parmentier"
"Tramp Ken Trenkamp"
"Tramp Leia Palmatier"
"Tramp Leon Palmerton" []
"Tramp Rene Parmenter"
"Tres Beau Bret Esau"
"True Al Lauter"
"True Ash Huertas"
"True Ben Neubert"
"True Chas Tauscher"
"True Codi Coudriet"
"True Dale Delauter"
"True Dan Durante"
"True Dana Urdaneta"
"True Daniels Delaurentis"
"True Dona Tondreau"
"True Elva Revuelta"
"True Gail Lartigue"
"True Gia Gautier"
"True Hal Rheault"
"True Hanh Neuharth"
"True Irma Murrieta"
"True Laci Lucretia"
"True Les Eutsler"
"True Levan Laventure"
"True Loma Realmuto"
"True Lyn Turnley"
"True Marti Murrietta"
"True Milo Moultrie"
"True Niesha Steinhauer"
"True Nilsa Lauritsen"
"True Omar Muratore"
"True Oren Rountree"
"True Pal Pautler"
"True Pearl Perreault"
"True Reid Deruiter"
"True Retha Trueheart"
"True Rheba Brethauer"
"True Riva Virrueta"
"True Rob Ruberto"
"True Sad Stauder"
"True Sal Saulter"
"True Salena Arseneault"
"True Sean Saeteurn"
"True Shon Southern"
"True Ted Durette"
"True Wilt Tutwiler"
"Twangy Wygant"
"Tyra 'Dish' Hardisty"
"Underdog Geno Rudd" []
"Unsocial Icon Saul"
"Using-Gin Su"
"Versatile [if player is male]Travis Lee[else]Val Steier[end if]"
"Virtuoso Su Rovito"
"Vulnerable [if player is male]Ruben Valle[else]Eva Brunell[end if]" []
"Wan Lady Wayland"
"Wan Max Waxman"
"Warble-Bawler Reb Law"
"Way-Lost Twyla So"
"Weakling Wink Gale"
"Weathered [if player is male]Reed Wheat[else]Thea Wrede[end if]"
"Welcomer Clem Rowe"
"Weldon 'Yum' Muldowney"
"Wert 'Dish' Dewhirst"
"Wistful Lu Swift"
"Worn Alec Lowrance" []
"Worn Bell Brownell"
"Worn Ben Newborn"
"Worn Ed Rowden-Downer" []
"Worn Gage Waggoner"
"Worn Hal Lawhorn"
"Worn Heath Hawthorne"
"Worn Kaci Nawrocki" []
"Worn Kam Workman"
"Worn Kelsi Wilkerson" []
"Worn Nilsa Rawlinson"
"Worn Sid Windsor"
"Worn Theo Howerton"
"Worn Tisha Ainsworth" []
"Yael 'Chum' Mulcahey"
"Yodeler Rey Odle"
"Yodeling Lyn Diego"
"Yon Old Noodly Don Loy"
"Yowler Rowley" []

this-book is a number that varies. this-book is usually 0.

table of random books [xxm04] [tob]
blurb	prio
"[a-b], Russ: ABUSERS[r], by Bess Rau"	0
"[a-word-u] Zit Zen: Snazziest[r], by Issa Zentz"
"[d-t] Shed the Odds[r], by Ted Dosh"
"[d-t], Snub Not Buds[r], by Stu Bond"
"[d-word-u], Girl, Grim Land[r], by [if player is male]Dr. Gilman[else]Marg Lind[end if]"
"[d-word-u] Riots: Ron Admits It's Random[r], by [if player is male]Simon Dart[else]Dion Smart[end if]"
"[if censor-minor is true]Turds, Turds, TURDS[else]Rudd's Trust[end if][r], by Dr. Stu Durst"
"[if player is male]He Eats[else]She Ate[end if] the Sea[r], by Teesha Athees" []
"[if player is male]He Resents[else]She Enters[end if] Thereness[r], by Tess Neher"
"[mle], a Lame Male[r], by Elma Elam" [x]
"[tt] Favre, Favorite to Vie Far[r], by Iva Forte"
"A-Listed: Details[r], by Adelaide Stilts"
"A'Ight, Git? Ha[r], by Gita Haight"
"A'Rite, I Tear a Tire[r], by Artie Etria" []
"Abbey Cho's Sobby Ache[r], by [if player is male]Cobey Bash[else]Sheya Cobb[end if]"
"Abbie's Babies[r], by Seb Iba"
"ABC is Basic![r] by Cassi Babic" []
"ABCDEFGHI Chafed Big[r], by Fidge Bach"
"Abe's God Goes Bad[r], by Deb Sago"
"Abhorrent, Earth-Born[r], by [if player is male]Robert Han[else]Berna Roth[end if]"
"Abide Inert, Inebriated[r], by Benita Reid" []
"Able Arty Betrayal[r], by [if player is male]Bart Ealy[else]Tara Blye[end if]" []
"Ablest Creep, Respectable[r], by Caleb Peters"
"Ably, Alby[r], by Baby Lyla"
"About KC: a Buck to Back Out[r], by Cat Kubo"
"The Abyss Hastes By[r], by Shay Best" []
"Academy Day Came[r], by Mac Eady"
"Ace Frost Forecast[r], by Scot Rafe"
"Ace Gods So Caged[r], by Ced Gosa"
"Ace Rest Creates a Secret[r], by Cat Rees"
"Ace Yard Race Day[r], by Cary Ade"
"Ace's Case[r], by CeCe & Sasa"
"Ach, Get on to Change[r], by Chet Goan"
"Ach, Sir: Chairs I Crash[r], by Charis Sarich-Raisch"
"Ache, Sorer Racehorse[r] by Rose Reach"
"Achy Lull[r], by [if player is male]Clay Hull[else]Lucy Hall[end if]"
"Achy Odes: Days Echo[r], by Doc Hayes"
"Acidly, Icy Lad[r], by Di Clay"
"AcidSoft Factoids[r], by Tad Scifo" []
"Acre-Fog of Grace[r], by Garf Coe" []
"Acronyms? Mas Corny![r] by Ros McNay"
"Act, Feed a Defect[r], by Ted Face"
"Act Tipsily: Plasticity, Sip Tacitly[r], by Sly Pacitti"
"Acting Naif's Fascinating[r], by Cats Finigan"
"Actless Castles[r], by Sal Stec"
"Acton's Cantos to Scan[r], by Costas Canton" []
"Actually Lay a Cult[r], by Lucy Lata"
"Acuity Calls Caustically[r], by Stacy Ciulla"
"Ad-Men Rig Dreaming[r], by Reid Mang"
"The Ad or Her Toad[r], by Ed Troha" []
"Adam, He's Ashamed[r], by [if player is male]Ed Hamsa[else]Mae Shad[end if]" []
"Add Iron, Android[r], by Ida Dorn" []
"Add Love, Old Dave[r], by Lev Doda"
"Add Neon and Done[r], by Don Dean"
"Adding Up a Pudding[r], by Ping Duda"
"Adieu, Rude Air[r], by Audrie Rideau"
"Adios, North on This Road[r], by [if player is male]Ash Rotondi[else]Rhonda Otis[end if]"
"Adjacent Cadet Jan[r], by Jed Canta"
"Ado By a Body[r], by Bo Day" []
"Adolf, Lad of Fad, Lo![r] by Ada Dolloff" []
"Adonis Said No[r], by Sonia Addison"
"Adorbs Sad Bro[r], by Bossard Bardo" []
"Adores: DeRosa Soared[r], by Sara Roos-Dede" []
"Adroit Clean Declaration: Radical Note[r], by [if player is male]Tad Naclerio[else]Tracie Dolan[end if]" []
"African Francia[r], by Cara Fin"
"Afterlife Felt Afire[r], by Effie Tarl"
"Age, Sprout Great Opus: Pages Tour[r], by [if player is male]Gus Tropea[else]Rose Gupta[end if]" []
"Aged Crib, Bird Cage[r], by Deb Craig"
"Ageism Images[r], by Maggie Massie"
"Ageless Sage Les[r], by Lee Gass" []
"Ages and Agendas[r], by Dan Gase-Sandage"
"Agony, Sin: Saying No[r], by Sina Yong"
"Ah, And Try a Hydrant[r], by Nat Hardy"
"Ah, Battlers: Blathers at Last Breath[r], by [if player is male]Ash Talbert[else]Shelba Tart[end if]" []
"Ah, Blest the Slab[r], by Hal Best"
"Ah, Claim Malachi[r], by Hal Maci"
"Ah, Crazy Zachary[r], by Chaz Ray"
"Ah, Cry, Chary Archy[r], by Harry Chyca"
"Ah, Debtor, Both Read the Board[r], by Ed Hobart" []
"Ah, Doter O['] Hatred[r], by Rod Athe" []
"Ah, Her Paper[r], by Pepe Harrah" []
"Ah, Old Men Hold Mean Homeland[r], by Del Homan & Mel Honda"
"Ah, Poor Harp[r], by Orpha Pharo"
"Ah, Serf, Afresh[r], by Shafer Sharef" []
"Ah, Share a Rehash, Ehh, Sara[r], by Rhea Ash"
"Ah, Sot: Oaths to Ash[r], by Tasha Hoots" []
"Ah, Swell, We Shall[r], by Wes Hall"
"Ah, to Pry a Trophy: Oh, Party![r] by Phat Roy" []
"Ah, Tune Un-Hate[r], by Hue Tan"
"Ah, Weirdo, How I Dare[r], by Rhoda Wei"
"Ah, WOW is How I Was[r], by Wai Show"
"Ah, Yay, Ssh[r], by Shay Hays" []
"Aha! Sunk, Kahunas[r], by Asa Kuhn"
"Ahead Long? Aha, Golden[r], by Leda Hogan"
"Ahh, Denier in Her Head[r], by Dinah Rhee"
"Ahh, Diets: Hate Dish![r] by Sid Heath"
"Ahh, Tell the Hall[r], by Hal Leth"
"Ahh, Tourist at This Hour[r], by Ruth Oshita"
"Ahh, Twisty That-is-Why[r], by Whitt Hays"
"Ahoy, Sir So Hairy[r], by Rio Hays"
"Aid Sent Instead[r], by Ed Astin"
"Ail, Ail, Ail[r], by Lia Ali"
"Ail Earlier[r], by Ariel Reali"
"Ail, Wary Railway[r], by Alia Wry"
"Aim, Toss Maoists[r], by Tim Sosa"
"Aimless Plot, Lamest Spoil[r], by Salome Spilt"
"Air-Lust Rituals Trail Us[r], by Lurista St. Lauri"
"Air Mass, Mrs. Asia[r], by Marissa Samaris-Massari"
"Air Plenty Interplay[r], by [if player is male]Nat Ripley[else]Trina Pyle[end if]"
"Air Promise, Impresario[r], by [if player is male]Mario Piers[else]Marie Spiro[end if]"
"Airy Tar: a Rarity, Array It[r], by Rita Ray"
"Aisles['] Liases, Lassie[r], by Elissa Alessi"
"Al Capone: a Clean Op, No Palace[r], by [if player is male]Neal Copa[else]Lona Pace[end if]"
"Al Has a Lash[r], by Shala Halas"
"Al, OK to Look At[r], by Ola Kot" []
"Al Rose: a Loser So Real[r], by Sal Ore"
"Al Sings Signals in Glass Sans Gil[r], by Sis Lang" []
"Al Wove a Vowel[r], by Eva Low"
"Al's Bucolic Social Club[r], by Luci Blasco"
"Al's Grunt-Slang Rut[r], by Lu Strang"
"Alarmed? Go, Ogle Drama[r], by [if player is male]Leo Dagmar[else]Margo Dale[end if]"
"Alarmists['] Mass Trial[r], by Lara Smits"
"Alas, Empty Lame Pasty Playmates[r], by Alma Stype"
"Alas I'm As Mail[r], by Sam Ali"
"Alas, Lovin['] So Vanilla[r], by Alvi Sloan"
"Album Is Malibu's[r], by Sia Blum" []
"Alchemist, Lacesmith[r], by Milt Chase"
"Aldo Wu's Wouldas[r], by Saul Dow"
"Ale, Latte: Let a Late Tale[r], by Ella Tate" []
"Alert Us: a Result-Lust Era[r], by Lea Rust"
"Alerting to Retotaling Tolerating[r], by [if player is male]Al Ottinger[else]Regina Lott[end if]"
"Aleuts Salute Alt-Use[r], by Sue Tal" []
"Alfie's Life as Falsie[r], by Isaias Leffel"
"Alfredo, Deal For Dr. LaFoe[r], by [if player is male]Ed Flora[else]Flo Ader, Lea Dorf & Fae Lord[end if]" []
"Alfredo's Old Fears[r], by Flor Sade"
"Ali's Ex Alexis[r], by Eli Sax & Sal Xie"
"Alien Flier in Real Life[r], by Lilian Free"
"Alien Middleman Annelid Dilemma[r], by Melinda Idleman" []
"Alienator Rationale[r], by Tari O'Neal"
"Alight Me, Megalith[r], by [if player is male]Tim Hagel[else]Gita Helm[end if]"
"Alight, My Almighty[r], by Ty Gilham"
"All-Bums Slum Lab[r], by Sal Blum"
"All-Days-Sad Lyla[r], by [if player is male]Sal Daly[else]Alda Sly[end if]"
"All-Gone Galleon[r], by Leo Lang" []
"All Gutsy Tall Guys[r], by Sly Gault"
"All-Joy Lyla Jo[r], by Jay Oll"
"All Ma's Llamas[r], by Sal Lam"
"All Right Li'l Garth[r], by Trig Hall"
"All Sew as Well[r], by Les Law"
"All Sew as Well[r], by Sal Lew"
"All Them: The Mall[r], by Mel Halt"
"All This: It Shall[r], by Sal Hilt"
"All Time Low: a Mellow Lit[r], by [if player is male]Milo Atwell[else]Wilma Tolle[end if]"
"All Twins Want Ills[r], by [if player is male]Will Nast[else]Lin Walst[end if]"
"All Types Ply Tales[r], by Sly Patel"
"All Vain? Vanilla[r], by Al Lavin"
"Allegorist Legislator Tiger Laslo[r], by [if player is male]Otis Grella[else]Lita LeGros[end if]"
"Allowing Law Lingo[r], by Will Noga"
"Alma Maters Alarm Teams[r], by Martel Maas"
"Almighty? Myth: I Lag[r], by Mathy Gil" []
"The Alms Hamlets[r], by Mel Tash"
"Along the Hot Angle[r], by Theo Lang"
"Alp Nation Planation[r], by [if player is male]Nolan Pait[else]Tana Polin[end if]"
"Also Giant Nostalgia Lost Again[r], by Sonia Galt" []
"Also No Saloon[r], by Sal Ono" []
"Also Try Taylor's[r], by [if player is male]Sal Troy[else]Rosy Alt[end if]"
"Alternative Tea Interval[r], by [if player is male]Arnette Vail[else]LaVerne Tait[end if]"
"Altruism Must Rail[r], by [if player is male]Lui Smart[else]Lura Smit[end if]"
"Altruist, Ultraist[r], by Stuart Li"
"Always, Aw, a Sly Law, Say[r], by Sal Way" []
"Am Whole? How Lame, Ahem, Low[r], by Elmo Haw"
"Amateurs, Amuse Art[r], by Sue Marat"
"Amble, Blame[r], by Mabel Lemba"
"Amen, Sing Meanings[r], by Genni-Sam Mangines"
"Amen, Tidy Dynamite[r], by Tim Dayne"
"Amend Verily, Deliveryman? Never, Milady[r], by [if player is male]Devin Marley[else]Melvina Dyer[end if]"
"American Man: I Care[r], by Ren Amaci"
"Americans Are Manics[r], by Carin Ames"
"Amnesia: Am I Sane[r], by [if player is male]Asa Mein[else]Nia Ames[end if]"
"Amphetamines: Mean Shipmate[r], by Emma Stephani & Pam Mathiesen"
"Ample Test Templates[r], by [if player is male]Matt Sleep[else]Pam Settle[end if]"
"Amplify My Pilaf[r], by Flip May"
"Anaglyptic Playacting[r], by Patil Cygan"
"Ancestors, Cross a Net, Note Scars[r], by Ross Tance"
"Ancestries['] Resistance[r], by [if player is male]Cesar Stein[else]Tressa Ince[end if]" []
"And Bring Branding[r], by Brad Ginn"
"And Dire Dreadin['][r], by [if player is male]Ned Radi[else]Nia Redd[end if]"
"And Do an Odd Add-on[r], by Donda Dando"
"And Fighters Fret and Sigh[r], by Fred Hasting"
"And Flag, Glad Fan[r], by Fang Lad Gandalf" []
"And Flop, Fond Pal[r], by Alf Pond"
"And Flow, Wan Fold[r], by [if player is male]Dan Wolf[else]Flo Dawn[end if]"
"And Fresh Fan Herds[r], by Fred Nash"
"And Gore Raged On Near God[r], by Rod Egan"
"And Hence, Enhanced![r] by Dean Chen"
"And His Dashin['] Had Sin[r], by Shandi Danish" []
"And I Help Delphina[r], by [if player is male]Phil Dean & Ned Phail[else]Daphne Li[end if]"
"And Lee Leaned, Leaden[r], by Ed Lane"
"And Lo, No Lad[r], by Nola Donald" []
"And Lost Lands to Sandlot[r], by Old Stan" []
"And Moan, Madonna[r], by Mo Anand"
"And My, Mandy[r], by Maddy Nyman"
"And Nice in Dance Can Dine[r], by Nic Dean"
"And No Wait Into a Dawn[r], by Ada Winton"
"And Now No Wand[r], by Ann Dow"
"And Ode Dead On[r], by Ed Doan"
"And Revel NEVER, Lad[r], by VernDale Vreeland"
"And Roost, Tornados[r], by Rod Aston"
"And Row Onward[r], by Rann Woodward" []
"And See a Dense Sea-Den[r], by DeSean Esande"
"And Show Wan D'ohs, Don Shaw[r], by Shwonda Ashdown"
"And So, No Ads[r], by Saddo Anson Donas"
"And So On, Sad[r], by Sana Dodson" []
"And Sure Asunder[r], by Sue Rand" []
"And the Ten Had Hat Den[r], by Ted Han"
"And to Nod at a Don't[r], by [if player is male]Donta[else]Tonda[end if] Donat"
"And Toys Don't Say Stand, Yo[r], by Tad Sony" []
"And We Wend: a New Ad Waned[r], by [if player is male]Ewan Wadden[else]Wende Dwana[end if]"
"And Yes, in Nine Days[r], by Sandi Ney"
"Andre Nader, A Nerd[r], by Daren Raden" []
"Androids So Drain'd[r], by Sid Doran"
"Anger-Haus Harangues[r], by Rush Eagan"
"Anger I Regain[r], by Regina Aigner"
"Angola's Analogs[r], by Asa Long"
"Angry at a Gantry[r], by Nat Gray"
"Angry at a Nag Try[r], by Gary Tan"
"Angry at a Nag-Try[r], by Nat Gray"
"Angry at Gay Rant[r], by Gary Tan"
"Angry Mime Yammering[r], by Emmy Garin"
"Angst Eats, Stagnates[r], by Stan Gates"
"Ankh, Fist, Fish Tank[r], by Nath Fisk"
"Anna Sees Sane Sean[r], by Asa Senne"
"Anneal, Lessee[r], by [if player is male]LeSean[else]Selena[end if] Lanese-Anslee"
"Annoying Agony Inn[r], by Nino Nagy" []
"Anoint No Anti-Nation[r], by Antoni Tanino"
"Anon Has Hosanna[r], by A. Hanson"
"Anon Toasts: Not Sonatas[r], by Santo Aston"
"Anonym Yon, Man: Many? NO[r], by Ann Moy"
"Another Do on the Road[r], by [if player is male]Theo Ardon[else]Eda Horton[end if]"
"Another Near-Hot Tan Hero[r], by Art Hoen" []
"Ant Farm, Frat Man?[r] by Mart Fan"
"Ante Oddly: Not Deadly[r], by Toddy Lane"
"Anti-Cruel, Ultra-Nice Alien Curt[r], by Lucie Tran"
"Anti Drugs Rants I Dug[r], by Darin Gust"
"Anti-Erotic Recitation[r], by Torian Tice"
"Anti-Facts? Fantastic![r], by Staci F. Tan"
"Anti-Muon Mountain[r], by Nina Muto"
"Anti-Rancor Contrarian[r], by [if player is male]Antoni Carr[else]Tara Rincon[end if]"
"Anti-SOB Bastion, Ban Otis[r], by Ian Bost & Bo Tanis"
"Antioch to China[r], by [if player is male]Nat Choi[else]Nita Cho[end if]"
"Anton, Future Unfortunate[r], by Enton Furuta" []
"Ants Die Instead[r], by [if player is male]Sid Neat[else]Dani Tse[end if]" []
"Antsy Hop: a Python's Nosy Path[r], by Pat Hyson"
"Any Darn Yarn and Ayn Rand[r], by Dan Ryan"
"Any Dot And Toy to Andy[r], by Dontay Dayton"
"Any Drab Bad Yarn[r], by Rand Bay"
"Any Fresh Hay-Ferns[r], by Shane Fry"
"Any Glow? Long Way[r], by Aly Wong" []
"Any Goal Analogy[r], by Aya Long"
"Any Nit is Insanity[r], by Nini Tsay" []
"Any Pen a Penny[r], by Nan Pye"
"Any Pick Panicky[r], by Nick Yap"
"Any Plight, Plaything? Ply a Night[r], by Hilty Pang"
"Any Rad Day Ran[r], by Andray-Daryan Darnay"
"Any Seem Mean, Yes[r], by Ames Ney"
"Any Temp Payment Type, Man[r], by [n-t] Pym" []
"Apes['] Apse[r], by Essa Pape"
"Apex Roads Paradoxes[r], by [if player is male]Rex Posada[else]Rox Espada[end if]"
"Aphrodite Atrophied[r], by [if player is male]Theo Pradi[else]Ardith Poe[end if]"
"Apollo's Solo Pal[r], by Al Sloop"
"Apple, Out-Populate[r], by [if player is male]Pat Puleo[else]Tula Pope[end if]"
"Apropos, Poor Sap[r], by Pa Spoor"
"Apt, Brute: Batter Up[r], by Bert Tupa"
"Apter Gripe, Paper Tiger[r], by Greta Piper"
"Arc-Bass Scarabs[r], by Rab Cass"
"Arc I Curl, Circular[r], by [if player is male]Arric Luc[else]Luci Carr[end if]"
"Arcane Commoner Romance[r], by Ace Norm Cameron" []
"Arch Woes, Raw Echos: Who Cares[r], by [if player is male]Chas Rowe[else]Shea Crow[end if]"
"Archivee Achiever[r], by Vera Eich"
"The Arctic Architect: Her Tactic[r], by Chet Traci" []
"Ardor Roar'd[r], by Dorra Arrod"
"Are Most to Smear[r], by Rose Tam"
"Are Tots to Stare[r], by [if player is male]Ares Ott[else]Ros Tate[end if]"
"The Area: a Reheat[r], by Tea Rahe"
"Arid Pool Polaroid[r], by Opal Dior"
"Arid Port Road Trip[r], by Tad Prior"
"Ariel's Serial Ailers[r], by Al Reis" []
"Arise, Raise a Sire![r] by Siara Riese" []
"Aristotle's Totalisers[r], by [if player is male]Otis Slater[else]Tess Rialto[end if]"
"Arlo's Solar Orals[r], by Ross Allaro"
"Armories['] Semi-Roar[r], by [if player is male]Omar Reis[else]Rosa Meir[end if]" []
"Armoring Rigor Man[r], by [if player is male]Gino Marr[else]Roni Gram[end if]"
"Arms on Ransom[r], by Ms. Rona Rosman" []
"Arnie's Sin Era[r], by Serina Raines" []
"Arrange No Ego, O Anger[r], by Genaro O'Regan-Garone"
"Arrogant Tarragon[r], by Art Garno"
"The Arrow, a Thrower: Hot, Rawer[r], by Hart Rowe"
"The Arrow Heart Row[r], by Thor Ware" []
"Arsenic's Raciness[r], by [if player is male]Eric Sans[else]Erin Cass[end if]"
"Art, Baby, by a Brat[r], by Bart Bay"
"Art, Cantos: a Contrast[r], by Rana Scott"
"Art Fits at First[r], by Sir Taft"
"Art, Hill: a Thrill[r], by Lil Rath"
"Art I Love To Elvira[r], by [if player is male]Avi Toler[else]Lita Vore[end if]" []
"Art Now to Warn[r], by Warran Wotton"
"Art Set at Rest[r], by Teressa Tratt" []
"Art, Sun, Runs at Saturn[r], by Su Tran"
"Artemis, a Smiter[r], by Tim Ares"
"Arthroscope Crapshooter[r], by [if player is male]Oscar Thorpe[else]Tora Porsche[end if]"
"Artisan Sinatra[r], by [if player is male]Ira Nast[else]Nia Star[end if]"
"Artsman Mantras[r], by Nat Mars"
"Artsy-Eyed Yesterday[r], by Syed Tyrea"
"Arty Nat, a Tyrant[r], by Ray Tant"
"As Burnt Bats Run[r], by [if player is male]Bart Sun[else]Su Brant[end if]"
"As Burnt Bats Run[r], by Stu Barn"
"As for Afros So Far[r], by Sara Rosoff"
"As I Beg, Big Sea[r], by Ab Gies"
"As I Grew Earwigs[r], by Wes Riga"
"As If, As If[r], by Asia Siff"
"As Pundit I Stand Up[r], by Pati Sund" []
"As Soil Ails So[r], by Isa Sol"
"As the Heats Haste[r], by Hesta Athes & Tessa Heath" []
"As Tho['] a Shot[r], by Tosha Athos" []
"As Unto a Snout[r], by Taunton Sousa"
"As Vince Caves In[r], by Vic Enas"
"Ash Pine in Heaps[r], by Sean Phi"
"Ash Tree: Here Sat Theresa[r], by Seth Rea" []
"The Ashen Heathens[r], by Seth E. Han"
"Ask Chet: a Sketch[r], by Kat Esch & KT Chase"
"Ask It, Yo, It's Okay[r], by Ty Osaki"
"Ask Them: I Make This[r], by [if player is male]Sam Keith[else]Kim Haste[end if]"
"Ask Them, the Mask[r], by [if player is male]Kam Tesh[else]Kat Mesh[end if]"
"Ask Theo to Shake the Oaks[r], by Kat Shoe"
"Ask Yon Yak, Son[r], by Sy Kano"
"Asking Her: a Gherkin's Shrinkage[r], by Kris Hagen"
"An Asleep Seaplane[r], by Sean Apel"
"Astatine, in a State[r], by [if player is male]Sean Tait[else]Nita East[end if]"
"Asterisk[r], by [if player is male]Art Sikes[else]Kris East[end if]"
"Asteroids So Satired[r], by Sid Setora"
"Astral Altars[r], by Starla St. Lara"
"Asylum of Foul Yams, Famously So Fumy, Al[r], by Ulf S. Mayo"
"Asynergia Gainsayer[r], by [if player is male]Gary Anise[else]Inga Rasey[end if]"
"At [']Em, Team-Mate[r], by Emma Tate" []
"At a Blue Tableau[r], by Beau Alt"
"At a Creek, Take Care[r], by Kate Cera"
"At a Rum Trauma[r], by Mat Rau"
"At a Sudsy Duty[r], by Stu Day"
"At Bison Bastion[r], by Boston Sabatini" []
"At Her Art, Eh[r], by Hera Threat"
"At Lowly Lyla Two[r], by Walt Loy"
"At No Addition[r], by Donita Donati"
"At Rest, Taster[r], by Teressa Tartt"
"At Roles So Alert[r], by Les Tora"
"At Snide Ties and in Dates[r], by Tad Enis-DeSanti"
"At the Theta[r], by Hetta H. Tate"
"At Voices So Active[r], by [if player is male]Vito Case[else]Eva Tosci[end if]"
"At-Worst Tot Wars Start, Ow[r], by Ros Watt"
"Atlantis Ain't Last[r], by Lita Nast"
"Atlas of Alas, Oft So Fatal[r], by Flo Asta"
"Atom Bombs, a Mob's Tomb[r], by Bobo Stamm"
"The Atoms Most Hate[r], by Shea Mott"
"Atoners, Senator Orantes[r], by Stan Roe" []
"Atticus, Tacitus[r], by Staci Tu"
"Auctions['] Cautions[r], by Nia Couts"
"Aunt Midge's Magnitudes Gained Smut[r], by Tami Sugden"
"Authoress Rathouses[r], by [if player is male]Hosea Rust[else]Rosa Shute[end if]"
"Avalons So Naval[r], by [if player is male]Sal Avon[else]Lana Vos[end if]"
"Avast, Earth: the Avatars Have Strata[r], by Tarah Vesta"
"Avenir Ravine[r], by Verena Virani & Vernie Varian" []
"Avoid Men, Oven Maid[r], by Mia Devon"
"Avon is So Vain[r], by [if player is male]Ian Vos[else]Vi Naso[end if]"
"Avowers Oversaw[r], by Wes Ravo"
"Aw, All Shy Hallways[r], by Lyla Wash"
"Aw, Dish I'd Wash[r], by [if player is male]Sid Hwa[else]Di Shaw[end if]"
"Aw, Flo: Law of a Wolf[r], by Alf Faw-Wool"
"Aw, Lob a Blow[r], by Bo Law"
"Aw, Nerd, Ew--Darn[r], by Andrew Ardwen" []
"Aw, Purely Lawyer Up[r], by [if player is male]Paul Wyre[else]Lupe Wray[end if]"
"Aw, Urged, We Guard[r], by Gerda Wu"
"Awareness Earns Awes[r], by Wes Arenas"
"Awe-Smit, It Was Me[r], by Mia West"
"Awesome Mesa Woe[r], by Wee Amos"
"Awesomely Measly Woe[r], by [if player is male]Wesley Mao[else]Salome Yew[end if]"
"Aww, Rain, Win a War[r], by Wai Nawr"
"Axe Sully Sexually[r], by Elsy Laux"
"Axioms: So, a Mix[r], by Amos Xi"
"Ay, Foul? I Fail You[r], by Fay Iulo"
"Ay, Funds: Fun Days[r], by Sandy Fu"
"Ay, Rebel Belayer[r], by Lee Bray"
"Ay, Sir Ray Is[r], by Sriya Irsay" []
"Ay, Slam My Alas[r], by Sal May"
"Ay, Tots, To Stay Toasty[r], by Ty Sato"
"Ay, Warn Us, Runaways[r], by Ruy Aswan"
"Aye, I Trust Austerity[r], by [if player is male]Titus Raye[else]Sari Yuett[end if]"
"Aye, Net a Teeny Tan Eye[r], by Nat Yee"
"Aye, Sinner: Ye Insaner Nine Years[r], by Serina Ney & Nina Reyes"
"B-Movies: Mobs Vie[r], by Mo Bevis"
"Back Under Crude-Bank Cad Bunker[r], by Buck Arden"
"Bad Grades[r], by Brad Degas"
"Bad Men or [d-word-u] Bore[r], by Don Amber"
"Bad Moon Mood Ban[r], by [if player is male]Dan Boom & Bo Damon[else]Oma Bond[end if]" []
"Bad, Rote, Aborted[r], by Art Bode, Tad Boer & [d-t] Bare"
"Bad Vibes: Diva's Ebb[r], by Babs Devi"
"A Baffle, Affable[r], by Fae Falb"
"Bah, Rent the Barn[r], by Ben Hart"
"Bah, Rosy Rash Boy[r], by Ash Roby" []
"Bah, Son! Bash On! Ah, Snob[r], by Bo Nash"
"Bail Came, Amicable[r], by Mica Abel"
"Bail Won, I Bawl On[r], by Lina Bow"
"Bait a Bit[r], by Abbi Tait" []
"Bait Luck's Black Suit[r], by Basil Tuck"
"Bait Me, I'm Beat[r], by Bambie Mattie"
"Bait Your Obituary[r], by Ryu Tobia"
"Baiter of To Be Fair[r], by Fae Brito"
"Balcony-Boy Clan[r], by Clay Bon"
"Ballyard Balladry[r], by Lyra Bald"
"Balmier, I Ramble[r], by Amber Li"
"Bamboo's a Bomb, So[r], by Bob Amos"
"Ban a New Wannabe[r], by Anna Web"
"Ban Ego? No, Gabe[r], by Bo Egan"
"BAN MILK[r], by Bilk-Man Lambkin Milbank"
"Ban No Elm, Nobleman[r], by Ben Lamon"
"Ban Sin or Brains? NO[r], by Ann Boris"
"Banbury: Any Burb[r], by [if player is male]Bub Ryan[else]Barb Yun[end if]"
"Bane or a Boner Near Bo[r], by Eb Roan"
"A Baneful Moth, Unfathomable[r], by Afton Ambuehl"
"Bar Me a Berm[r], by Mr. Abe Embar"
"The Bard Bret Had Breadth[r], by Rad Beth DeBarth"
"The Bard of Far Hotbed[r], by Beth Foard"
"The Bard's Breadths[r], by Bert Dash"
"Barefoot Oaf Berto: Boor Fate[r], by Bao Forte" []
"Barmy Mr. Bay[r], by Byram Mabry"
"Barnet's Banters[r], by Stan Erb" []
"Baroquest Squat Bore[r], by Art Bosque"
"Barren Bane, Bare Banner[r], by Abner Berna"
"Barrenest Banterers[r], by [if player is male]Bret Serna[else]Reba Ernst[end if]"
"Basal Balsa[r], by Sal Ba"
"Basalt: a Blast at Labs[r], by Sal Abt"
"Basic Lone Balconies[r], by [if player is male]Les Bocian[else]Ilse Bacon[end if]"
"The Basic Tech Bias: Cite, Bash[r], by [a-b] Tisch" []
"Bat Null, Nutball![r] by Blunt Al"
"Baths O['] Bathos[r], by Bo Tash"
"Batless Labs-Set Stables[r], by Bess Alt"
"Bauer's Abuser, Bear Us[r], by Su Baer" []
"Bauerle's Reusable Blues Era[r], by [if player is male]Saul Bree[else]Lea Suber[end if]"
"Baum, a Bum[r], by Babu Muma"
"Bayern Nearby[r], by [if player is male]Barnaby Neyer[else]Bryanna Beyer[end if]"
"Bayonets be a Stony Bane's Toy[r], by Toby Sean"
"Be Afraid: a Bad Fire[r], by Deb Faria"
"Be Apart: Bar a Pet[r], by Pat Baer"
"Be Cool, Ole Cob[r], by Bo Cole"
"Be Cut on But Once[r], by Ben Cuto"
"Be Drony, Nerd Boy Ed Byron[r], by Rey Bond"
"Be Dry, Dr. Bey-Derby[r], by Debby Ryder" []
"Be Fair: a Brief Fib Era[r], by Fae Rib"
"Be-Far Faber[r], by [if player is male]Raffa Beber[else]Barbee Raff[end if]"
"Be, Kook, Be[r], by Bob Okeke"
"Be Loved, Bold Eve[r], by [if player is male]Del Bevo[else]Bev Odle[end if]"
"Be Merry, Mr. Beyer[r], by Bry Meer"
"Be Moany Mean Boy[r], by [if player is male]Ben Mayo[else]May Bone[end if]"
"Be Proud, Prude Bo[r], by Bud Poer"
"Be Sat! St. [a-b] Abets Betas[r], by Abbess Etta"
"Be Trim, Timber[r], by Betti Brimmer"
"Beach [']N a Bench[r], by Bec Han"
"Beady Hot Body Heat[r], by Beth O'Day"
"Beam, Babe Emma[r], by Amee Mabb"
"Beam Dry, My Bread[r], by Em Brady"
"Beaming Game Bin[r], by Gabe Min"
"Bear Day, Bad Year[r], by Ada Brey"
"Bear no Bane or One Bar[r], by Robena Barone" []
"Bear to Eat, Bro[r], by [if player is male]Roberto Abate[else]Barbee Totaro[end if]"
"Bearcat Cabaret[r], by Ace Brat Art Cabe"
"Beardy Dry [a-b][r], by Deb Ray" []
"Bearing a Binger[r], by Ian Berg & Gabe Nir"
"The Bears Eat Herbs[r], by Hera Best"
"Beastly Labs, Yet[r], by Aly Best" []
"Beasts or Boasters[r], by Bert Sosa"
"Beat, Bold Bob Dealt to Dabble[r], by [a-b] Boldt"
"Beat Poetry by a Treetop[r], by [if player is male]Rob Payette[else]Petra Tobey[end if]"
"Beating a Big Net[r], by Gia Bent" []
"Beating Up a Bug, Inept[r], by Paige Bunt"
"Bechdel Belched[r], by Ced Hleb"
"Bedlam Ambled[r], by Bad Mel Dembla"
"Bedlam: Bad Lem Blamed Bald Em[r], by Ed Lamb" []
"Bedrock Doc Berk[r], by Rod Beck"
"Bedtime: I'd be Met[r], by Tim Bede"
"Been-Dark Reedbank[r], by Ned Baker"
"Beer Cans Scare Ben[r], by Bren Case"
"BeerInc: Be Rec'in![r], by Ben Rice & Nic Eber" [p]
"Bees, Grit, Big Trees[r], by Geri Best"
"Beg Hard, Gebhard[r], by Gab Herd"
"Beg with a White Bag[r], by Gib Wheat"
"Behaviors['] Bias, Hover[r], by [if player is male]Ravi Shobe[else]Sheri Bova[end if]"
"Beheld, He Bled[r], by Ed Hleb"
"Bein['] Less Sensible[r], by Ben Siles"
"Bein['] Sly: Bylines[r], by Lyn Seib-Lisenby"
"Being Led, Bleeding[r], by [if player is male]Ben Lidge[else]Deb Ingle[end if]"
"Being Right: Hint Bigger[r], by Inge Bright & Britni Hegg"
"A Belief's Feasible, Base Life[r], by Basil Fee"
"Belmont Blotmen[r], by Len Tomb"
"Below One: Noble Woe[r], by Leo Bowen"
"Belser Rebels[r], by Les Erb"
"Belt, Lush: He'll Bust[r], by Les Bluth" []
"Bely So, Ye Slob[r], by Les-Boy Bosley-Boyles" []
"Bemused Seed-Bum[r], by Bud Mees" []
"Ben, a Bean[r], by Anne Abbe"
"Ben Sat Absent[r], by Beans Basnett & Bennett Sabas"
"Bend, Stray Bystander[r], by Bret Sandy & Andy Brest"
"Benevolent Noble Event[r], by Neve Belton"
"Benoit's Boniest Bio-Nest[r], by Bo Stein"
"Bent Hay[r], by Bethany Neathby" []
"Beriberi Bier[r], by Bri Beier"	60
"Bermuda: a Dumber Mad Rube[r], by Red Baum"
"A Bermuda to Dream About[r], by [if player is male]Mateo Burda[else]Maude Tabor[end if]"
"Bermuda's Dear Bums[r], by Bud Maser"
"Bernoulli: No Ill Rube[r], by [if player is male]Burl O'Neil[else]Elli Bruno[end if]"
"Bertie Be-Rite[r], by Bit Ree"
"Best, Hard: the Bard's Breadths[r], by [if player is male]Bret Dash[else]Deb Stahr[end if]" []
"Besties is Beset[r], by Tess Ibe"
"Bestrew, Webster[r], by Wes Bert"
"Bet, Star Taber St. Batters[r], by Art Best"
"Betamax: I Mix a Beat[r], by Tamie Bax"
"Betray Yet, Rab?[r] by Bettye Ybarra"
"Betty Lou's Subtle Toy[r], by Utley Bost"
"Beyond Done-by, Ye Bond[r], by Don Bey" []
"Bias in an Ibis[r], by Sibina Banisi"
"Bias-Moved Bad Movies: A Mob's Dive[r], by Mavis Bode"
"Bible: Rad? A Dribble[r], by Barb Idle"
"Bid Ken be Kind, Kid Ben[r], by Ed Bink"
"Bid Long, Glib Nod, Go Blind[r], by Gil Bond"
"Big Banks: Baking BS[r], by Babs King"
"Big Cedar Bird Cage[r], by Deb Craig" []
"Big Crank Crab King[r], by Nick Barg"
"Big East, Get Bias[r], by Gia Best"
"Big, Lame, I Gamble[r], by Gabe Lim"
"Big Land Balding[r], by Al D. Bing"
"Big Lies is BILGE[r], by Gil Seib"
"A Big Nerd Barged In[r], by [if player is male]Brad Egin[else]Dina Berg[end if]"
"Big Note to Begin: I Go Bent[r], by Tobie Ng" []
"Big Read: Abridge[r], by Ida Berg"
"Big Red Bridge[r], by Brigid Edberg & Di Berg"
"Big Throne, Both Reign[r], by [if player is male]Bo Enright[else]Beth Gorin[end if]"
"Bigotry's Gory Bits[r], by Rigby Tso"
"Bile Libe[r], by Billi-Bee Lieb" []
"Bile, Wit: I Blew It[r], by Tib Weil"
"Biled, I Bled[r], by Bill Dedbie"
"Bilious, I Boil Us[r], by Lois Bui"
"The Bill: Hell Bit[r], by Bet Hill"
"Bill the Bell-Hit[r], by Li'l Beth" []
"Bill's Hut: Stub Hill[r], by Lis Bluth"
"Bin a Gig, Big Gain[r], by Gia Bing"
"The Bind: Hid Bent Hint Bed[r], by Ted Binh"
"Bind the Thin Bed, Then Bid[r], by Beth Din" []
"The Bird be Third[r], by Di Berth"
"Bird of Forbid-Dif Bro[r], by Bo Frid"
"Bird of Forbid[r], by Bibi Ford-Dorf"
"Birdbrain and Brinda[r], by Brandi Briand"
"The Birds Bred This[r], by [if player is male]Sid Breth[else]Deb Hirst[end if]"
"Birthdays Bit Sy Hard[r], by Tish Darby"
"Births of Both Firs[r], by Robt. Fish"
"A Bit Shy, Thy Bias[r], by Tish Bay"
"Bite, Mr. Be-Trim[r], by Betti Brimmer" []
"Bite, Nag, Neg, Bait[r], by [if player is male]Ben Taig[else]Gia Bent[end if]" []
"Biter Tribe[r], by Berti Tiber"
"The Black Belt Hack Tech-Balk[r], by Kat Belch, Chet Balk & Beth Lack"
"Black Fire, Leaf Brick[r], by Flick Baer"
"Blackmail Claim-Balk[r], by [if player is male]Mack Bilal[else]Alma Blick[end if]"
"The Blades She Tabled[r], by Beth Dales"
"Blamable Me[r], by Mabel Lambe"
"Blame Mabel[r] by Mel LeBamba" []
"Blame to Me: A Blot[r], by Tom Beal & [a-b] Molt" []
"Blamer Mr. Bale[r], by Al Berm"
"Bland Curs['] Scrubland[r], by Luc Brands"
"A Bland DNA Lab[r], by Al Band"
"Bland Ire? Drab Line? A Blinder[r], by Ben Laird"
"A Blander Bare Land[r], by Brad Lane"
"Blando Boland[r], by Al Bond"
"A Blank Balkan[r], by Al Knab"
"Blast Once, Constable Boncastle[r], by Stan Coble" []
"Blather On, Then Labor[r], by Noel Barth"
"Bleach, Lye, Bellyache[r], by Lyle Beach"
"Blearily, Reliably[r], by Bill Raye"
"Bleat at a Battle[r], by Lea Batt"
"Bleat, Mr. Lambert[r], by Tal Brem"
"Bleat Pure, Reputable,[r], by Paul Ebert"
"Blemished Limbs, Heed[r], by Debi Helms"
"A Blend-Den Lab[r], by Ed Blan"
"Blighter Girl Beth Hiltberg[r], by Helg-Brit Gilbreth"
"Blocked Old Beck[r], by Ced Kolb"
"Blog Friend, Blind Gofer[r], by Ford Ebling"
"Blog Loud, Dull Goob[r], by Doug Boll" []
"Blood Bay, Ol['] Bad Boy[r], by Lady Bobo"
"Blood, Water: a World to Be[r], by Bart Elwood"
"Blow One Low Bone[r], by Ben Wool"
"A Blowgun Bungalow[r], by [if player is male]Blu Wogan[else]Ang Bulow[end if]"
"Blue Words, Rude Blows[r], by Bud Rowles"
"Blues at a Subtle Late Bus[r], by [if player is male]Les Buta[else]Lu Bates[end if]"
"A Blur of Our Flab[r], by [if player is male]Rob Lauf[else]Flo Baur[end if]-Balfour" []
"Blush, Gone, Bungholes[r], by Ben Slough"
"Blush Ripe, Publisher![r] by Herb Pulis"
"Bo's Life-Foibles[r], by [if player is male]Leif Bos[else]Flo Seib[end if]"
"Boadicea Bade Ciao[r], by Ada Boice"
"The Board's Drab Ethos[r], by [if player is male]Shad Berto[else]Rhoda Best[end if]"
"Boat or a Robot[r], by Rob Tao"
"Boater to Bear or Beat[r], by Tre Abo & [a-b] Ort" []
"Bob Lew's Wobbles[r], by Sol Webb"
"Bob's Gig: Big Bogs[r], by Og Gibbs"
"The Bogus, Besought[r], by Hugo Best"
"Bogus Dryad Bodyguards[r], by Buddy Goras"
"Boguser Rubes, Go[r], by Sue Borg"
"Bohemia's Home Bias[r], by Moe Shiba"
"Bohemians['] Basin Home: Monies? Bah[r], by [if player is male]Noah Bemis[else]Neoma Bish[end if]"
"Boil Sly Li'l Boys[r], by [if player is male]Billy So[else]Lily Bos[end if]"
"Boing Boing[r], by Gino Gibbon"
"Boist-Obits[r], by Bobi Tissot"
"Bold Euro Blue Door[r], by Lou Brode"
"Bold Greg Goldberg[r], by Blogger D"
"Bold Gun, Old Bung[r], by Bud Long"
"Bold Hate, Bad Hotel[r], by Theobald Bhat-Dole" []
"Bold Heat, Theobald[r], by [if player is male]Thad Loeb[else]Beth Aldo[end if]" []
"Bold Sin So Blind[r], by Lis Bond"
"Bold Web: Lewd Bob Wobbled[r], by Deb Blow" []
"Bolder Bro Del Led Rob[r], by Deb Lor"
"A Bolder Labored Old Bear: Bad Lore[r], by [a-b] Lord" []
"Boldest Slob Ted Lost Deb[r], by Del Bost" []
"A Bombin['] Bambino[r], by Bob Iman"
"The Bone He Bet On[r], by Benet Ho"
"Bones Bit, I Ebb Tons[r], by Bob Stein"
"Bones Hid Behind So[r], by Ben Doshi"
"Bones in Benoni's Benison[r], by Bo Ennis"
"Bonsoir, Orbison[r], by [if player is male]Bo Irons[else]Robin So[end if]"
"Boogers! Goobers![r], by Geo Bors"
"Boone's One SOB[r], by Ben Soo"
"Boorhug Borough[r], by Rob Hugo"
"Boors['] Sty Sob Story[r], by Toby Ross"
"Boost My Boy Most[r], by Tom Osby"
"Booting No Bigot[r], by [tt] Bong"
"Bore Until in Trouble[r], by Eli Bruton & [toti] Bruel"
"Born a Baron[r], by Barbra Noon"
"Bosh Diets: Both Sides[r], by Edith Boss" []
"Boss Eats Asbestos[r], by Tess Sabo"
"Boss Joel Loses Job[r], by Jess Lobo"
"Boss Lady Says Bold[r], by Loyd Bass"
"A Bot-Boat[r], by Toto Baab & Bobo Tata"
"Both, Dear: The Board Hated Rob[r], by [if player is male]Thad Ober[else]Beth Dora[end if]" []
"Both Dye the Body[r], by Deb Hoyt"
"Both Employ Phlebotomy[r], by Ethyl Pombo"
"Both End the Bond[r], by [d-t] Behn"
"Both Merry, My Brother[r], by Thom Berry"
"Both Met the Tomb[r], by Beth Tom"
"Both Slew: the Blows[r], by Stew Holb"
"Both Sunk a South Bank[r], by Tosha Bunk"
"A Bother to Rehab[r], by [a-b] Hort"
"A Bottle to Bleat[r], by [a-b] Lott"
"Bottled Up Debut Plot[r], by Bud Pottle"
"Boundless Soul Bends[r], by Eldon Buss"
"A Bounty, Buoyant[r], by Una Toby"
"Bourbon Run[r], by Bruno Bourn"
"Bowden's Snow Bed[r], by Wes Bond"
"The Bowl Blew Hot[r], by Beth Low"
"Boy, Ban No Baby[r], by Bob Yan"
"Boy, Barf for Baby[r], by Bob Fray"
"Boy Names: No Maybes[r], by [if player is male]Sam Ebony[else]Amy Bones[end if]"
"A Boy Spins By: Passion[r], by Pansy Bois"
"The Boy: Ye Both[r], by Ty Boeh"
"Boyo Dan, a Nobody: Boon Day[r], by Yao Bond"
"Boystown By Now, Sot[r], by Toby Snow"
"Brad Sikes, Bad Kisser[r], by Sadi Krebs"
"Brag Thus, Brash-Gut Bar Thugs[r], by Gus Barth"
"Bragsome Embargos[r], by Amos Berg"
"Brain Barin['][r], by Briana Birn"
"Brain-Sim Mini-Bars[r], by Si Barmin" []
"Brain, Sum Urbanism[r], by Sam Rubin"
"Brainless Near-Bliss[r], by [if player is male]Sal Brines[else]Erin Blass[end if]"
"Brainwaves: I Save Brawn[r], by Vernia Swab"
"Brand Names, Bad Manners[r], by [if player is male]Sam Brendan[else]Debra Manns[end if]"
"Brandy: a Bad Yarn[r], by [if player is male]Rand Bay[else]Ana Byrd[end if]" []
"Brave Boy-Baby, Rove[r], by Bob Avery"
"The Brave Have Bert[r], by Bev Harte" []
"Brave Nun Van Buren[r], by Evan Burn"
"Bravest Star Bev[r], by Rav Best"
"Brawl On, Barn Owl[r], by Al Brown"
"Bray, Bray[r], by Barry Bay"
"Bray Oft, Frat Boy[r], by Fab Troy Bayfort"
"Bray Soft, Frat Boys[r], by Fay Borst"
"Brazen Guile, Gaberlunzie[r], by [if player is male]Bazil Gurnee[else]Zenia Bulger & Eliza Gruben[end if]"
"Break Down, Woken Bard[r], by [if player is male]Andrew Bok[else]Kendra Bow[end if]"
"Breaking King Bear[r], by [if player is male]Ben Kigra[else]Inge Bark & Angi Berk[end if]"
"Brew On, New Bro[r], by Bowen Browner" []
"Brice's Scribe[r], by Cerise Cribbs"
"Brick Safe Backfires[r], by [if player is male]Abe Fricks[else]Beck Faris[end if]"
"Brides['] Debris, Biders['] Rebids[r], by Sid Erb"
"A Bridge, Rage-Bid[r], by Ida Berg" []
"Brief Lost Firebolts[r], by [if player is male]Boris Felt[else]Flo Sibert[end if]"
"A Bright Brag Hit[r], by Garth Raith-Gibb"
"Bring Hot, Big North[r], by Brit Hong"
"Bring Me Mr. Being[r], by Ben Grim"
"Bring Un-Burning[r], by Bri Gunn-Ninburg"
"A Brittle Trite Lab[r], by Brett Ali"
"Bro-Code: Bore, Doc? Be Crood[r], by Ced Boor"
"Bro Didd, Odd Bird[r], by Bri Dodd"
"Bro-Duel Boulder[r], by Old Rube Rod Blue"
"Bro Rob[r], by Bob Orr"
"Bro Time Bit More[r], by Tim Boer"
"A Broker or Baker[r], by [a-b] Rork"
"Bronte's Ten Bros[r], by Ron Best"
"Broody Boy Rod[r], by Boyd Ro" []
"Brooms or Mobs[r], by Mo Bors"
"The Bros Or Beth's[r], by Rob Tesh" []
"Brownest Torn Webs[r], by Bret Snow" []
"Brutal-Rut Lab[r], by Al Burt"
"Bub's Gig: Big Bugs[r], by Gus Gibb"
"Bud, Earn a Burden, Unbared[r], by Branden Budreau"
"Bud for Buford[r], by Bo Ruff-DuBord"
"Bud's Tin Dustbin[r], by Sid Bunt"
"Buddies['] Bids Due[r], by Sid Dube"
"The Bugs Beg Thus[r], by Gus Beth"
"Bugs['] Rent: Grub Nest[r], by Gus Brent"
"Bum Hans, Bushman[r], by BS Human Shubman"
"Bum Rey, My Rube[r], by Mumby Bruyere"
"Bump Each Cheap Bum[r], by [if player is male]Cuba Hemp[else]Pam Buche[end if]"
"The Burbs: Herb Bust[r], by Bret Bush"
"The Burbs['] Bus Berth[r], by Ruth Ebbs"
"Burgeon, One Grub[r], by Bo Unger"
"Burgle, Bugler[r], by Lu Berg"
"Burned Burden[r], by Bub-Ned Rudner"
"Bus Calms, Slum Cabs[r], by Cass Blum"
"Buses Like Blue Skies[r], by Sue Belkis & Bessi Luke"
"Bush-Dad Buddhas[r], by Bud Dash"
"Busted Debuts[r], by Bud Tse"
"But Dr. Joe's Just Bored[r], by Jude Borst"
"But Hey, Buy The...[r], by Beth Yu"
"But No, He's the Bo'Sun[r], by Ben South"
"But Polish to Publish[r], by Tulip Bosh & Tobi Plush"
"But Rally Brutally, Bully-Rat[r], by Lyla Burt"
"But Reach a Butcher[r], by [if player is male]Bret Chau[else]Ruth Cabe[end if]"
"But Sell Bullets[r], by Stu Bell"
"But Tire, Tribute[r], by Bert Tiu"
"But Yeah, Bye, Utah[r], by [a-b] Huyt"
"But Yon Bounty[r], by Toby Nu"
"A Butcher's Sure Batch[r], by [if player is male]Trace Bush[else]Sera Butch[end if]"
"Butler Ulbert[r], by Bret Lu"
"A Butler's Baluster[r], by [if player is male]Bert Saul[else]Rea Blust[end if]"
"Buy Ann a Bunny[r], by Nun Bay Bunyan"
"By a Third Birthday[r], by Thad Irby"
"By Best BBS Yet[r], by Ty Ebbs"
"By Dear, a Derby[r], by [if player is male]Ray Bey-Bedard[else]Deb Ray[end if]" []
"By Lingo Ignobly[r], by [if player is male]Gino Bly[else]Glyn Obi[end if]" []
"By Luck, Eh, Huckleby[r], by [if player is male]Kyle Chub[else]Becky Luh[end if]" []
"By Sod, a Sad Boy[r], by Bo Days"
"Bye, Bath: the Baby[r], by Beth Bay"
"Bye Now, New Boy[r], by Ben Yow"
"Bye, Souls: Bless You[r], by [if player is male]Loy Busse[else]Su Bosley[end if]"
"Byroads So Bardy[r], by Rob Days"
"Cab-Only Balcony, Boy Clan[r], by Lyn Coba" []
"Cabals to Lab Coats[r], by Scot Alba"
"Cabin Fever: France Vibe[r], by Vince Faber"
"Cad Empire: Carpe Diem[r], by Meda Price"
"Cadger-Graced Dr. Cage[r], by Edgar C. DeCrag"
"The Cads Scathed[r], by Ted Cash"
"Cagier Gracie[r], by Erica G. Geraci"
"Cagley Legacy[r], by Ace Gly"
"Cake: Try, Take, Cry[r], by Rey Tack"
"Calcium Accumil[r], by Ma Lucci" []
"Calgary's Scary Gal[r], by Rags Clay"
"Call Thou Local Hut: Touch All[r], by Lou Latch"
"Call Up Pal Luc[r], by Al Culp"
"Calls to Co-Stall All Cost[r], by Sal Colt"
"Calumnies['] Main Clues[r], by [if player is male]Sam Lucien[else]Sue Maclin[end if]" []
"Came for Cream of Mo['] Farce[r], by Mac Fero"
"Camoflague: a Face Mogul[r], by Gema Coufal"
"A Camp Elf Facepalm[r], by Alec Famp"
"The Camp's Math Spec[r], by Pam Tesch"
"Can-Do and Co[r], by A. Condon, Cad"
"Can His Chains Cash In[r], by Nic Ash"
"Can Louts Consult a Cult As No Soul Can't[r], by Scot Luna"
"Can-May-a-Mancy[r], by [if player is male]Mac Yan[else]Ayanna McCamy[end if]"
"Can Yetis Stay Nice[r], by Staci Ney"
"Can't Jo Be an Object[r], by [if player is male]JC Boneta[else]Jen Cabot[end if]"
"Can't-Lose Con Tales[r], by Len Coats & Sal Conte" []
"Cancel Out a Cult Once[r], by [if player is male]Cole Cantu[else]Luce Caton[end if]"
"Candider Riddance[r], by [if player is male]Ned Darci[else]Cinda Erd[end if]"
"The Candor: Don't Reach[r], by Chet Doran"
"Cannibal-Cabal Inn[r], by Ian Blanc"
"Canonists['] Sanctions[r], by Cassi Tonn"
"The Cape's Cheapest[r], by Pete Cash" []
"Capello's Collapse[r], by Sol Place"
"Captain Pa-I-Can't[r], by Tip Caan" []
"Caputo's Up-Coast Opus Act[r], by Pa Scout"
"Car Tour Curator[r], by Curt Roa"
"Carabineers['] Aberrancies[r], by Sara Bernice & Narcisa Bree"
"Carcinogen: Cancer, Go In[r], by Nanci Groce" []
"The Cards Herd Cats[r], by Dre Tasch"
"Care? Groan, Arrogance or Carnage[r], by [if player is male]Reg Carano[else]Cora Agner[end if]"
"Carer on a Corner[r], by [if player is male]Ron Race[else]Noe Carr[end if]" []
"Carl W is Sir Claw, I Scrawl[r], by Ric Laws"
"Carlsen Left Crestfallen[r], by Frances Tell"
"Carmelo's Scam-Role Clamores[r], by Sam LeRoc"
"Carnage Can Rage[r], by Ace Garn"
"Carnal Clone Offer[r], by Florance Falconer"
"Carouse Our Case[r], by Sue Cora"
"Carry On, Rancory[r], by Ron Cray"
"Carry On, Ray Corn[r], by Ron Cray"
"Carsick, We Wisecrack[r], by [if player is male]Cesar Wick[else]Kaci Crews[end if]"
"Cartoons, to Carson: no Actors Can Roost[r], by Nora Scot"
"The Case: Ace Seth Teaches SeaTech E-Cheats, Each Set[r], by Tee Cash" []
"The Case for Other Faces of Cheaters[r], by Cesar Hoeft"
"Cast Iron Into Cars[r], by Arin-Scot Crisanto" []
"Cat Lady: a Dactyl[r], by Tad Clay"
"Cat People Peace Plot[r], by Cleta Pope"
"Catbird, Yelp Predictably[r], by Cadet Pribyl"
"Catch Phrase Scratch Heap[r], by [if player is male]Casper Hatch[else]Chara Petsch[end if]"
"Catch, Sir: I Scratch[r], by Rich Cast"
"Cater So to Cares[r], by Scot Rea"
"Catfishes['] Chat: I [']Fess[r], by Cassi Heft"
"Cathy's Shy Cat[r], by Ty Cash" []
"Cations['] Actions[r], by Nic Sato" []
"Causally, Casually[r], by [if player is male]Saul Clay[else]Lucy Sala[end if]"
"The Cause: He's Acute[r], by Ace Theus" []
"Caustic Rare Caricatures: Accurate, Sir![r], by Traci Crause"
"Cave Dirt: It Craved A Verdict[r], by Tad Cervi"
"Cave Troll's Last Clover[r], by [if player is male]Sol Calvert[else]Carol Velst[end if]"
"Cavendish and Chives[r], by [if player is male]Chad Vines[else]Devin Cash[end if]"
"The Caves Save Tech[r], by [if player is male]Steve Cha[else]Eva Tesch[end if]"
"A Cedar Arcade[r], by Ace Ard"
"Cedary Red Cay[r], by [if player is male]Ed Cary[else]Darcey DeCray[end if]" []
"A Ceded Decade[r], by [if player is male]Ed Deac[else]Cad Dee[end if]"
"Cedwin Winced[r], by Cid New & Nic Dew"
"A Celebrant Tabernacle[r], by Lance Beart"
"Cell: I Yap Epically[r], by [if player is male]Lyle Pica[else]Lily Pace[end if]"
"Cellar Race[r], by Clare Carle-Lacer" []
"Centaurs Sure Can't[r], by [if player is male]Sean Curt[else]Una Crest[end if]"
"A Century, Runty Ace[r], by [if player is male]Nat Cruey[else]Tyra Cuen[end if]" []
"Cerasoli Calories[r], by [if player is male]Eli Oscar[else]Laci Rose[end if]"
"Chaim's Smicha[r], by Mischa Masich"
"Chan is in Cash[r], by Nic Ash" []
"Chandler's Ranch Sled[r], by Cher Lands"
"Chap, Yer Preachy[r], by Pa Ryche"
"Chaplin's Clan Ship[r], by [if player is male]Sal Pinch[else]Lin Pasch[end if]"
"Charlie LaRiche: Ah, Relic[r], by Hal Rice" []
"Charm-Spent Parchments[r], by Nat Schremp"
"Charm Twice, Warm Hectic Crime Watch[r], by Mitch Carew"
"Charming Mr. Chiang[r], by Marc Nigh"
"Charon's Anchors[r], by Ron Cash" []
"Cheat On, Ache Not[r], by [if player is male]Nat Echo[else]Tena Cho[end if]"
"Cheatum's Mustache, Such Meat[r], by Sam Chute"
"Cheers to the Score[r], by Chet Rose"
"A Chef's Chafes[r], by E. F. Cash, Chaffee Sachs & F. C. Shea"
"Cher's Kid: His Dreck[r], by Ed Kirsch"
"Cheri's Riches[r], by Sir Che Schier" []
"Chess Bait: the Basics[r], by Cassi-Beth Estis-Bach"
"A Chess Game: Scheme Saga[r], by Sasha McGee"
"Chet Rios Shot Eric[r], by Chris Teo"
"Chic Loner Chronicle[r], by Olric Chen"
"Chicer Heresies, Cheesier Riches[r], by Cherise Scheier" []
"Chicest Thrillers, Stretchier Chills[r], by Christel Tichsler"
"A Chicken: Nice Hack[r], by Ceci Khan"
"Chider Dr. Eich[r], by Ed Rich"
"Chimeras Scare Him[r], by [if player is male]Rich Ames[else]Sam Reich[end if]"
"A Chit-Chat I Act, Hi[r], by Cathi Chait" []
"Chokes at Casket, Oh[r], by [if player is male]Chet Soak[else]Kath Esco[end if]" []
"Cholesterol: Tolls Cohere[r], by Rochelle Tso"
"Chorale Cholera[r], by Carole H. LaRoche"
"A Chore, Horace: Oh, Care or Ache![r] by Rao Che"
"A Chortle to Rachel[r], by [if player is male]Alec Roth[else]Cleo Hart[end if]"
"Chortled a Cold Heart[r], by [if player is male]Chad Toler[else]Dot Rachel[end if]"
"Chosen Boy: One Shy Cob[r], by [if player is male]Shon Boyce[else]Ebony Ochs[end if]"
"A Chosen Has Once[r], by [if player is male]Sean Cho[else]Noe Cash[end if]" []
"Christoper's Rectorships[r], by Horst Crespi & Itch Prosser"
"A Chum's Scum, Ha[r], by Mac Shu"
"Chunks to Shuck Not[r], by Scot Kuhn"
"A Chunky Cay Hunk[r], by Huck Yan"
"Churn Lithe in the Lurch[r], by Luther Chin & Ulrich Neth" []
"Ciambi's Iambics[r], by Ibis Mac"
"Cicero's Co-Cries: Soccer, I?[r], by Ceci Ros"
"Cinema Fit to Naif Totemic Metafiction[r], by Camie Fitton"
"Cinnamon Icon Mann[r], by Mina Conn"
"Circles of Serf Colic[r], by Cecil Fors"
"A Cistern Can't Rise[r], by [if player is male]Stan Rice[else]Cris Neat[end if]"
"Citatory Atrocity[r], by Cory Tait"
"Cite Thy Itch, Yet: the City, Ye Titch[r], by Ty Teich"
"Cito's Tic So Stoic[r], by Coco Tsitis"
"City Hall: Achy Till All Itchy[r], by Ty Cahill"
"City Life Felicity[r], by Ty Filice"
"Civil Man's Calvinism[r], by Vic Silman"
"Civilians, I Cavil Sin[r], by Cali Ivins & Lisa Vinci"
"Claims to Mac's Toil[r], by Mica Solt"
"Clam Up Ma Culp[r], by Lu Camp"
"Clamor, Pain, Moral Panic[r], by Lorina Camp" []
"Clan Dour Cauldron[r], by [if player is male]Conrad Lu[else]Luna Cord[end if]"
"A Clan Icon, Canonical[r], by Alica Conn"
"Clap at a Catalpa[r], by Pat Cala"
"Clark, Be Blacker[r], by Al Breck"
"Clarke: a Clerk[r], by Clara Keckler"
"Clashed Sad Lech[r], by Les Chad"
"Clasp Nine Pinnacles[r], by Cap Nilsen"
"Classify Cy's Fails[r], by Cay Fliss"
"Claw Forth, Flowchart[r], by Craft Wohl"
"Clay-Net Latency[r], by Nate Cly & Ty Lance"
"Clay Nor Corn Lay[r], by [if player is male]Lon Cary[else]Nora Cly[end if]" []
"Clean Mud, Calm Dune[r], by Luc Amend"
"Clean Sharp Plane Crash[r], by [if player is male]Charles Pan[else]Chanel Rasp[end if]"
"Clear New Were-Clan[r], by Carl-Ewen Lawrence" []
"Clear Sky, Scary Elk[r], by Carl Keys"
"Clearly, Carlyle[r], by Ella Cyr"
"Clematis Climates[r], by [if player is male]Alec Smit[else]Laci Smet[end if]"
"A Cleric Pro-Reciprocal[r], by [if player is male]Rico Parcel[else]Carol Price[end if]"
"Clings to a Nostalgic Antic Slog[r], by Gil Cantos" []
"Clio's Coils[r], by Colli Sisco"
"Cloak a Lock[r], by Kao Allcock"
"Clobbering-Belong Crib[r], by Corbin Gelb"
"Clochards, Arch-Clods[r], by Cal Dorsch"
"Clod Ed's Scolded Coddles[r], by Ced Olds"
"Cloddish Men, Demon Childs[r], by Eldon Schmid"
"A Close Solace[r], by Sal Coe & Cal Ose"
"A Closed, Solaced Old Case[r], by Ed Lasco" []
"Closeted Doc Steel[r], by Ted Coles"
"Cloud the Old Chute[r], by Ludo Echt" []
"Cloy On, Colony[r], by Lon Coy"
"Cloyings So Clingy[r], by Syg Colin"
"Clue Not One Cult[r], by Luc Eton"
"Clueless Cell Uses[r], by Luc Essel"
"Cluing, I Clung[r], by Luci Ng"
"Co-Ed Deco[r], by Dede & Coco"
"Co-Insured Decurions Cruised On[r], by Rico Sunde"
"Co-Slime? I'm Close[r], by Sim Cole"
"Co-Whine? How Nice[r], by Owen Chi"
"Coalitionist Solicitation[r], by Alison Ciotti"
"Coarsen It: on Raciest Reactions to Arsenic[r], by [if player is male]Eric Santo[else]Nita Crose[end if]" []
"A Cobalt Lab Coat[r], by Al Cabot"
"Coca, Yayo: a Coy CYOA[r], by Cacy O. Yao"	60
"Code-Fork Roofdeck[r], by Fred Cook"
"Coded-to-Dote Doc[r], by Todd Coe"
"Coifer of Rice[r], by Ric Foe"
"Coiners['] Cronies[r], by Enrico S. Ericson" []
"Col Nemo's Monocles[r], by Mel Coons" []
"The Cold Cot Held[r], by Ted Loch & Old Chet"
"Cold Fury Could Fry[r], by Lucy Ford"
"Cold Milk Mill-Dock[r], by Mick Doll"
"The Cold Old Tech[r], by Ced Holt"
"Cold Water, Late Crowd[r], by [if player is male]Del Cowart[else]Delta Crow[end if]"
"Cold Wet Doc Welt[r], by Ted Cowl" []
"Coleman, One Calm Lame Con[r], by O. McLane" []
"Colleagues: A Close Glue[r], by Gale Clouse"
"Colonialists['] Oscillations[r], by Sion Castillo & Staci Ollison"
"Colonials Slain? Cool[r], by Laci Olson"
"Color is Cool, Sir[r], by [if player is male]Sol Rico[else]Cris Loo[end if]"
"Colorado's Cool Roads[r], by Loo Dorcas"
"Colt Saw Claws to Scowl At[r], by Cal Stow"
"Come Again, Egomaniac[r], by Meg Iacona"
"Come By Me, Coby[r], by Bec Moy"
"Come On, Men Coo[r], by Mo Cone" []
"Come to Me, Coot[r], by Tom Coe"
"A Comely Coy Male[r], by Moe Clay"
"A Comet So Comatose[r], by Mae Tosco"
"Commenter Rec-Moment[r], by Tom McNeer & Mort Nemec"
"A Common Ammo Con[r], by Mac Moon"
"A Complex Calm Expo[r], by Max Cople"
"Compromise: Micro Poems[r], by Cooper Mims"
"Computers['] Cute Romps[r], by Tom Spruce" []
"Comrades['] Co-Dreams[r], by Ed Marcos"
"Conceal Rarely Yon Cry Alone[r], by Carolyne Roylance" []
"Concertos, Not Soccer[r], by [if player is male]Scot Crone[else]Coco Ernst[end if]"
"Confession Confines So[r], by [if player is male]Ennis Fosco[else]Connie Foss[end if]"
"Confide, Def Icon[r], by Doc Fine"
"Congruity Outcrying[r], by [if player is male]Guy Citron & Cyr Guiton[else]Ying Turco[end if]"
"A Conquest: Quotes Can Squat Once[r], by Coste Quan"
"Conservationalist Conversationalist[r], by Svetlana Sciortino"
"Consider Corn Dies[r], by Ned Corsi" []
"Considerate Care is Noted[r], by Darci Osteen"
"Considerate Desecration: Anecdote, Sir[r], by [if player is male]Dante Serico[else]Doreen Staci[end if]" []
"Consul to CLOUT, Son? Cult Soon[r], by Su Colton"
"Contemporary Contrary Poem[r], by Payton Cromer & Marco Poynter"
"Contessa Doli Consolidates, Disconsolate[r], by DeLois Caston"
"Contrary Art, Cry On[r], by Ty Carron"
"Coo Spite So Poetic[r], by Otis Cope" []
"Cook Quit Too Quick[r], by K. C. O'Quoit"
"A Cooker's Care So OK[r], by Ace Rooks"
"Cool Duped Odd Couple[r], by Luc DePodo"
"The Cool Echo Lot[r], by Chet Loo" []
"A Cool Rant Too Carnal[r], by [if player is male]Ara Colton[else]Caron Toal[end if]"
"Cool Shades Schools Ed A[r] by Chas DeLoos"
"Cooling On Logic[r], by Gil Coon" []
"A Copywriter Wrote Piracy[r], by Capri Towery"
"Coracles at Clear Coast[r], by Les Toccara"
"Cordless Scolders[r], by Del Cross"
"Core Art Creator[r], by Cate Orr"
"Core-Op Eco-Pro Cooper[r], by Roc Poe" []
"Corn-Fed [']N Forced[r], by Don Cerf"
"Corn Yet? Try Once[r], by Cortney Creyton"
"Corniest Noticers Censor It[r], by Cris Eton"
"Coronating Tragic Noon[r], by Cartooning Anton Corgi"
"Coroner-Crooner[r], by Ron C. Roe"
"Corruption Count Prior[r], by Curt Pirono"
"The Cost To Techs[r], by Chet Tso"
"A Cot-Sty So Catty[r], by Ty Costa"
"Cottage: I Cogitate[r], by Tito Cage"
"County Finds Dysfunction[r], by Cyndi Founts"
"Courtesy or Cutesy?[r] by Rusty Coe & Stu Corey" []
"Courtney's Once-Rusty Route-Sync[r], by Tony Cruse"
"A Cove Runs Cavernous[r], by [if player is male]Ron Cuevas[else]Cora Venus[end if]"
"Cowardly Wary Clod Wordy Cal[r], by [if player is male]Cary Wold[else]Darcy Low[end if]"
"Cowhand and Chow[r], by Dawn Cho"
"Cowherd Chowder[r], by Drew Cho"
"The Cows, Chow-Set, Hew Cost[r], by Stew Cho"
"Crack Bowl, Black Crow[r], by Brock Claw"
"Craig [']N Caring Nag Ric[r], by Carin G. Cragin"
"Cram Only Normalcy[r], by Lon Marcy"
"Crapulous, Opuscular[r], by Paulo Crus"
"Crayon Pics Conspiracy[r], by Pansy Ricco" []
"Crayoned Deaconry[r], by [if player is male]Don Carey[else]Candy Roe[end if]"
"Creak to a Rocket[r], by Art Coke"
"Creationist Recitations[r], by [if player is male]Scottie Arin[else]Tricia Stone[end if]"
"Creative Rite Cave[r], by [if player is male]Avi Crete[else]Traci Vee[end if]" []
"Creativity, Rivet a City[r], by Ivie Cratty"
"Cred? A Ton? Don't Care[r], by Dean Cort" []
"Credo: Irk Doc Riker[r], by Cid Roker" []
"Creep Down, Deep Crown[r], by Ned Cowper & Drew Ponce"
"A Creep E-Caper[r], by Cap Ree-Pearce"
"Creepy Mitt: Petty Crime, Temper City[r], by Mercy Petit"
"Crenelation Intolerance[r], by [if player is male]Lonnie Carte[else]Trina Conlee[end if]"
"Cretinous Neurotics['] Countries[r], by [toti] Cruse"
"The Crew We Retch[r], by Chet Rew-Wechter"
"Crib Gloom: Micro-Blog Girl Combo[r], by Rico Glomb"
"Cries as I Caress[r], by Eric Sas"
"Crime and Mind Care[r], by Ned Maric"
"Crime Goons['] Ergonomics[r], by [if player is male]Roscoe Ming[else]Meg Corsino[end if]"
"Crime? Merci[r], by Eric M"
"Cringe, Hot Ice Throng[r], by Teri Chong-Creighton"
"Criselda's Laser Disc[r], by Reid Class"
"Cristobal Lost a Crib[r], by Bo St. Clair"
"Crooked or Coked?[r] by Eco-Dork/OK Coder Red Cook"
"Croplike Rock Pile[r], by [if player is male]Eric Polk[else]Lori Peck[end if]"
"Crossly, Sly Orcs[r], by Ross Cly"
"The Crow's Hot Crews[r], by Wes Rotch"
"The Crow's Hot Crews[r], by Wes Torch"
"The Crowd Threw Doc[r], by Ced Worth"
"Crowded Odd Crew[r], by Doc Drew"
"Crush the Tech Rush[r], by Che Hurst"
"Crushin['] Sun-Rich Urchins[r], by Nic Rush"
"Crustily, Rusticly[r], by Lucy Rist"
"Cry Eep, Creepy Percey[r], by Rep. Cey"
"Cry. Fail. Clarify[r], by Laci Fry"
"Cry, Hall So Scholarly[r], by Sally Roch"
"Cry Last, Sly Cart[r], by Ty Carls" []
"Cry, Mangle, Clergyman[r], by Marc Elgyn"
"Cry, Rose: Sorcery[r], by Coy Serr"
"Cry, Simon: Icy Norm's Cronyism[r], by Ros Mincy"
"Cub, Lady, Club Day[r], by Bud Clay"
"Cub, Take a Bucket[r], by [a-b] Tuck"
"Cue, Sir: I Curse[r], by Su Rice"
"A Cue's Cause[r], by Esau Cuscea"
"Cul-De-Sac L'Accused[r], by Claud Ces"
"Culls to Ol['] Cults[r], by Luc Olst"
"Cult Den[r], by Luc Dent & Ced Lunt"
"Cult Hero: Her Clout[r], by Cleo Hurt" []
"Cumberland's Calm Burdens[r], by Del Branscum"
"Cupid, Jeer Prejudice[r], by Jude Price"
"Cur Has a Crush[r], by Su Arch"
"Curb [']Em, Mr. Cube[r], by Rube McCumber"
"Cure Also Carousel[r], by [if player is male]Lucas Roe[else]Cora Luse[end if]"
"A Curly Cur Lay[r], by Luc Ray"
"A Curly Elf, Carefully[r], by Lucy Faler"
"Curry [']Em, Mercury[r], by Rey Crum"
"Curse-Paw Swap Cure[r], by A Screw-Up"
"A Curse Saucer[r], by Su Cera"
"A Cursed Crusade[r], by Sue Card"
"Cushing Chugs In[r], by Gus Inch"
"Cuss, Dear Crusades[r], by Russ Cade"
"Cuss Fear Fuss Care: Surfaces[r], by Russ Face"
"Cussier Cruises[r], by Russ Ice"
"Cut Grain, Giant Cur[r], by Cari Tung"
"Cutlers['] Cluster[r], by Les Curt"
"Cynic, Hear Chicanery[r], by Carey Chin"
"Cynical Caci-Lyn[r], by Nic Lacy"
"Cynical, Icy Clan[r], by I. Clancy" []
"Cyrano, a Crony[r], by Ron Cay"
"Da Life, Failed[r], by Lalida Diffee" []
"Dabbler Drabble[r], by Del Barb"
"Dad, I'm No Diamond[r], by Mad Dino" []
"Dad Loy's Old Days[r], by Sly Doda"
"Dad's Bile Disabled[r], by Sid Blade"
"Dad's Brow, Bad Words[r], by Brad Dows"
"Dallying in Gladly[r], by Lyla Ding"
"The Dame, Me, Death[r], by Ed Mehta"
"The Damp PM Death[r], by Ted Pham"
"Damping Mind Gap[r], by Pam Ding"
"Dan and DNA: Add Ann?[r], by Nann Addad" []
"Dan Ho Had No Honda[r], by Noah Haddon"
"Dan Yu's Sunday[r], by Su Nady"
"Dan'l Gee, a Legend[r], by Egeland DeLange"
"The Dance-Teach Den[r], by Chet Dean"
"Dang Lips, Spin Glad[r], by Dan'l 'Pigs' Spalding" []
"Dang Mimes['] Mind Games[r], by Sam Deming"
"Danger, Aid My Daydreaming[r], by [if player is male]Damien Grady[else]Madie Nygard[end if]"
"The Danger Raged Then[r], by [if player is male]Thad Green[else]Eden Garth[end if]"
"Danglin['] Landing[r], by Gil Dann"
"Dante, Tend a Den at AdNet[r], by Ada Dennett" []
"Dante's Chum Deutschman[r], by Ted Schuman"
"Dapper Dr. Pape Rapped[r], by Pepard Da Perp"
"Dapperer, Prepared[r], by Reed Rapp"
"Dare By Red Bay: Yer Bad[r], by Bry Ade" []
"Dare On, Rad One[r], by Dan Roe"
"Darer Mutiny: Rudimentary Unity Marred[r], by Terri Munday"
"Dares-Arsed Radar Seeds[r], by Drea Saders"
"Daring a Grind[r], by Girard Dannig" []
"Dark Blue Bark Duel[r], by Luke Bard"
"Dark Corner, Rank Record, Crank Order[r], by Rand Rocker"
"Dark Fens, Def Snark[r], by Des Frank"
"Dark Shadow: Wah, Sad Dork[r], by Dash Dworak"
"Dark Son Drank So[r], by Don Sark"
"The Dark Trek Had Hard Tek[r], by Kat Dreh"
"Dark Winter? Darker Twin, Drink Water[r], by [if player is male]Ward Tinker[else]Karri Wendt[end if]"
"Darken Danker, Kendra[r], by Ken Ard"
"Darling Ring, Lad Gardlin[r], by Gil Rand" []
"Darn, a DNR[r], by Dann Darr"
"Darn Choirs Dish Rancor[r], by [if player is male]Chad Norris[else]Cinda Shorr[end if]-Richardson"
"Darn, Guy, a Grundy[r], by Guy Rand"
"Darn, I Go Adoring Roading[r], by Ingador Gironda"
"Darn Plot, Portland[r], by Rod Plant"
"Darn Sin Innards[r], by Sid Rann"
"Darn, to Dart On[r], by Rod Tan & Nat Ord" []
"Dartmouth MathTudor: a Mud Troth[r], by Tom DuHart"
"Data Hill Had it All[r], by Thad Lail"
"Date More Moderate[r], by Tor Meade"
"Dauntless Adultness[r], by Tessa Lund"
"Dawdle, Dew Lad[r], by DeWald Waddle"
"Dawkins Wadkins Was Kind[r], by Sid Kwan"
"The Dawn Had Went: What End?[r] by Ted Hawn"
"Day-Bother: Breathy Do By the Road[r], by Debra Hoyt"
"Day-Rob Byroad[r], by Bo Rady"
"Day Ten: And Yet Tend, Ay[r], by Ty Dean"
"Daydream-Made Yard May Dread[r], by [if player is male]Adam Dyer[else]Mara Eddy[end if]"
"Daymares? Yes, Drama[r], by Ada Myers & Myra Sade"
"De Facto Taco-Fed, Co-Fated to Decaf[r], by [d-t] Face"
"Dead Anne[r], by [if player is male]Aden Dane[else]Edna Dean[end if]" []
"Dead Mary's Daydreams[r], by Eddy Armas"
"Dead Men Amended Mad Need[r], by Ned Mead"
"Dead-Newsy Wednesday Dawned, Yes[r], by [if player is male]Wayne Edds[else]Wendy Sade[end if]"
"Dead Omens: So Amended Desdemona[r], by [if player is male]Damon Seed[else]Dede Mason[end if]"
"The Deal Hate Led[r], by [if player is male]Thad Lee[else]Dee Halt[end if]"
"The Deal With Hilda Hewett[r], by Letha Whited"
"Deal With Wild Hate[r], by [if player is male]Wade Hilt[else]Tilda Hew[end if]"
"Dear Beth Breathed[r], by Bret Head"
"Dear Brent: Enter, Drab Bartender[r], by Rand Ebert"
"Dear Damon, Andromeda Manor: Dead![r], by Dara Moden"
"Dear Ghost: Goatherds['] Hardest Go[r], by Art Hodges" []
"Dear, if I Fared[r], by Frieda Fareid" []
"Dear, it's Satired Staider[r], by Dre Tsai"
"Dear Jo or Jade: J'Adore[r], by Joe Ard"
"Dear Old Dad Lore: Lo, Dread[r], by Ed Doral"
"Dear Pa's Parades[r], by Ed Paras"
"Dear Sol, Sore Lad, Reloads[r], by Del Rosa"
"Dear Sot: Roasted or Sated?[r] by Ed Astor"
"Dear Voter (Overrated,)[r] by Art DeVore" []
"Death Metal Healed Matt[r], by Mattee Dahl"
"Death? My, They Mad[r], by Mat Hyde" []
"Death? Not Done That[r], by Ed Hatton & Tad Thoen"
"Death Wish Hides What With Shade[r], by Shad White"
"A Deathly Hate, Lady[r], by Tad Healy"
"Deathsome Homestead[r], by Dee Thomas"
"Deb's Too Boosted[r], by Odo Best"
"DeBarth, The Bard[r], by Deb Hart" []
"Decal Once Concealed[r], by Alec Conde"
"The Decay Ached Yet[r], by [if player is male]Chet Eady[else]Cathy Dee[end if]"
"Deceits Sect, Die[r], by Sed Tice"
"Decent's Descent[r], by Ned Stec & Ced Enst"
"Decrepit Creed Pit[r], by Ted Price"
"Deem For Freedom, Me: Do, Ref[r], by Fred Moe" []
"Deem Shot the Domes[r], by Ted Moshe"
"Deep Diss, Despised[r], by Sid Speed"
"Deep Piers, Reed Pipes[r], by Pepe Dries"
"Deep South Housed Pet[r], by Ted Shoupe"
"Deering Reigned[r], by Ned Iger"
"Deez Is Seized[r], by Sid Zee"
"Defer Until Unfiltered[r], by Elden Fruit"
"Defer Ye Yer Feed[r], by Fred Yee"
"Deferral Re-Flared, Drear Elf[r], by Fred Lear"
"Deferring Nerd Grief[r], by [if player is male]Fred Negri[else]Fern Ridge[end if]"
"Defiantly Deal, Nifty Dainty Elf[r], by [if player is male]Tad Finley[else]Lindy Fate[end if]"
"DeFord's Fodders[r], by Fred Sod"
"Defrayed Feedyard[r], by Edda Frey & Dedra Fey"
"Deftly Infer Differently[r], by [if player is male]Ferdie Flynt[else]Firefly Dent[end if]"
"Deistic Edict is Diciest[r], by Ced Isti"
"DeKalb Balked[r], by Del Bak"
"Delaune's Unleased Used Lane[r], by Luna Dees & Adele Sun"
"DeLaurentis Adulterines, Neutralised[r], by [if player is male]Dustin Earle[else]Adriene Lust[end if]"
"Delete Le Deet[r], by Ted Lee" []
"Delicacy-Aid Cycle[r], by Cecil Day"
"Delila, Allied[r], by [if player is male]Ed Lail[else]Ida Ell[end if]"
"Dell-Roof Folderol[r], by Rolf Dole"
"Della's Dalles[r], by Lad Les Edsall" []
"Delora's Ordeals[r], by Al DeRos & Rod Sale" []
"Delude Le Dude[r], by Lu Dede"
"Demand a Man Dead[r], by Ned Adam"
"Demarinis's Misandries[r], by Iris Madsen & Mindi Sears"
"Demetri's Demerits[r], by Mister Ed & Si Detmer" []
"Deming's Smidgen[r], by Sid Meng"
"DeMint's Mindset: Mis-Tend[r], by Sim Dent & Ned Mist"
"Demolish, Idle Shmo[r], by Mel Doshi" []
"A Demon Moaned[r], by Dan Moe"
"Demons on Meds[r], by Desmon Sedmon"
"Demons['] Odd Mends[r], by Desmond Edmonds" []
"Demotion Into Demo[r], by [d-t] Monie"
"Dengel's Legends[r], by Les Deng & Des Glen"
"Denials, Lead-Ins: Laden is Eli Sand[r], by Selinda Insdale-Daniels" []
"DeNiro Rode in, Ironed[r], by [if player is male]Didier Nooner[else]Dorie Nordine[end if]" []
"Dennis Yu's Sunny Side[r], by Sindy Suen"
"Dense Rut, Unrested Dentures[r], by Ted Usner"
"Denser Icy Residency[r], by Cindy Rees"
"Deny Sad Days['] End[r], by Dan Syed"
"Deny Tax Next Day[r], by Tex Nady"
"Deplore, Old Peer[r], by Rod Peel"
"Deported Odd Peter[r], by Dede Port"
"Depraving Pervading[r], by Pig Vander"
"The Derby: Thy Breed[r], by Beth Dyer"
"Derogating Doing Great[r], by [if player is male]Diego Grant[else]Gidget Roan[end if]"
"DeRossi Dossier[r], by Sid Rose" []
"Desiccant Accidents[r], by Enid Cacts"
"Desire Re-Dies[r], by Sir Dee Seider"
"Desk Owner Needs Work[r], by Ken Dowers"
"A Despair Paradise[r], by Ada Piers"
"Despair's Dire Pass[r], by Sed Paris"
"Destination: No Daintiest Sin Antidote, It's Anointed[r], by [if player is male]Tino DeSanti[else]Nitta Edison[end if]"
"Destination: Tan Sedition Instead Into Inane Dittos[r], by Sandi Titone" []
"Destroying Stony Ridge[r], by Syed Girton"
"Detach Ad-Tech[r], by Ted Cha the Cad"
"Detaches as Etched[r], by [if player is male]Ted Chase[else]Cath Dees[end if]"
"Details Die Last[r], by Al Deist" []
"Detain My Dynamite, Man-Deity[r], by Ty Damien" []
"Devil Sim Mislived[r], by Mel Divis"
"Dew-Born, Bred Now[r], by Ed Brown"
"Dew Point Tepid Now[r], by Wind Poet Edwin Top"
"Dew Sat[r], by Wade St. Tawdes"
"Dewpoints Down Spite[r], by Wendi Post"
"Diagnose San Diego[r], by [if player is male]Dino Sage[else]Isa Ogden[end if]" []
"Diagnosis: God is a Sin[r], by India Goss" []
"Dial Tone, To Denial Not Ideal[r], by Donte Ali & Ida Elton"
"The Diary: Their Day Hit, Ready[r], by Ray Heidt"
"Diastole, Isolated[r], by [if player is male]Del Saito[else]Lois Date[end if]" []
"The Dice He Cited[r], by Ted Eich"
"Dicer Deric Cried[r], by Cedric Reid" []
"Dictatorship, Ditch a Ripost[r], by Picardi Shott"
"Die Anew, New Idea[r], by Dee Wain"
"Die Calm, Mild Ace[r], by Cam Idle"
"Die, Laggard Cleric[r], by Gricelda Claridge"
"Die Slow, Wise Old Sid Lowe[r], by Lois Dew"
"Diebel, Belied[r], by Ed Lieb"
"Dieringer's Grinderies[r], by [if player is male]Sig Ridener[else]Rene Sigrid[end if]"
"Dies Needy? Yes Indeed[r], by [if player is male]Eddy Niese[else]Dee Sidney[end if]"
"Differently, Friend Lefty[r], by Lynfred Feit" []
"Dilemmas I Slammed[r], by Dale Mims" []
"Dilly's Idylls[r], by Ly Dils"
"Diluted Dude-Lit[r], by Luddite Eli Tudd"
"Dim Grace Grimaced[r], by [if player is male]Mac Ridge[else]Meg Darci[end if]"
"Dim? Yes. My Side[r], by Sy Deim"
"The Diner in the Red[r], by [if player is male]Ted Rhine[else]Enid Hert & Dee Trinh[end if]"
"A Diner: Readin['] and Ire[r], by Darien & Nerida Adrien"
"Dingier Cons Considering Nicer Doings[r], by Cindi Gerson"
"Dinsdale's Side Lands[r], by Silas Nedd"
"Diogenes Seein['] God[r], by [if player is male]Gene Odis[else]Edie Song[end if]"
"Dipietro's Tripodies[r], by Otis Pride"
"A Dipole, Oedipal[r], by [if player is male]Lida Poe[else]Ed Paoli[end if]"
"The Dips Hid Pets[r], by Sid Peth"
"The Dire Deer-Hit Hid Tree[r], by Ed Reith"
"Dire Fop of Pride[r], by Fred Pio" []
"Dire Howls, Wild Horse[r], by [if player is male]Lewis Hord[else]Dori Welsh[end if]"
"A Dire Id Era Aired[r], by Aida Reider"
"Dire Rap Parried Rapider[r], by Pa Rider"
"Dire Scene Residence[r], by Sincere Ed"
"Dire Wolf's Life Words[r], by Lewis Ford"
"Dire Zeal Realized[r], by [if player is male]Ezra Idle[else]Liza Reed[end if]"
"A Direct Car Diet[r], by Tad Rice" []
"Directions: Discretion So Indirect[r], by Don Cristie"
"Dirt Serf Drifters[r], by Fred Rist"
"A Dirt Triad[r], by Art DiTardi"
"The Dirt's Third Set[r], by Sid Rhett"
"Dirty Room Dormitory[r], by Roy Ditmor"
"Disaster Dares Sit[r], by Tad Siers"
"Disc-Lover Vice Lords[r], by Doc Silver"
"Discourse Cruised So[r], by Susie Cord"
"Discriminators['] Doctrinairisms[r], by Smart Di Corsini"
"Disdain is IN, DAD[r], by Sid Dani"
"Disgrace Acre Digs[r], by Cid Sager" []
"A Dish is Had[r], by Di Ash"
"Dismalest Medalists[r], by Tad Smiles"
"Dismallest Medallists[r], by Della Smits"
"Disowned: Downside, So Winded[r], by [if player is male]Denis Dow[else]Dion Dews[end if]" []
"Display a Daisy, Pal[r], by Ali Spayd"
"Disruptive Prude Visit[r], by Vi DuPriest"
"Dissenter Tiredness, Residents[r], by Sid Sterne"
"Ditch a Hid Cat[r], by Tad Chi"
"Dithering Thin-Dirge Night Ride[r], by Hedi Grint"
"Dive, Lone Neo-Devil[r], by [if player is male]Eli Devon[else]Enid Love[end if]"
"Diverse Derives, Revised[r], by Dr. Sieve"
"Diverse Drivees I Served[r], by Deviser Irv Dees" []
"Diversey Drive, Yes[r], by Sid Every"
"Do Allegory Really Good[r], by Leo Gaylord"
"Do Beers Breed So[r], by Rob Dees"
"Do Clean, Lone Cad[r], by Dan Cole"
"Do Crawl, Cold War[r], by Carl Dow" []
"Do Frisk For Kids[r], by Rod Fisk"
"Do Ill? Ew, I Do Well[r], by Leo Wild"
"Do It, Do It: Did it Too[r], by [if player is male]Tito Dido[else]Didi Otto[end if]"
"Do Lean on Dale[r], by Lon Ade"
"Do Let's Sled To[r], by Les Tod"
"Do Meet to Deem Emoted[r], by Ted Moe & Tom Dee"
"Do Meet to Deem[r], by Tom Dee, Ted Moe & Ed Mote"
"Do New, We Nod[r], by Wende O'Down" []
"Do Nobly, Yon Bold Bony Old Blond, Yo[r], by Lon Boyd"
"Do Not Sleep, Olden Poets[r], by [if player is male]Donte Lopes[else]Dee Polston[end if]"
"Do Red, Odder Dr. Doe[r], by Ed Ord"
"Do Rust or Dust[r], by Otto-Russ Rudd"
"Do Sneer, Red Nose[r], by Ron Dees"
"Do So, O Sod[r], by Dodo Soos"
"Do Swim, Wisdom[r], by Sim Dow"
"Do Tanks Stand OK?[r] by Dan Kost"
"Do-the-Same Homestead[r], by Theo Dames"
"Do Well, Low-Led Old Lew[r], by Ed Woll"
"Do-Wishes Side Show[r], by Wes Doshi"
"Do Worry, Rory Dow[r], by Roy Word"
"Doc Beth Botched BodTech[r], by Ted Boch"
"A Doc Coda[r], by Coco Dada"
"Doc Noles Condoles Cold Ones[r], by Del Coons" []
"Doc Tries So Direct[r], by Edric Tso" []
"Documents I Miscounted[r], by Donte Music" []
"Dodging Ammonia in Dogma[r], by Dominga Mandigo"
"A Dog is Sad: I Go[r], by Sid Gao"
"Dogs Are So Raged[r], by Rod Sage"
"Doin['], I Nod[r], by Noni Dido"
"Doing Well: I Lend Glow[r], by Lew Goldin"
"The Dole Lot Heed[r], by Dee Holt"
"Doleful Loud Elf[r], by O'Dell Fu"
"Dollars to Toll Roads[r], by [if player is male]Lord Salto[else]Lola Drost[end if]"
"Dolls Yet Old-Style[r], by Dell Yost"
"A Doltish Oath Slid[r], by Ida Holst"
"Don't Ape Pat Oden[r], by [d-t] Pena" []
"Don't Be a Neat Bod[r], by Bo Dante"
"Don't Be No-Debt[r], by Bo Dent"
"Don't-Care Coed Rant[r], by [d-t] Crane" []
"Don't Fear a Red Font[r], by Dean Fort"
"Don't Move, Vent Doom[r], by Tom Devon"
"Don't Panic, Antic Pond[r], by Cinda Pont"
"Don't See No Steed[r], by Ted Enos & Ed Stone"
"Don't See to Needs[r], by Ed Stone" []
"Donatistic Dictations[r], by India Scott"
"Donetta, Notated[r], by Don Tate"
"Donors So Redone or Sodden Sooner[r], by Rosendo Ordones"
"A Doodler's El Dorados[r], by Dedra Loos"
"Doom? Nah, Manhood[r], by Damon Ho"
"The Door to Herod[r], by [d-t] Rohe"
"Dope Will Lope Wild[r], by Di Powell"
"Dopier Period! O Pride![r] by Rod Pei"
"Dopy [a-b] Peabody[r], by Pebo Day" []
"Dopy Hal's Posh Lady Holds Pay[r], by Loyd Hasp"
"Dork Play? Dark Ploy[r], by Loyd Park"
"A Dork's So Dark[r], by Rod Sak-Kardos"
"A Dork's Zen: Dark Zones[r], by Zander Kos"
"The Dorms Herd Most[r], by Ed Strohm"
"Dorset Doters[r], by Rod DeRossett"
"Dorx of Oxford[r], by Rod Fox"
"Dosage, Sea Dog[r], by Dad-E-O Gossage"
"Dosing Fear: Readings of Daring Foes[r], by [if player is male]Edison Graf[else]Frieda Song[end if]"
"Dote and Add Note: Not Dead[r], by [d-t] Dean"
"Dote, Grim Grit-Dome[r], by Tom Ridge"
"Double Pro Pure Blood[r], by [if player is male]Bud Looper[else]Lupe Bordo[end if]"
"Doubles Do Blues[r], by Sue Bold"
"A Doubter, Obdurate[r], by Bo Duarte"
"Doug the Huge Dot[r], by Ted Hugo"
"Dour Glad Old Guard[r], by Olga Rudd" []
"Dovetail, Violated Old Evita[r], by Teo Vidal" []
"Down Ball Wall Bond by Dawn Boll"
"Down Gin Now, DING[r], by Don Wing" []
"Downfall of Lladwn[r], by Dan'l Wolf"
"Downtime's Wisdom Net[r], by Owen Smidt"
"A Doyen One Day[r], by Ned Yao & Dan Yeo"
"Doyen Sim on My Side[r], by Sid Money & Denis Moy"
"Doyens Nod Yes[r], by Syd Eno"
"Dr. Choi's Orchids[r], by Sid Croh"
"Dr. Deon Droned[r], by Ned Ord" []
"Dr. Egan's Gardens[r], by Reg Sand" []
"Dr. Fok is For Kids[r], by Rod Fisk"
"Dr. Joan Jordan[r], by [if player is male]Jon Ard[else]Jo Rand[end if]" []
"Dr. Kothe, the Dork[r], by Ted Kroh"
"Dr. Lane's Rad Lens[r], by Les Rand-Sandler" []
"Dr. Lange, Gnarled Nerd-Gal[r], by Rad Glen LeGrand"
"Dr. LeDuc, Curdled Cuddler[r], by D. D. Clure"
"Dr. Lee: A Dealer[r], by Lee Ard" []
"Dr. No-Lab Ran Bold[r], by Bald Ron Borland"
"Dr. Oden Droned[r], by Ned Ord" []
"Dr. Pogyi, Prodigy: I'd Go Pry[r], by Gord Yip"
"Dr. Rocha's Orchards[r], by Rod Rasch"
"Dr. Same-Dreams[r], by [if player is male]Ed Mars[else]Red Sam Semrad[end if]"
"Dr. Spano Pardons Rod's Nap[r], by Don Rasp"
"Dr. Vogue, Rev. Doug[r], by Rog Duve"
"Drab Angie Bargained Gabardine[r], by Gena Baird & Ada Bering"
"Drab Lit, Brit Lad[r], by Al T. Bird"
"Drab-Lit Libtard Lad Brit[r], by Tal Bird" []
"Drab Mutes Muster Bad Drumbeats[r], by Bert Dumas"
"Drab Stu Bustard[r], by Bud Rast"
"Draft-a-Fad Art[r], by Tad Raf"
"Draft One Tea Frond[r], by Red Afton" []
"Drafty, Fat, Dry[r], by Tad Fry" []
"Drag Yon Organdy[r], by Don Gray" []
"Dragons So Grand[r], by Rod Gans"
"The Drains: Sin, Hatred[r], by Denis Hart"
"Dramatise, Armistead[r], by [if player is male]Sid Matera[else]Mae Astrid[end if]"
"Drastic St. Darci[r], by [if player is male]Sid Cart[else]Cris Tad[end if]" []
"Drawn Olden Wonderland[r], by [if player is male]Ned Waldron[else]Wendra Nold[end if]"
"Dread Adder Dared[r], by Dedra Edard" []
"Dream County Documentary[r], by Myrna Doucet"
"Dream Logic: Old Grimace, Miracle-God[r], by [if player is male]Gil Mercado & Ced Milagro[else]Carol Midge & Marcie Gold[end if]"
"Dream on and More, Mad Nero[r], by Dan Rome" []
"Dream Time: Readmit Me[r], by [if player is male]Tim Maeder[else]Tammi Reed[end if]"
"Dream World: Mold, Redraw[r], by Redd Marlow"
"DreamCo Comrade Mo Cared More, Cad![r], by DeMarco Mercado"
"Dreams of More Fads[r], by Ford Ames" []
"DrearCo: a Record[r], by Rod Race"
"Dreem of Freedom[r], by Mo Feder" []
"A Dreg Raged[r], by Edgar Radge" []
"Dressing Up Purged Sins[r], by Gund Priess"
"Drew and Red Dawn[r], by Ned Ward"
"Drink Tea, Darn Tike[r], by [if player is male]Nate Dirk[else]Kira Dent[end if]"
"Dripped Did Prep[r], by Pip Redd"
"Drive Any Vineyard[r], by Ervin Day"
"A Drive, Varied[r], by [if player is male]Davide Rivera[else]Deadra Vivier[end if]"
"A Driver Arrived[r], by Vi Rader"
"Drole Ol['] Red, Older Lorde[r], by Dr. Leo Elrod-DeLor"
"Drone by a Boneyard Brayed On[r], by [if player is male]Arne Boyd[else]Robyn Ade[end if]"
"Drone On, Dr. Noone[r], by Ron Oden"
"A Drone-On Read[r], by Dorena Ardone-DeNaro" [r] []
"Drone Thy Threnody[r], by Ron Heydt"
"Drop All, Alp Lord[r], by Droll Pa Pollard" []
"Drowned Oath Down the Road Trodden, Whoa[r], by [if player is male]Donte Howard & Edwardo Noth[else]Dedra Howton[end if]"
"A Drudge, Guarded[r], by Edd Gaur"
"Drugs of Fur Gods[r], by Gus Ford"
"Drunk Jay's Junkyards[r], by Judy Karns"
"Dry Abe, Ye Bard Beardy: a Derby[r], by Deb Ray" []
"Dry AI Diary[r], by Yadir Riady"
"Dry Blood, Body Lord[r], by Rod Dolby"
"Dry Bo, Boy Dr.[r], by Brody O'Byrd" [p]
"Dry Haler Heraldry[r], by Hal Ryder"
"Dry Mouth, Dour Myth[r], by Ruth Mody & Trudy Ohm"
"Dry Mouths['] Dour Myths[r], by [if player is male]Dusty Mohr[else]Trudy Ohms[end if]"
"Dry Nuanced Redundancy Cranny Dude[r], by Darcey Dunn"
"Dry Omens: My So-Nerd Syndrome[r], by Sy Redmon"
"Dry Salon: Old Yarns[r], by Lyn Rodas"
"Dryable Bradley[r], by [if player is male]Al Derby[else]Deb Rayl[end if]"
"Drygate Tragedy[r], by Ted Gray & Gert Day" []
"DTF I.E. Fetid[r], by Eddie Tifft"
"Dubliner, I Blunder[r], by [if player is male]Enid Burl[else]Del Rubin[end if]"
"Dubliners['] Ruins Bled: Sure, Blind Idle Burns[r], by Les Durbin & Sid LeBrun"
"Duc Love Could've[r], by Luc Devo"
"Duck! Real Luck, Dear, Due Clark[r], by Luc Drake"
"Duck This Sick Thud[r], by [if player is male]Dick Hust[else]Kit Dusch[end if]"
"Dud Sap Adds Up[r], by A. Spudd"
"Dude, Lap a Puddle[r], by Edd Paul"
"Due Tents Untested[r], by Tut Sneed"
"A Duffer's Far Feuds[r], by Sade Ruff"
"Duh, Tell the Dull[r], by Ted Hull"
"Dull Maw, Mud Wall[r], by Wm. Udall"
"Dumb as Sad Bum Bud Sam[r], by Bub Massa-Mudd"
"Dumber Ones Numbered So Burdensome[r], by Ruben Demos & Bud Emerson"
"A Dumpy Bro: Bumpy Road[r], by Brody Puma"
"Dunbar's Sad Burn[r], by Brad Sun"
"Dunce Tom's Documents[r], by Comus Dent" []
"The Duos Shouted[r], by [if player is male]Ed South[else]Su Thode[end if]"
"Duper-Oath Up the Road: Proud Hate[r], by [if player is male]Pedro Haut[else]Hope Dutra[end if]" []
"A Duty? Ay, Tut, Ya Dud[r], by Tad Yu"
"Duty: Solve, Study, Love[r], by Stuey Vold"
"A Dweeb: Wee, Bad[r], by Bea Dew & Deb Wea"
"E-Czar Craze[r], by Z. C. Rea"
"E-Divas I Saved[r], by Sad Evi Davies"
"E-Z In Zine[r], by Inez Enzi"
"Each Cashes as He Caches[r], by Chase Aesch"
"Each Get the Cage[r], by Tag Chee & Chet Gea"
"Each in a Niche[r], by Ai Chen"
"Each Inert Nice Heart[r], by Teri Hance" []
"Each Po['] Cheapo[r], by Ace Hop" []
"Each Rad Charade[r], by Arch Dea"
"Each Vet the Cave[r], by Eve Tach"
"Each Wry Why-Care[r], by [if player is male]Ray Chew[else]Cher Way[end if]"
"Eagerly Past a Spry Eaglet[r], by Gayla Peters" []
"An Eagle's Gala Seen[r], by Sean Gale"
"The Ear Heater[r], by Art Hee"
"Earbuds? Bad, Sure[r], by Sue Bard"
"Earl Hit the Lair[r], by Art Ihle" []
"Earliest Ateliers/Realties[r], by [if player is male]Eli Satre[else]Rae Stile[end if]"
"Earliness, Leariness[r], by [if player is male]Neal Reiss[else]Erin Seals[end if]"
"Early Relay Layer[r], by Leyla Rayer"
"Earn Trust? Rare Stunt[r], by Ren Stuart"
"Earringed Grenadier Dearinger[r], by [if player is male]Dan Reiger[else]Erin Edgar[end if]"
"Ears, Sear[r], by Sara Rees" []
"Earth-Clad Cathedral[r], by Tad Lacher"
"Earth is Astir, Eh? Share it[r], by Tia Sher"
"Earth Nite: Hearten it, Henrietta![r] by Rene Hiatt"
"Earwig, Rig Awe[r], by Ewa Weir-Graig"
"Ease, Thrill, Satire, Hell: All There Is[r], by Leslie Hart & Hera Tellis"
"Easier Aeries[r], by Ira See"
"Easily Ye Sail[r], by Alysia Eisley"
"East Wing Wage Snit: a Stewing[r], by [if player is male]Wes Tiang[else]Gwen Tsai[end if]"
"East Wood: Toad's Woe[r], by Wade Soto"
"Eastbed Debates[r], by Tab Dees"
"Eat, Drink, Darn Tike[r], by Kent Adri" []
"Eat Fast at Feast[r], by Asa Fett"
"Eat, Love: To Leave[r], by Eve Toal"
"Eat. Run. A Nut Re: Nature[r], by Ren Tua" []
"Eat, Sing, Set Gain in Stage[r], by Nat Geis" [ic]
"Eat Slop to Lapse[r], by Sal Peto"
"Eat Soup to Pause[r], by Esau Top"
"Eberling's Inselberg[r], by Ben Sigler"
"Ebola: O, Bale[r], by Bo Lea"
"Echo Ire? Cheerio, I Cohere[r], by [if player is male]Reo Eich[else]Cori Hee[end if]"
"Echo Mr. Chrome[r], by Mo Cher"
"Eco-Dust: Due Cost Scouted[r], by Ted Usco"
"Eco-Ship Hospice[r], by Chip Ose" []
"Eco-Vista So Active[r], by [if player is male]Otis Cave[else]Vi Coates[end if]" []
"Ed Has a Shed[r], by De Ash" []
"Ed Has a Shed[r], by Shaheed Das" []
"Ed Hurls Hurdles[r], by Del Rush"
"Ed Ictis, Diciest Deicist[r], by Sid Tice" []
"Ed Napoli's Palinodes[r], by [if player is male]Dale Spino[else]Opal Denis[end if]" []
"Ed Pyle Yelped Deeply[r], by Del Pye"	100
"Ed Wood's Odd Woes[r], by Wes Dodo"
"Ed Writes Weirdest[r], by Stew Reid"
"Ed's Cable Debacles[r], by Seb Cadel"
"Edgar, a Dreg[r], by Gerda Garde" []
"Edrington's Grindstone[r], by [if player is male]Goren Stind[else]Enid Strong[end if]"
"Educations: Ideas Count[r], by [if player is male]Tad Ionescu[else]Candie Tsou[end if]"
"Educing a Guidance[r], by [if player is male]Ice Dugan[else]Inga Duce[end if]" []
"Eel Inn[r], by Lennie Leinen" []
"Eel Jaw: a Jewel[r], by Jae Lew"
"Eelskins['] Likeness[r], by Len Sikes"
"Eeriest Sisters[r], by Tressie Tessier"
"Eeyore's Eyesore[r], by Rose Yee"
"E.G. Think the King[r], by Keith Ng & Ken Gith" []
"E.G. With Weight, the Wig[r], by Gig Thew-White"
"Ego, Crave Coverage[r], by Eva Greco" []
"Ego Lost to Ogles[r], by Loo Gest"
"Ego-Trip Got Ripe[r], by [if player is male]Rog Piet[else]Peg Orti[end if]"
"Egoist-O-Geist: it Goes[r], by Sig Te'o"
"Eh, Al, Heal[r], by Leah Hale" []
"Eh, Blast the Slab[r], by Hal Best" []
"Eh, Go Down When Good[r], by [if player is male]Ogden How[else]Gwen Hood[end if]"
"Eh, Pass, Shapes[r], by Pa Hess" []
"Eh, Sing, Hinges[r], by Shene Higgins"
"Eh, Spout the Soup Up Those[r], by Hue Post"
"Eh, Toby, the Boy[r], by Eb Hoyt" []
"Eh, Toning: Gone Thin[r], by Theo Ginn"
"Ehe, Fibs: His Beef[r], by Bee Fish"
"Eichmann-Men Chain[r], by Mae Chinn"
"Eight Bit? I Be Tight[r], by Gib Hiett"
"Eight Born, One Bright: The Boring[r], by [if player is male]Bert Honig[else]Toni Bergh[end if]" []
"Eight Days: I Get Shady[r], by Ty Sadeghi"
"Eight Years a Geyser Hit[r], by Gertie Hays & Tisha Geery"
"Eisenbarth Hibernates, Breathes In[r], by [if player is male]Ethan Biers[else]Tisha Breen[end if]"
"Either-So Theories[r], by Otis Rhee"
"El Dope Eloped[r], by Del Poe"
"El Paso: a Slope So Pale[r], by Sal Poe"
"Elaborate Oblate Era[r], by [if player is male]Lee Tabora[else]Tora Albee[end if]"
"Elder, I Re-Idle[r], by Deriel Ridlee-Riedle"
"An Elder Learned a Lender[r], by Rand Lee" []
"Electro-Tec Lore[r], by Tre Cole"
"Elegies? Gee, Lies[r], by Giesele E. Seigel"
"Elf Coast Coal Fest[r], by Flo Cates" []
"Elf, Dung-Engulf'd[r], by Del Fung"
"Elf Inge, Fleeing Feeling[r], by Eli Feng"
"Elf Lover Fell Over[r], by Flo Lever"
"Elf Ross, Flosser for Less[r], by Ros Self"
"Elf, Try at Flattery[r], by Lyra Fett"
"Elf Valor: Fall Over[r], by Flo Ravel"
"Elfy, Elfy[r], by Lyle Fyfe"
"Eli's Leis Isle[r], by Isis, Elle & Si Leslie" [x]
"Elite Hank in the Lake[r], by Nat Heikel"
"Elk from Mer-Folk[r], by Flo Kerm"
"Elk I Like[r], by Kelli Ike"
"Elk, Nene, an Ankle, a Kennel[r], by [if player is male]Ken Lane[else]Nan Leek & Ann Klee[end if]"
"Elks Are Leakers[r], by Lee Rask"
"Ella May Lay Lame[r], by Alma Ely"
"Elliot's Lost Lie: So, I Tell[r], by [if player is male]Leo List[else]Lis Leto[end if]"
"Elmdale, Male-Led[r], by Al Medel"
"Else Kim Likes Me[r], by Ike Elms & Mike Les"
"Else Opt to Sleep[r], by Lee Post"
"Elton's Lonest Stolen Ol['] Nest[r], by St. Leon Elston"
"Elysium Isle, Yum![r] by Miles Yu"
"Em Sagna Manages[r], by Sam Egan"
"Em Seger Emerges[r], by Meg Rees"
"Em Smells Mel's Elms[r], by Les Melms"
"Em's Vim Vies[r], by Ms. Evi Vimes"
"Emending a Demeaning Mad Engine[r], by Megan Nied"
"Emigre Regime[r], by Meg Eir"
"Emmi Ard, a Dimmer Mermaid[r], by Dr. Mamie DeMarim"
"Emot-Tome[r], by Moe Motte" []
"Empires['] Premise[r], by Pieper Messimer"
"Enabled-Bed Lane[r], by Lee Band"
"Enact or Care Not[r], by Art Cone"
"Encase A Scene: Can See?[r], by Seneca Ceesan"
"Enclosed Old Scene[r], by Ned Coles"
"End With Dew-Hint[r], by Ned Whit" []
"End With the Wind[r], by Whitten Whidden"
"End Word: Drowned[r], by Don Drew" []
"End's Ark, Snarked, Darkens[r], by Ned Rask"
"Endure Ur-Need, Rue End[r], by Dee Run"
"Enduring Drug Nine[r], by [if player is male]Reid Gunn & Ned Rungi[else]Erin Gund & Geri Dunn[end if]"
"Engrave, Avenger[r], by Gran Eve Van Geer"
"Engrossed Nerds['] Egos[r], by Deren Goss & Don Segers"
"Enhancer Ran Hence[r], by Rene Chan"
"Enigma, I Imagine[r], by Gia Mein"
"Enliven, Reviler[r], by [if player is male]Evil Ren[else]Verline[end if] Leviner"
"Ennuis[r], by Sunnie U. Ennis"
"Enoch's Chosen Noches[r], by Sen-Cho Schoen"
"Enos, Try Tyrone's Tyres On[r], by Rey Snot"
"Enrich: a Reach In[r], by Ira Chen"
"Ensue, Toxic Executions[r], by Tex Cousine" []
"Entrails, Latrines[r], by [if player is male]Neil Rast[else]Ali Stern[end if]"
"Entropies Interpose[r], by [if player is male]Nito Peers[else]Irene Post[end if]"
"Entrustin['] Nutrients[r], by Ennis Rutt"
"Envy Dirk, Very Kind Nervy Kid[r], by Kevin Dry"
"Envy, Envy[r], by Evyn Vyne"
"Envy Erases Seven Years[r], by Venessa Rey"
"Epic Rut Picture[r], by Curt Pei"
"Epidemic: Dim Piece[r], by Cimi Deep" []
"Epigram Primage[r], by Pam Iger & Meg Ripa"
"Epistles on Politeness[r], by [if player is male]Sol Epstein[else]Lise Posten[end if]"
"Equated as Adequates[r], by Tesa Quade"
"Equity Eras['] Quiet Years[r], by Syreeta Qui"
"Er, Meds, Mr. Seed[r], by Dr. Esme Demers"
"Er, Yes, Reesy[r], by Syree Reyes" []
"Era Eight Heritage[r], by Gita Rhee"
"Era End Neared[r], by Randee Deaner"
"Era Ended, Endeared Deadener[r], by [if player is male]Andre Dee[else]Edra Eden[end if]"
"Era from More Far[r], by Raf Rome"
"Erase, Start: Art Teasers[r], by Tresa Tesar"
"Erasing Searing Gainers[r], by Agnes Ri" []
"Erdman's Remands[r], by Ned Mars" []
"Ere a Razz, Raze[r], by Ezra Azer"
"Ere Hearty Year Three[r], by Tyree Hare"
"Ere Shaw Was Here[r], by Wash Ree & Ash Ewer"
"Ere Venom, Even More[r], by Mo Vereen" []
"Erect Crete[r], by CeCe Retter"
"An Erect Cretean[r], by Art Ence"
"Eric Rust, Stu Crier: Crustier Recruits[r], by Curt Ries"
"Eric's Cries[r], by Ricci Esser"
"Eric's Pet Receipts[r], by Cris Peet"
"Erin's J/K Jerkins[r], by Jen Risk"
"Eris, Sire[r], by Siri Rees"
"Erm, Shy Hermy's Rhymes[r], by Em Rhys" []
"Erotic Nudism: Dim Neurotics['] Reductionism[r], by [if player is male]Dominic Suter[else]Cristine Odum[end if]"
"Erotic Rant Retraction[r], by [if player is male]Rico Arnett[else]Nita Rector[end if]"
"Err, Boys? Be Sorry[r], by Bry Rose"
"Err, Dog, Order Red Grog[r], by Rodger Gorder"
"Errant Nate, Rear Tenant[r], by Trena Arent" []
"Errs Get Sterger[r], by Reg Rest"
"Erstwhile Wilts Here[r], by [if player is male]Stew Riehl[else]Teri Welsh[end if]"
"Erupt, [']Puter[r], by Prue Pruett"
"Erupt, Animal Plantearium[r], by Paul Armenti" []
"Erv, I Got Vote-Rig Vertigo[r], by Reg Voit"
"Eskimos: Some Ski[r], by Ike Moss"
"Esotropic Porticoes[r], by [if player is male]Otis Coper[else]Corie Post[end if]"
"Especially Epic Alleys[r], by [if player is male]Ice Lapsley[else]Celia Pyles[end if]" []
"Essric Scries Crises[r], by Crisse Iscser"
"Estimated Dematteis Meditates Admittees[r], by Tami Deets"
"Estrange Grantees, Sergeant[r], by Stan Eger" []
"Et Voil, Violate a Violet[r], by Avi Leto" [x]
"Eternise, Teensier[r], by Teri Nees"
"Ethically, I Yell-Chat[r], by Tacey Hill"
"Ethics Itches[r], by Chessie Titch"	60
"Eton's Onset[r], by Enos Teston"
"Eunuchs['] Cue-Shun[r], by Sue Chun"
"Evaders Ever Sad, Re-Saved[r], by Dav Rees"
"Evanston: Ten Novas, None Vast[r], by Ann Stove"
"Eve Ruins Universe[r], by Sue Ervin"
"Eve's Sandy Seven Days[r], by Syed Evans & Evan Dyess"
"Eve's Silly Ivy[r], by Sylvie Sivley"
"Even for No Fever of Nerve[r], by Von Reef"
"Even Grief Given Free[r], by Vern Feige"
"Even Sty Seventy[r], by Ty Neves"
"Even Swell New Levels[r], by Lew Vensel"
"Ever-Daunt Adventure[r], by Dave Utner" []
"Everlasting Resting Vale[r], by Lester Gavin"
"Every Birth by the River[r], by Ivy Herbert"
"Every Bit Be Verity[r], by [if player is male]Ty Biever[else]Ivy Ebert[end if]"
"Every Step Very Steep[r], by Steve Prey"
"Everything Vying There[r], by Ivy Genther"
"Evident, I Vented[r], by Ted Vine"
"The Evil Hivelet[r], by [if player is male]Lev Heit[else]Eve Hilt[end if]"
"Evil Laws Will Save[r], by [if player is male]Val Lewis[else]Liv Wales[end if]"
"Evil Lord Dolliver[r], by Reid Voll"
"Evil Twins Wilt Vines[r], by Wes Litvin"
"Evildoers So Reviled[r], by [if player is male]Elrod Ives[else]Ilse Dover[end if]"
"The Evils Hit Elves[r], by Les Veith"
"Evita's Vitaes[r], by Ev Tsai"
"Ew, Dorky Keyword[r], by Drew Koy"
"Ew, Reason: Erase Now Saner Woe[r], by [if player is male]Wes Roane[else]Rea Owens[end if]"
"Ew, There's the Sewer: Wet, Sheer[r], by Wes Ereth"
"Eww, Tests[r], by Stew West"
"Exhaustion Hoaxes Unit[r], by Xenia South"
"Exiles: Lexie's Sex Lie[r], by Lee Six"
"Exponential-Polite Annex[r], by Ileen Paxton"
"Expulsed Duplexes[r], by Lex DePus"
"Extra Body: a Try, Boxed[r], by Bart Doxey"
"Eying Foul, Young Life?[r] by Flo Guiney" []
"Fab Foes['] Safe Fob-Off Base[r], by Bo Fefsa"
"Fab Foul Buffalo[r], by Bo Lauff"
"Face North: Each Front, Notch Fear[r], by Nora Fecht" []
"Faced Other Death Force[r], by Fred Choate"
"Factories['] Cafe Riots[r], by Cora Feist"
"Factoring Caring Oft[r], by Gino Craft & Traci Fong"
"Facts is Fascist[r], by Tif Cass"
"Fad-Like, I Flaked[r], by Kia Feld"
"Fade, Story: Day of Rest[r], by [if player is male]Ford Yates[else]Freda Yost[end if]"
"Fads Threw the Dwarfs[r], by Fred Thaws"
"Fail, Done: Final Ode of Denial[r], by [if player is male]Aldo Fine[else]Fae Dolin[end if]"
"Fail-Man Fan Mail[r], by Alf Mina"
"Failures Use Flair? Fie, a Slur[r], by Israel Fu"
"Faint, if Naif Fit, Tiffani[r], by Fifi Tan"
"Fainter Fine Art[r], by Tia Fern"
"The Fair Fear Hit[r], by Tai Fehr"
"A Fairly Glum Gallimaufry[r], by Mally Figura"
"Fairness Sans Fire[r], by Fran Sise"
"Fairy, I Fray[r], by Fifi Ayr-Ray" []
"The Fairy's Fiery Hats[r], by Trish Faye"
"Fake News: Swank Fee[r], by Fawn Eske"
"Fall Down, Wolf Land[r], by Fawn Doll" []
"Fall, Oaf-Pop[r], by Lala Popoff"
"Fallacy? Flay Cal[r], by Alf Clay"
"False Hick Has Fickle Life Hacks[r], by [if player is male]Leach Fisk[else]Shea Flick[end if]"
"False to Lose Fat[r], by Flo East"
"Falsely Inside Elysian Fields[r], by [if player is male]Fidel Sainsley[else]Felisa Lindsey & Delfina Sisley[end if]" []
"Fame, Sin, Famines[r], by Sam Fine"
"Familiar Frail Aim[r], by Alf Amiri" []
"A Family May Fail[r], by Liam Fay"
"Fanciest Snitface[r], by Stef Cain"
"Fancy Old Floyd Can[r], by Flo Candy"
"Fanfic's Naff (Sic)[r], by Nic Saff"
"Fang, Echo of Change[r], by Fae Chong"
"Fanpost of Pants[r], by Pat Fons"
"The Far Father[r], by Heather Traff"
"The Far Father[r], by Teffa Ehrhart" []
"Far Gone Near Fog[r], by Noe Graf" []
"Far Iciest Artifices[r], by [if player is male]Eric Faist[else]Staci Frei[end if]"
"Far-Led Alfred[r], by Fredda Farell" []
"Far Moths, Hats From Shamfort Hot Farms[r], by Sam Forth"
"Far North Front, Rah[r], by Fran Hort"
"Farm So: of Arms for Sam[r], by Mo Sarf"
"Farmhouse Four Shame[r], by Amos Rhufe" []
"Farming Mr. Fagin[r], by Min Graf"
"Farmy Ma Fry[r], by Mr. Fay Afrym"
"Fascinated Antics Fade[r], by Cinda Festa"
"Fast Firm Stiffarm[r], by Tim Sarff"
"Fasties['] Fiestas: [']Tis Safe, Sis. Fate[r], by Tia Fess"
"Fat Fence: an Effect[r], by Cate Neff"
"Fat-I-Vores['] Favorites[r], by Avi Foster" []
"Fat Lord, Old Fart[r], by Flo Dart-Talford" []
"Fat Red's Sad Fret[r], by Stef Ard"
"A Fat Sum, Ma Faust[r], by Atsumfa Mustafa"
"Fated for Trade-Off[r], by Ted Raffo"
"Fated Here The Feared Feathered Draftee, Eh?[r] by Thea Feder"
"A Father's Hat Fears[r], by Rea Shaft"
"Fathom of Math[r], by Mo Haft"
"Fatigued, Due a Gift, I Dug Fate[r], by [ta] Fudge"
"Faulkner's Real Funks[r], by Fran Lukes"
"Faun Felt Affluent[r], by Tula Neff"
"A Favor for Ava[r], by Raf Avo"
"Favorable Brave Olaf, Verbal Oaf[r], by [if player is male]Rob LaFave[else]Bev Alfaro[end if]"
"The Fays['] Hay-Fest as Hefty[r], by Ty Shafe"
"Fear-Taken Neat Freak? Aren't Fake[r], by Kate Fearn"
"Fearing a Finger[r], by Geri Fan" []
"Feast, or Fares to a Forest of Tears[r], by Tre Faso"
"Fed Rumors of Murders[r], by Ford Remus"
"Federal Are Fled[r], by Alfred E. Redleaf" []
"Federals? Dare, Self[r], by Sal Freed"
"Feel, Burn, Fun Rebel[r], by Fern Blue"
"Feel-Rants: A Stern Elf, Left Saner[r], by [if player is male]Lester Fan[else]Fran Steel[end if]"
"Feel That Late Heft[r], by Fat Ethel"
"Feet Fail: I Feel Fat[r], by Elie Taff"
"Feet, Sir? I Fester[r], by Treefis Seifert"
"Feign, Shirk, Fisher King[r], by Rifek Singh"
"Felinity, Finitely[r], by Tiny Leif"
"A Felony's Only Safe[r], by Fay Slone"
"A Feminist, I: Manifest[r], by Mistie Fan"
"Feud Logs of Sludge[r], by Doug Self"
"Feudalism: a Field Sum[r], by Leif Dumas"
"Few LOLs, Fellows[r], by Les Wolf"
"Few Roast for Sweat[r], by Fae Strow"
"Fey Sol Foley's Sly Foe[r], by Les Foy"
"A Fiddle? Add Life[r], by Ida Feld"
"Fie, Dr. Fried[r], by Deidre Riff"
"Fie, Sam, I'm Safe[r], by Effima Massie"
"Fie, Self! Eff Lies[r], by Les Fife"
"Filch a Sword, Cold Raw Fish[r], by [if player is male]Wilford Cash[else]Wilda Frosch[end if]"
"Files of Lie-Offs[r], by Sol Fife"
"Filter No Torn Life[r], by Roe Flint"
"A Filthy Haylift: Thy Fail[r], by Fay Hilt" []
"A Filthy Haylift[r], by Faith Ly" []
"Find [']Er, Red-Fin![r] by Nidiffer Dern & Fred Ni" []
"Fine Lad Elf and I[r], by Alf Dein"
"Fine Light Nightlife[r], by Tif Ehling"
"Fine or on Fire[r], by Ron Fei" []
"Fine Worth For the Win[r], by Owen Firth"
"Finer Fog Offering[r], by Erin Goff"
"Fir at a Rift[r], by Raffi Trita"
"Fir Slope Profiles[r], by Flip Rose"
"Fire Walk Ark? I Flew[r], by Rafe Wilk"
"Firefly Life, Fry[r], by Riff Ely"
"Firmest Me-First[r], by Mr. Feist"
"Firmly to a Formality[r], by Troy Flaim"
"First-Ever Riverfest[r], by Trev Fries"
"First Hand Trash Find[r], by Hans Drift"
"First Lady Flays Dirt[r], by Sly Tardif"
"First on a Strain of Fan Riots[r], by [if player is male]Ian Frost[else]Fran Otis[end if]"
"Fitfulness Stifles Fun[r], by Sen Sutliff" []
"Five Days Ivy Fades[r], by Davis Fye"
"Five Days: Ivy Fades[r], by Davy Seif" []
"Five-Null, Funville[r], by Vi Fullen"
"Flag Ride: Garfield, Fred, Gail[r], by Alf Ridge"
"A Flaky AFK-Lay[r], by Alf Kay"
"Flame or Bid: Formidable[r], by Bo Armfield"
"Flared Rad Elf[r], by Alfred Fardle" []
"Flashiest Fish Tales[r], by Elsa Shift"
"Flashy Shy Alf[r], by Ash Fly"
"Flatter, Tart Elf[r], by Art Felt"
"A Flavor of Larva[r], by Ava Rolf"
"Flee Corn, Florence[r], by Fern Cole" []
"Flee, Win New Life[r], by Lew Fine"
"Flesh Out Soul Heft[r], by Flo Shute"
"The Flicks Hicks Left[r], by Stef Hickl"
"Flier at a Trifle[r], by Art Leif" []
"A Flight-Hit Flag[r], by Gil Haft"
"Floating in to Flag[r], by Lita Fong"
"Floating to a Fling[r], by Gil Afton"
"A Flood, Old Oaf[r], by Alf Odo"
"Floor Nine, One Florin[r], by Lin Onofre"
"Flop Up, Pup Flo[r], by Ulf, Pop of Pulp"
"The Flops: Top Shelf[r], by Flo Speth"
"Flora for Al or Alf[r], by Raffa Rollo"
"Flouters of Luster Left Sour[r], by [if player is male]Leo Furst[else]Lu Foster[end if]"
"Flow Lone, Low Felon[r], by Len Woolf" []
"Flow, My Fan, Off My Lawn[r], by Myna Wolff"
"Flow, Sea of Wales[r], by Sol Efaw" []
"Flower Kid Field Work[r], by Wilfred Ko & Ford Wilke"
"Flowery, or We Fly[r], by Rey Wolf" []
"Flukin['], I Flunk[r], by Lu Fink" []
"Flus, Face a Scuffle[r], by Luce Saff"
"Fly East, Sly Fate[r], by Tay Self"
"Fly on Ere Only Free[r], by Ren Foyle"
"Fly, Rouse Yourself[r], by Rolf Suey" []
"Fold Rank, Darn Folk[r], by Kold Fran Lankford" []
"Folk-Bodies['] Field Books: Fools Biked[r], by Fidel Bosko"
"A Folksy Sky-Foal So Flaky[r], by Fay Klos"
"Follow Me Mo['], Fellow of Mellow[r], by Elmo Wolf"
"Fond Cay Fancy Do[r], by Cody Fan" []
"Fond Gear of Danger[r], by Ford Egan"
"Food/Rest Dose Fort[r], by Ted Roofs & Fred Soto"
"Fool, Cut of Clout[r], by Luc Foot"
"The Fool Left, Oho![r] by Leo Hoft"
"Fool-Spun Spoonful[r], by Flo Ponus"
"Fooling Gilfono-Fogolin[r], by Gino Lof" []
"Foot-Long Goon Loft[r], by Fog Olton"
"Footballs['] Lobs Float[r], by Flo Oblast"
"For a Bed of Bread[r], by Bo Fader"
"For a Meek Fake, More[r], by Moe Kafer"
"For Codes So Forced[r], by Red Fosco"
"For Easy Years of a Serf, Yo[r], by Rose Fay"
"For Hats or Shaft[r], by Ashfort Hofstra" []
"For Lads Sold Far[r], by Sal Ford"
"For-Real Far Lore[r], by Rolf Rea" []
"For Smart Art Forms[r], by Mr. A. Frost"
"For Ye of Rye[r], by Ro Fey"
"Forays of Syra Fray So[r], by Ros Fay"
"Forbear, Far Bore[r], by Reo Farb"
"Forbidden Fib, Droned[r], by Fred Dobin"
"Forbidden Fond Bride[r], by Deb Inford" []
"A Force or Face of Care[r], by Ara Coe-Coffer" []
"Forecasted Defecators[r], by [if player is male]Fred Coates[else]Stacee Ford[end if]"
"Foreign Reign of No Grief[r], by Goferin['] Rio Feng"
"The Form for Them[r], by [if player is male]Tom Fehr[else]Em Forth[end if]"
"A Form of RAM for Ma[r], by Momar Raffo"
"Formal Mr. Olaf[r], by Al From"
"Fort Cay Factory[r], by Fay Cort"
"A Fort of Art[r], by Tara Troffo" []
"Fortunes of Unrest[r], by Ren Fouts"
"Forwardest Afterwords[r], by Ward Foster"
"A Fossil Fails So[r], by [if player is male]Sol Asif[else]Flo Issa[end if]"
"Foul Bind of Dublin[r], by Blondi Fu"
"Foul Dire Fluoride[r], by Lou Fried"
"Foul Dr. Rudolf[r], by Lu Ford"
"Foul Hefts to Shuffle[r], by Lute Shoff"
"Foul Rye: Yule for Your Elf[r], by Lou Frey"
"Foul Sight: Ghoul Fist, Flush it, Go[r], by Gil Fouths" []
"Four Days['] Soda Fury[r], by Rudy Faso" []
"Four Haters: a Fresh Tour After Hours[r], by Tosha Rufer"
"Four-Sided Odd Furies[r], by Sudie Ford"
"Foxhole Hex, Fool![r] by Lex Hoof"
"Fraction a Fanatic or Naif Actor[r], by [if player is male]Fran Caito[else]Cari Afton & Iona Craft[end if]"
"Fractious Scout Fair[r], by Staci Rufo" []
"Fraid [']Ol Florida Alfrido[r], by Ida Rolf" []
"Frame [']Em Far[r], by Raffa Emmer"
"Framing Mr. Fagin[r], by Min Graf"
"Frat House: Fate's Hour[r], by Rhea Fouts"
"Fraud Lots for Adults[r], by Stu Alford"
"Frauleins in Refusal[r], by Luis Fearn"
"A Freak's Ask Fear[r], by Fae Kras"
"Fred, Flu-Ruffled[r], by Red Luff"
"Free Now, Foe Wren?[r] by Oren Few"
"Free Song for Gene's Fen-Ogres[r], by Rose Feng"
"Freeload for Adele[r], by Lea Forde"
"Fresca-Facers['] Farces[r], by Cesare Scarff"
"Fresh Con So French[r], by Fern Ochs"
"A Fresh Pink Sharp Knife[r], by Kip Fansher"
"A Fresh Ton on Fathers[r], by Shane Fort"
"Freshly, O Horsefly[r], by [if player is male]Roy Shelf[else]Flo Hyser[end if]"
"Fret, Guile, Guilt-Free[r], by Gil Fuerte"
"Fret, Pooh: the Proof of Pother[r], by Hope Fort"
"A Friend, Rad, Fine[r], by [i-n] Fred"
"Fringe-be-Fine Berg[r], by Ben Grief"
"Frivolous Fool Virus[r], by Ulf Viroso"
"Frogs['] Denial Signaled for Dragonflies[r], by [if player is male]Alfred Goins[else]Signe Alford[end if]"
"A Front for Nat[r], by Trant Aronoff"
"Frost and Sad Front[r], by Stan Ford"
"Frost Go to Frogs[r], by Ros Fogt"
"Frostieth Fortieths[r], by Theo Frist"
"A Frosty Stay for Frats, Yo[r], by Star Foy"
"A Frown Now Far[r], by Fawn Ro" []
"Fruity Pond of Punditry: Found it? Pry[r], by Toriy Pfund" []
"A Fry-Fray[r], by Fay Farry" []
"Fry Soda for Days, Dry Oafs[r], by Rod Fays & Ford Say"
"A Fun Faun[r], by Nana Fufu"
"Fun Pair's Pun Fairs[r], by 'Nips' Rauf"
"Fun Silence Influences[r], by Lucien Senf"
"The Funk's Heft, Sunk[r], by Kent Fuhs"
"A Funny Nun, Fay[r], by Anny Fu"
"A Fury, Ur-Fay[r], by Ray Fu"
"Gabriel, a Gerbil[r], by Ali Berg"
"Gad, No Rum? Moan, Drug Gourmand[r], by Omar Gund"
"Gad, Soul! Loud Gas[r], by Douglas Salgudo" []
"Gain, Mr.: Arming Ingram[r], by Mr. Nagi" []
"Gain So, Saigon[r], by Isa Ong"
"Gait, Balk, a Big Talk[r], by Gil Kabat"
"A Gal's Hut At Laughs[r], by [if player is male]Asa Gluth[else]Tasha Lug[end if]"
"Galileo's Allies Go[r], by Lois Gale"
"Galileo's Goal: LIES[r], by [if player is male]Sal Logie[else]Lois Gale[end if]"
"Game On, Ego-Man[r], by Mo Egan"
"A Gamed Damage[r], by Meg Ada" []
"Gamers, Bid: Big Dreams[r], by Sam Bridge"
"Games as Massage[r], by Sam Sage"
"The Games Meg Hates[r], by Mats Ghee" []
"Gang, to Gag Not[r], by Og Gant & Nat Ogg"
"Gangnam, Eh? Meh[r], by Meghan Ghanem" []
"Gangs of Fog Sang[r], by GG Fason"
"Gankery: Keg Yarn[r], by Ken Gray"
"Gant's Angst[r], by Stann Stagg"
"Gaol Be a Globe[r], by Gab Leo"
"Garages Are Gags[r], by Asa Gerg" []
"Garbage Bagger A[r], by Abe Garg"
"Garden Home Harmed, Gone[r], by [if player is male]Herman Doge & Ahmed Groen[else]Merna Hodge & Madge Horne[end if]"
"Gardener Garnered Red Anger[r], by [if player is male]Ed Garner[else]Gena Derr[end if]"
"A Garment Mega-Rant? Great, Man[r], by [if player is male]Art Megan[else]Marge Tan[end if]"
"Gas Lost to Slags[r], by Sol Gast"
"Gasfield Gadflies, Flagside[r], by Gil DeFas"
"Gather His High Rates[r], by [if player is male]Garth Sieh[else]Tish Hager[end if]"
"Gathered Dreg-Hate[r], by Garth Dee & Art Hedge" []
"Gay Hunt, Naughty Anythug[r], by Ty Huang"
"A Gay Icon, Coy Again[r], by Gina Cayo"
"Gay Men May Neg[r], by Meg Yan"
"Gear Up a Purge[r], by Peg Rau" []
"Gee, Mass Message[r], by Meg Essa"
"Gee, Rave Veerage[r], by Erv Agee"
"Geek Chart: Get Hacker[r], by Kate Grech"
"Geekiness Sieges Ken[r], by Gene Sikes"
"A Gem, a Gem[r], by Emma Gage"
"A Gem Unto Montague[r], by Meg Auton"
"Gene Saw New Ages[r], by Wes Egan"
"General's Rage Lens[r], by Sal Green"
"A Generic Age, Nicer[r], by Eric Egan-Carnegie" []
"Genes is Genesis, Signees[r], by Essie Ng"
"Gent, I Get In[r], by Nettie Ging"
"Gerald Glared[r], by Argall Dredge" []
"A Germ-Gamer[r], by Gemma Grear"
"Get Ahead. Age. Death[r], by Tad Gahee"
"Get, Annul, Untangle[r], by [if player is male]Glen Tuan[else]Luna Gent[end if]"
"Get Drab: Drat, Beg[r], by Tad Berg"
"Get No Imp to Ping Me[r], by Meg Ponti"
"Get Worse, Wrest Ego[r], by Stew Gore"
"A Ghost Free for the Ages[r], by Tosha Grefe"
"Ghost Mine Hosting Me[r], by Tim Goshen" []
"Giant Gnat, I[r], by Gianni Gatt"
"Gift Fair Graffiti[r], by Gita Riff"
"Gift: Soul of Guilts[r], by Gil Fouts"
"Gig Re-Rises[r], by Sergi Giers" []
"Gigante's Naggiest Gang Site[r], by Gia Tseng"
"Gil, Cease Elegaics['] Legacies[r], by Alec Geis"
"Gil, Shod His Gold[r], by Sid Gohl"
"Gin-Rid, Gird-In, I'd Grin[r], by Ingrid Riding"
"The Gin's Nighest[r], by Si Ghent"
"Gina's in Gas, I Sang[r], by Agnis Gains"
"Giordano's Grandioso Rigadoons[r], by [if player is male]Dario Song[else]Doris Noga[end if]"
"Girl Code? Relic, Dog[r], by Eric Gold"
"Girl, Do a Raid Log[r], by Ira Gold"
"The Girl, Lighter[r], by Reg Hilt"
"Girls of Log Firs[r], by [if player is male]Gil Fors[else]Lis Grof[end if]"
"Give-All Village[r], by [if player is male]Gil Vela[else]Gail Lev[end if]" []
"Give Away a Gay View[r], by Ivy Waage"
"Give Link, Evil King[r], by Kevin Gil"
"Give Shout This Vogue[r], by [if player is male]Hugo Tevis[else]Sue Voight[end if]"
"Give Word: Dreg, I Vow[r], by Drew Vigo"
"Given Peaks, Keep Saving[r], by Spike Ganev"
"The Giver Grieveth[r], by Teri Vegh"
"Glaciers['] Cries Lag[r], by Gil Cesar & Ric Gales"
"Glad Worm, Warm Gold, Mad Growl[r], by Marg Wold"
"Glare of a Golfer: Flare, Go[r], by Alf Gore"
"Gleaming, Aging Elm[r], by Meg Liang"
"Gleamy Gay Elm[r], by Meg Lay"
"Glean Up a Plunge[r], by [if player is male]Paul Eng[else]Lupe Nga[end if]"
"Glee and a Legend Gleaned[r], by Glen Ade-DeLange" []
"Glee and a Legend[r], by [if player is male]Lee Gand[else]Dee Lang[end if]"
"Glee Dan Gleaned[r], by Dee Lang" []
"Glee Lost Now? Get Well Soon[r], by Gwen Sotello"
"Glende's Legends[r], by Les Deng"
"Glib, Bray, Baby Girl[r], by Lyra Gibb"
"Glib Fonder Bold Finger[r], by Gil Benford & Fred Boling" []
"Glib Rote Bilge-Rot[r], by Geri Bolt"
"Glibster Gilbert's Best Girl[r], by Reg Bilst"
"Glide, Gelid[r], by Ed-Gil Lidge"
"Gloater Got Real to Glare[r], by Reo Galt"
"Gloaty Gal-Toy Gay Lot[r], by Ty Lago"
"Glob On No Blog[r], by Oblong Bo Long"
"Globalist Libs Gloat, Bigots All[r], by Bo Stigall"
"Gloominess? Neologisms[r], by [if player is male]Moises Long[else]Signe Olmos[end if]"
"Gloomy Rune Numerology? You Mongrel[r], by Myron Logue" []
"Glow Any Way Long[r], by Ola Gwyn"
"Glowing Long Wig[r], by Gil Wong"
"Glub Day, Ugly Bad Bald Guy[r], by Ladybug Gaby D. Lu"
"Glucose Eco-Slug Cues-Log[r], by Gus Cole"
"A Gnome Mage, On[r], by [if player is male]Mo Egan[else]Meg Noa[end if]"
"A Gnome on Game[r], by Omega Magnone" []
"A Gnomon On Among Goon-Man[r], by Ann Moog"
"Go Anti to Gain[r], by Gio Tan"
"Go Bait a Bigot[r], by Bo Taig"
"Go, Bend, Nod, Beg[r], by [if player is male]Bo Deng[else]Deb Ngo[end if]"
"Go Braid, Big Road[r], by [if player is male]Bo Gradi[else]Ida Borg[end if]"
"Go Bray, Gay Bro[r], by Bo Gary"
"Go Dress So, Dregs[r], by Ed Gross"
"Go Fib to Bigfoot[r], by Bo Goift" []
"Go for it? I Forgot![r] by Rio Fogt"
"Go Green Ere Gong[r], by Greg Eno" []
"Go Jibe, Big Joe[r], by J. Bogie"
"Go Lunar? Languor: a Run Log[r], by [if player is male]Ron Gaul[else]Lora Ngu[end if]"
"Go Make a Gem, OK[r], by Meg Kao"
"Go, Meltin['] Tin Golem[r], by Tig Lemon" []
"Go, Mr. Panic-Comparing[r], by Ringo Camp & Marco Ping"
"Go, Never Overgen[r], by Gov. Rene Von Geer"
"Go Peeking, Keep Going[r], by Peg Koenig"
"Go Pine, Neo-Pig[r], by Pigeon Opie Ng"
"Go Red, Er, Dog[r], by Roger Dodge"
"Go, Retain No Triage, Iron Gate[r], by Gia Toren"
"Go Seed Geodes[r], by Ed Gose"
"Go Sin [']Til Losing It[r], by Otis Ling"
"Go, Stan, Sag Not[r], by Gaston Sontag" []
"Go Stare at Ogres[r], by Art Sego" []
"Go Steady, Aged Toys[r], by Syed Gato"
"Go, Sworn So Wrong[r], by [if player is male]Rog Snow[else]Ros Wong[end if]" []
"Go Unwrap a Grown-Up, Wan Group[r], by Pura Wong"
"Go Wander: a Wronged Red Wagon[r], by Edra Wong"
"Go Win, Mr. I'm-Wrong[r], by Wm. Gorin"
"Go, World, Do Growl[r], by Gord Low"
"Go Yard, Gary, Do[r], by Rod Gay"
"Goable Goal Be a Globe[r], by Bo Gale"
"Goal: Thin Loathing[r], by Inga Holt" []
"Goalies['] Soilage[r], by Ali Gose"
"God-Bane Bondage[r], by [a-b] Gond"
"God Hearts Goatherds[r], by [if player is male]Art Hodges[else]Gerda Tosh[end if]" []
"God's New Dew Song[r], by Sed Wong"
"Godfather Ferg Had To[r], by Edgar Foth"
"Godless Ed's Slog, Glossed[r], by Del Goss"
"Godlike Kid, Ogle[r], by Ike Gold"
"Gods Poach Good Chaps[r], by Pogo Dasch"
"A Godson Soon, Gad[r], by Don Agos"
"Goin['] Back: a Big Conk[r], by Kaci Bong"
"Gol Durn Gun Lord[r], by Dru Long-N'Droglu"	100
"Gold Camel, Call Me God[r], by Madge Coll"
"The Gold Doth Gel[r], by Ted Gohl" []
"Gold, Lead, Odd, Legal[r], by Oleg Ladd"
"A Golden Gal Done[r], by Lea Dong" []
"A Golden Lad Gone[r], by Leo Gand" []
"A Golden Lean God[r], by Ed Logan"
"Golder Lodger Old Reg[r], by Gorrell Dodge"
"Gone Grey? Energy, Go[r], by Greg Oyen"
"Gone Mad on Madge[r], by Dom Egan"
"Gone Musk, Some Gunk[r], by Gus Monke"
"Gone Off on Geoff[r], by Ogo Neff"
"Gone, Rift: to Finger Not Grief[r], by [if player is male]Oren Gift[else]Teri Fong[end if]"
"Good Candy? A Dodgy Con[r], by Dodo Cygan"
"Good Hues Doghouse[r], by Doug Shoe"
"Good Kind God? No, Kid[r], by Dodo King"
"Good Luck Duck Logo[r], by Doug Lock"
"Good News, Owen's Dog[r], by Gen. Woods"
"Good Stuff Doffs Gout[r], by Doug Ffost" []
"Goon Lad on a Gold Gondola[r], by Oda Long"
"Goon Rat Nora Got to Groan[r], by Nat Goor"
"Goose-Who-Goes-Whoo Hoosegow[r], by Geo Woosh"
"The Gore: Go There, Thor, Gee[r], by Tre Hoeg"
"Gory Clone Necrology[r], by [if player is male]Royce Long[else]Lory Gonce[end if]"
"Gory Lit Trilogy[r], by Gil Troy"
"Gosh, [toti], Hog is Not Soothing[r], by Otis Hong" []
"Gosh, a Cue So Gauche[r], by Hugo Case"
"Goshdang Hangdogs[r], by Don Shagg"
"Got Booed to Be Good[r], by Ted Obogo"
"Got Into Tooting[r], by Gino Ott"
"Got Sworn to Wrongs[r], by Rog Towns"
"Goth Inn: NOTHING[r], by Tinnhog Gonnith"
"Goth Split, Light Spot[r], by Phil Gotts"
"Gothism: So Might Smith Go[r], by Tom Gish"
"Gotta Luv Lotta Guv[r], by Tula Vogt"
"Gourmand Gourdman Dru Mango[r], by Dom Ungar" []
"Grade Free Greed, Fear[r], by Freda Eger"
"Grand Jury Jug Ran Dry[r], by Raj Grundy"
"Grand Ol['] Dr. Logan[r], by Arn Gold"
"Grandest Dragnets[r], by Dan Gerst"
"Grandeur Rang Rude[r], by Red Ungar"
"Grandpa's Naps Drag[r], by Dan Grasp"
"A Granny's Nag Yarns[r], by [if player is male]Ryan Gans[else]Ann Grays[end if]"
"Grant's Drum: Sturm, Drang[r], by Dr. Mart Snug"
"The Grass Gets Rash[r], by Ash Gerst"
"Grateful True Flag[r], by Lute Graf"
"Grating Rant-Gig[r], by Nat Rigg"
"Gratuitous August Trio[r], by Stuart Igou & Gaius Trout"
"Gravelines['] Revealings[r], by [if player is male]Elvis Regan[else]Vela Singer[end if]"
"Graven Imp Revamping[r], by Pam Erving"
"Gray Bane: Anger Bay[r], by Gary Bean"
"Gray On, Groany Nag Roy[r], by Og Ryan-Gaynor"
"Gray Suit Guy Astir[r], by Gia Rusty"
"Grayest Stagery[r], by Ty Sager"
"Grayish Hayrigs[r], by Sy Harig"
"Graze, Gazer[r], by Gazza Erger"
"Greasepaint Pageantries[r], by Tegan Arispe"
"Greasing Snaggier Gearings[r], by Greg Sian"
"Great Lie: Regale It[r], by Ali Egert"
"Great Poets['] Egos Patter[r], by [if player is male]Pete Groats[else]Peg Rosetta[end if]"
"Great Power, Raw Protege[r], by Peter Wargo"
"Great Soul Glares Out[r], by Gus Treola"
"Great Sour Surrogate[r], by Roger Tsau"
"Great Wind, Tiger Dawn[r], by Gari Wendt"
"Greed Hit the Ridge[r], by Ted Ehrig"
"Green Day: a Grey End[r], by [if player is male]Reed Yang[else]Dyan Eger[end if]"
"The Green Gent Here[r], by Ren Egeth"
"Green Line: Inner Glee[r], by [if player is male]Glen Einer[else]Renee Ling[end if]"
"Green Sand Endangers Den Ranges[r], by [if player is male]Dan Gesner[else]Ann Gerdes[end if]" []
"Green Shrub? Sneer, Burgh[r], by Rush Bergen-Hunsberger"
"Greene's Reneges[r], by Reg Snee"
"Greg Won't Get Wrong[r], by Gwen Gort"
"A Gremlin's Girl Names[r], by [if player is male]Les Ingram[else]Selma Ring[end if]"
"Grenadiers['] Rereadings[r], by Eden Garris"
"Grey Suit Guy Tries Gutsy Ire[r], by Yuri Gest"
"Greybeard Barry Edge[r], by Edgar Brey & Gerard Bey"
"Grid One, Ignored, Rid, Gone[r], by Don Gier" []
"Grid Seven: Deserving Giver Dens[r], by Red Givens"
"Grid So Disorg[r], by Sir God"
"Gridlock, Dock Girl[r], by Rick Gold"
"Grief: to Forge It[r], by [tt] Ferg"
"Grievance: Care Given[r], by [if player is male]Vance Iger[else]Grace Vine[end if]"
"Grievant Averting[r], by Trev Nagi"
"Grieve, Regive[r], by Vergie V. Geier"
"Grieve, Tot? Get Over It[r], by Vito Egret"
"Grim Col. Mr. Logic[r], by Gil Crom"
"Grim Pest in Springtime[r], by Tim Persing"
"Grim Seat, Magister Stagmire[r], by Meg Raist"
"Grin Such Crushing Rich Guns[r], by Cris Hung"
"Grind-Out-Dung Riot[r], by Trudi Ngo"
"Grip More Grim Rope, Prim Ogre[r], by Meg Pirro"
"Grisham Rags Him[r], by Ash Grim"
"Grit Meant Mattering[r], by Megan Ritt"
"Grit, Rage: a Trigger[r], by Greg Rita"
"Groan or Nag[r], by Goran Rogan"
"Groan, Us: No Sugar or Angus[r], by Rosa Ung"
"Groaners Rang Sore[r], by Ros Regan"
"Groaning Mood? A Good Morning[r], by Maggio Rondon"
"Grodi ID-Org[r], by Dr. Gio Girod"
"Grok Wood? Good Work![r] by Dorko Gow"
"A Grossly Gory Lass Glossary[r], by Roy Glass"
"Group Mind Grim Pound[r], by Ming Prudo"
"Grow as Wars Go[r], by Ros Wag"
"Grow, Trees, Sow Regret[r], by Roger West"
"Grr, I Gets Triggers[r], by Greg Rist"
"Grub, Sweat, Waterbugs[r], by Buster Wag"
"Grubvale Be Vulgar[r], by Val Burge"
"Gruden's Gerunds[r], by Gus Dern" []
"Gruesome Gore Muse[r], by Meg Rouse"
"A Grumpy Pray-Mug[r], by Ray Gump"
"A Grungy Gray Gun[r], by Guy Garn"
"A Grunt's Guts Ran[r], by [if player is male]Art Sung[else]Su Grant[end if]"
"Guacamoles, a Mug, Solace[r], by Lucas Omega"
"Guacamoles Solace a Mug[r], by Lucas Omega"
"The Guards['] Daughters Dug Haters[r], by [if player is male]Garth Deus[else]Ruth Degas[end if]"
"Guider, I Urged[r], by Reiger Duguid"
"The Guild's Idle Thugs[r], by Leigh Dust"
"A Guile Soon Oleaginous[r], by [if player is male]Louis Genoa[else]Sonia Logue[end if]"
"Guilt Jars a Just Girl[r], by Juli Strag"
"Guilty Guy-Lit[r], by Ty Ulig"
"Guindon's Undoings[r], by Gino Sund"
"Gumpish Mugship[r], by Sim Pugh"
"Gun Bled, Bungled[r], by Bud Glen"
"Gun Chats['] Achtungs[r], by Stu Chang"
"Gun if in Fug-Fungi[r], by Ignu Guffin"
"Gunderson's Undersongs[r], by Dunne Gross"
"Guns Sung, Nun Suggs[r], by Guss Gunn"
"Gunsel Leung's Lunges[r], by Su Glen"
"Gunther is Hungriest[r], by [if player is male]Usher Gint[else]Sheri Tung[end if]"
"Gunther Rung the Hurt-Gen[r], by Reg Hunt" []
"A Guru's Augurs[r], by Gus Rau"
"The Gurus Gush True[r], by Gus Ruthe"
"Gus Made a Smudge[r], by Meg Daus"
"Gus Rhett GEts Hurt[r], by Ruth Gest" []
"Gush at a Thug's Guts? HA[r], by Su Gath"
"Gush On, Shogun, Go Shun No Hugs[r], by Su Hong" []
"Gutsy Bo Got Busy[r], by Guy Bost"
"Guys Toil So Guilty[r], by Lis Guyot"
"Gwen, It's Stewing, Went Sig[r], by Wes Ting" []
"Gymnast: My Angst[r], by Sam Gynt"
"Ha, Leftist Eats Filth[r], by Leah Fitts"
"Hack Creed: Read, Check, Reach Deck[r], by Chad Creek"
"Had Wes Washed, He'd Saw We Dash[r], by Ed Shaw"
"A Hag, Mr. Graham[r], by Marg Ha" []
"Hagminster Angersmith Nightmares[r], by [if player is male]Garth Mines[else]Megan Hirst[end if]"
"Hags Edge Eggheads[r], by Gege Dash"
"Hail Met the Mail[r], by Eli Tham"
"Hairline Post-Relationship[r], by [if player is male]Ariel Shipton[else]Lori Stephain[end if]"
"Haiti Stash[r], by Tisha Haist" []
"Hal's Rose: Hassle or Heal Ross?[r] by Sal Shore"
"Halls of Lo-Flash Falls, oh[r], by [if player is male]Sol Half[else]Flo Lash[end if]"
"Hallways Shall Yaw[r], by Ally Shaw" []
"Halogens['] Angles, Oh[r], by Shea Long"
"Hamfatters['] Aftermaths[r], by Matt Shafer & Farah Metts"
"Hamlet, NO! Oh, Mental[r], by Hal Monte"
"Hamlet the Mal At-Helm[r], by Thelma Lathem"
"Handbells Shall Bend[r], by Shel Bland"
"Hang Low, Lawn Hog[r], by Hal Wong"
"Hank Bet the Bank[r], by Ken Bath"
"Happier Hep Pair[r], by Pip Rhea"
"Har, Debt, the Drab Breadth[r], by Herb-Tad Bethard" []
"Harasser, Eh? Rah, Hearses[r], by Shera Asher"
"Hard Case Charades[r], by Ed Raasch & Chas Ader"
"Hard Knocks Dock Shrank[r], by Chad Kronsk"
"Hard News, Swan Herd[r], by Hans Drew"
"Hard Time Had Merit[r], by Tami Herd"
"Hard Times, Tired Sham[r], by Edra Smith"
"Hard to be Hot Bread[r], by Ed Hobart"
"Hard Wits Draw This[r], by Sid Warth"
"Hard-Won Word: Nah[r], by Rod Hawn"
"Hardcastle Cathedrals[r], by Chad Slater"
"Hardcore Vs. Hardcovers[r], by Dave Schorr"
"Hardlines Herald Sin[r], by Al Dishner"
"Hare, Owl or Whale[r], by Hal Rowe"
"Hark, Test: Up, Speak Truth[r], by [if player is male]Rhett Supak[else]Pett Hruska[end if]"
"Harm at Ham Art[r], by Martha Athram"
"Harm One Menorah[r], by Ron Hame"
"Harp Twice: Epic Wrath[r], by Chip Ewart"
"A Harried Idea? Harr[r], by Ira Heard"
"Hassinger's Garishness[r], by Nash Greiss"
"Haste, Get the Gates[r], by Etta Hegs"
"Hasten, Athens Thanes[r], by Nathan Sheets" []
"Hatch Our Roach Hut[r], by Thora Chu & Cora Huth"
"Hate Mail: a Lame Hit[r], by Leia Math"
"Hate Not That One[r], by Theo Tan"
"Hate Psalm: Me, Asphalt, the Plasma Heat Lamps[r], by Seth Palma"
"Hated Death: Add the Heat[r], by 'Teeth' Hadad" []
"Hateful Leaf Hut[r], by Fleta Hu & Fae Thul"
"Haters-Tip Therapist[r], by [if player is male]Rhett Pais[else]Rhea Pitts[end if]"
"Hauling Laughin['][r], by Lang Hui"
"Hauteurs: Use a Hurt[r], by Su Huerta"
"Have Mercy, Rhyme Cave[r], by [if player is male]Avery Mech[else]Rhee McVay[end if]"
"Haw, Tell the Wall[r], by Walt Leh"
"Haw, Yet: the Way Ye Thaw[r], by Ty Weah"
"Hay Among Mahogany[r], by Gay Homan"
"Hay Fest: Shy Fate[r], by Seth Fay"
"Hazy Car, Zachary[r], by Chaz Ray" []
"He Abets the Base[r], by Bee Tash" []
"He Ails? Ah, Lies[r], by Elisha & Sheila Hailes"
"He Baits the Bias[r], by [if player is male]Seth Bai[else]Abi Tesh[end if]"
"He, Born on Herb[r], by Hebron Bohner"
"He Can't Go to Change[r], by Echo Gant" []
"He Carts the Scar[r], by Tre Asch"
"He Lacks Le Shack-Shackle[r], by Sal Heck-Schalke" []
"He Lures Ur-Heels[r], by Lee Rush"
"He Melts Helmets[r], by Mel Tesh"
"He Mutes the Muse[r], by Su Theme"
"He Revolts the Lovers[r], by Sol Everth"
"He Rocks Chokers[r], by Ros Heck"
"He Said I, Shade[r], by Di Ashe"
"He Talked: a Hated Leak[r], by Kate Dahle"
"He Tames Math: See the Same[r], by Semetha Teesham" []
"He Trumps Thumpers[r], by Seth Rump"
"He Wards a Shrewd Rash Dew[r], by Drew Ash"
"He Won't Be On the Web[r], by Beth Owen"
"He'd Got the Dog[r], by Ted Goh" []
"He'll Bat the Ball[r], by Bet Hall"
"He's All a Shell[r], by Hal Les"
"He's Past the Asps: Ah, Pests[r], by Pat Hess"
"He's Past the Pass[r], by Pat Hess"
"He's Up to the Soup[r], by Stu Hope" []
"Head, Heart Heard Heat[r], by Edra Heath" []
"Head in the Hi-Hate Den[r], by Enid Heath"
"Heal Oft the Foal[r], by [if player is male]Leo Haft[else]Fae Holt[end if]"
"HeapsCo Poaches Cheapos[r], by Chas Poe"
"Hear Not Another[r], by Theo Arn" []
"Hear Out Thoreau[r], by Art Houe" []
"Hear Yet: They Are Ye Earth[r], by Tera Hey" []
"Heartbreak: a Rehab Trek[r], by Bertha Aker & Kate Harber"
"Hearts Rest, Ah[r], by Thersa Sather-Hearst" []
"Heat Waves Have Sweat: Avast, Whee[r], by Veta Hawes"
"Heating an Eight: the Gain[r], by Gia Neth" []
"Heaven, Sin as Nineveh[r], by [if player is male]Evan Hines[else]Iva Hensen[end if]"
"Heavy Metal, Leave a Myth[r], by [if player is male]Hamlet Avey[else]Melva Athey[end if]"
"Heavy Rains Year, Vanish[r], by [if player is male]Harvey Sina[else]Ivana Hyser[end if]"
"Heavy Rains Year, Vanish[r], by Avisa Henry"
"Hecate's Scathee Ceaseth[r], by Cath See" []
"Heck, a Bold Blockhead[r], by Chad Kolbe"
"Heck, Flout: Luck of the Chute Folk[r], by Luke Focht"
"Heel, Bust the Blues[r], by Su Bethel"
"Heft-Sunk Hunk Fest[r], by Seth Funk"
"Heisted: the Side He Edits[r], by Ed Theis"
"Hell Bent, Then, Bell[r], by Nell Beth"
"Hell Hit the Hill[r], by H. L. Thiel"
"A Hell Town on the Wall, Now Lethal[r], by Nell Howat"
"Hellacious Allies, Ouch[r], by [if player is male]Lucio Shale[else]Luisa Loche[end if]"
"Help Plug the Gut[r], by Peg Thul" []
"Hen Clan Channel[r], by Len Chan"
"Henna, Ashes[r], by Shane Hanes"	60
"Hep Tod: He'd Top the Pod[r], by Ted Pho"
"Her Eerie Hiss[r], by Sherie Heiser"
"Her Fad: Six Hard Fixes[r], by Dax Fisher"
"Her Fate: the Fear-Free Hat Feather[r], by Fee Hart"
"Her Koran to North Korea[r], by [if player is male]Arron Thoke[else]Kera Horton[end if]"
"Her Lute: the Lure[r], by Ruth Lee"
"Her Main Hammerin['] Hernia[r], by Hermina Amrhein"
"Her Note: Oh, Enter Not Here[r], by Theo Ren"
"Her Own Plot: On the Prowl[r], by Pohl Wroten"
"Her Pact: The [crap-u] Chapter[r], by [if player is male]Chet Arp[else]Pat Cher[end if]"
"Her Plans: Shrapnel[r], by Len Sharp" []
"Her Sir: His Err[r], by Sherri Shirer-Risher"
"Her Son: Sneer Shorn, Oh[r], by Sheron Hosner"
"Her Test Tethers the Rest[r], by Seth Ert" []
"Herald Not Hotel Rand-Thorndale[r], by Art Holden" []
"Herald to Old Earth[r], by [if player is male]Rod Lathe[else]Edra Holt[end if]"
"Herb Neglect[r], by Engelbrecht Lechtenberg"
"Herbalist Earth's-Lib is Blather[r], by Brit Saleh" []
"Herbert, a Breather[r], by Bart Rhee"
"A Herd to the Road[r], by Dr. Oathe" []
"Herds Into North Side[r], by Denis Hort"
"Here Acts the Scare[r], by Cher East" []
"Here as a Sheer Hearse[r], by Rea Esh" []
"Here Cuts the Curse, Uh, Secret[r], by Ester Chu" []
"Here I Got Their Ego[r], by Gertie Ho"
"Here's to the Rose[r], by Ester Ho" []
"Heretic for Free to Rich[r], by [if player is male]Chet Fierro[else]Cheri Forte[end if]"
"Heritage's Sheer Gait[r], by Trisha Gee"
"Hermit, Atone Another Time[r], by [if player is male]Theo Reitman[else]Ettie Harmon[end if]"
"Hero Bird, Be Horrid[r], by Herb Rodi"
"Hero Bit: I Bother[r], by Herb Ito"
"A Hero Era, Ho![r], by Rhoea O'Hare"
"Hero, List Her Toils to Relish[r], by [if player is male]Eli Short[else]Lori Tesh[end if]"
"Hero Man Mo Ahern Ran Home[r], by Em Horan" []
"Hero-Still Hollister[r], by [if player is male]Ellis Roth[else]Tori Shell[end if]"
"Hero Stu, the Sour Shouter[r], by [if player is male]Theo Rus[else]Ruth Ose[end if]"
"Hero Tamed: More Death, Mate Herod[r], by Mateo Herd"
"Hex Curt: The Crux[r], by Rex Tuch"
"Hey, Beast By the Sea[r], by Tesha Bey"
"Hey, Intro the Irony in Theory[r], by [if player is male]Roy Thein[else]Erin Hoyt[end if]" []
"Hey Mac My Ache[r], by Amy Che"
"Hey, Walt, Why Late[r], by Al Whyte-Wheatly" []
"A Hi-Lung Laugh-In[r], by [if player is male]Ali Hung[else]Inga Uhl[end if]" []
"Hi, Plant a Plinth[r], by [if player is male]Nat Phil[else]Lin Phat[end if]"
"Hi-Tech's Hitches[r], by Chet Shi"
"Hibernating, Breathing In[r], by Annie Bright"
"Hicks to Thickos: O, Shtick[r], by Kit Cosh"
"Hid Cal, a Child[r], by Chad Li"
"A Hiding Hid Gain[r], by Di Hagin & Gia Hind"
"High-Class Sigh-Clash[r], by Chas Sligh"
"Hilbert's Blithers[r], by Bert Lish"
"Hilda, a Dahlia[r], by Ida Ahl"
"Hindered, Rehidden[r], by Reed Dinh"
"Hint, Beg: Night Be Big Then[r], by Beth Ing"
"Hint, D-Bag: Bad Night[r], by Thad Bing"
"Hip Farce: a Cheap Fair[r], by Rafi Peach"
"His Angst Has Sting: Sit, Gnash[r], by Stan Gish"
"His Belly, Shy Libel[r], by Lyle Bish"
"His Blood Holds Bio[r], by [if player is male]Odis Bohl[else]Lido Bosh[end if]"
"His Blue Helibus[r], by Eli Bush"
"His Clang-Clashing Clings, Ah[r], by Lis Chang, Chas Ling, Cal Singh & Sal Ching"
"His Code: So Chide Disco, Eh[r], by Desi Cho"
"His Dance: Echidnas Cashed In[r], by [if player is male]Deac Shin[else]Dina Esch[end if]"
"His Fat Faiths[r], by Fifi Hass-Hatt" []
"His Finer Finisher[r], by Erin Fish"
"His Name, Mean-Ish in Shame[r], by Mia Shen"
"His Patent: in the Past[r], by Shane Pitt" []
"His Robot: Short Bio[r], by Tori Bosh"
"His Safer Far Shies[r], by Ash Fries"
"His Spam Mishaps[r], by Hap Sims"
"His to Hoist[r], by Ishio Shott" []
"History of Fishy Root[r], by Io Forsyth & Sofyi Hort"
"Hit Knot to Think[r], by Nik Toth"
"A Hit[r], by [ta] Haith"
"Hitler's a Real [s-w][r], by [if player is male]Seth Rail[else]Ilse Hart[end if]" [x]
"Ho, Nigh on High Noon[r], by Nino Hogh"
"Hobert's Bothers[r], by Rob Tesh" []
"Hobo Rey, Boy Hero[r], by Herb Yoo"
"Hold Back, Bold Hack[r], by Chad Kolb"
"Hold Breath, Bold Hearth[r], by [if player is male]Beth Harold[else]Hobert Dahl[end if]"
"Hold Fast Old Shaft[r], by Thad Flos"
"Holy Gap to Pathology[r], by Hoyt Gopal" []
"Home Strife Smit Hereof[r], by [if player is male]Tim Forshee[else]Mei Forseth[end if]"
"Home, Twig, Go With Me[r], by Moe Wight"
"Homeowners When Morose[r], by Owen Mosher"
"Hone Fins, Neon Fish[r], by Shon Fine"
"Hone Vast Havens to Have-Nots[r], by Noah Vest"
"Honest Prude, Proudest Hen[r], by Peter Hudson"
"Honorable Hobo, Learn[r], by Noah Roble"
"Honorin['] No Rhino[r], by Noni Roh"
"A Hooch Career[r], by Horace Roache" []
"Hooker, OK Hero[r], by H. Rooke"
"Hooray or Ahoy[r], by Roy Hao"
"Hoorays So Hoary[r], by Rosa Hoy"
"Hope Mill, Poem Hill, Philomel[r], by Emil Pohl"
"Hopelessness Lessons, Sheep[r], by Sponsel Hesse"
"Hordes to the Doors: Short Ode[r], by [d-t] Shore"
"Hormone, Honor Me[r], by Moe Horn"
"Horncastle-Charleston Scholar Net[r], by Lance Short" []
"Hornstein's Thorniness[r], by Nestor Shin"
"Horridest Herd Riots[r], by [if player is male]Reid Short[else]Tish Doerr[end if]" []
"Horsewomen, Homeowners[r], by Omer Hewson" []
"Host Lawyer Aylesworth[r], by [if player is male]Hoyt Rawles[else]Tesha Lowry[end if]" []
"Hostel of the Fools['] Elf-Hoots[r], by Sol Hoeft" []
"Hot Crew: We Torch The Crow[r], by Tre Chow"
"Hot Edy's Shy Dote[r], by Des Hoyt"
"Hot Fear of Earth[r], by [if player is male]Art Hofe[else]Fae Hort[end if]" []
"Hot Nine: In On the Neon Hit[r], by Theo Nin"
"Hot Rene: Thereon Not Here[r], by Thor Nee" []
"Hot Sulfur So Hurtful[r], by Rufus Holt"
"Hot Tea: the Tao[r], by Tate Ho"
"Hotspur Up Short[r], by Su Thorp"
"Hovel Ten, Then Love: the Novel[r], by Neel Voth"
"Hovering Over Nigh[r], by Ervin Goh"
"How Guys Go Why Us?[r] by Gus Yhow"
"How I Feel: Whole, Fie![r], by Leif Howe"
"How I Met With Moe[r], by Tom Hwei"
"Howard's Rad Show: Ah, Words, Raw Dosh[r], by Rod Shaw" []
"Howl-Clue? Well, Ouch[r], by Lou Welch"
"Howls Due: She Would, We Should[r], by Welsh Duo Huw DeLos & Su DeWohl"
"Howry St., Why Sort Thy Rows[r], by Hy Worst"
"Huamnist: Must I? Nah[r], by [if player is male]Tim Shaun[else]Sami Hunt & Una Smith[end if]"
"The Hub's Best, Huh[r], by Beth Shu"
"Hudson Hound's Unshod[r], by Don Hsu" []
"Hues From a Farm House[r], by Amos Frueh"
"Huge Bios, Big House[r], by Hugo Seib"
"Hugest Hug Set[r], by Seth Gu"
"Huggable? Beg, Laugh[r], by Gage Buhl"
"Hugo's Greed: Rough Edges[r], by Doug Gehres"
"Hunk Fest Stunk, Feh[r], by Seth Funk"
"Huns['] Wet New Huts[r], by Wes Hunt"
"Huntress Shunters[r], by Russ Neth"
"Hup, Lord Rudolph[r], by Dru Pohl"
"Hurons or Huns Rush On[r], by Ron Shu"
"Hurricanes['] Ruin-Search[r], by [if player is male]Nash Currie[else]Chris Rauen[end if]"
"Hurt, I Go it Rough[r], by Rui Goth" []
"A Hurt Rut, Ah[r], by Art Hu"
"Hush, Riot This Hour?[r] by Thor Shui"
"Hustling Sunlight: Lust Nigh[r], by Gus Nilth"
"Hut Clan at Lunch[r], by Luc Tanh"
"Hut-Fort of Truth[r], by Ruth Oft" []
"Hyenas Nae Shy[r], by Shayne Haynes" []
"A Hymn, a Hymn[r], by Mynah Hyman"
"Hypatia: I, Apathy[r], by Pati Hay"
"Hyperbole Helper Boy[r], by [if player is male]Lee Brophy[else]Beryl Hope[end if]"
"Hypocrites['] Icy Pothers[r], by Cristy Hope"
"I, a Husk: Haikus[r], by Suki Ha & Su Haik"
"I, a Lass, Assail[r], by Alissa Salais"
"I, a Mentor to Remain[r], by [if player is male]Ira Monet[else]Trina Moe[end if]"
"I, a Mopy Myopia[r], by Pia Moy"
"I, a Pier, Spears: I Spare a Spire[r], by Persia Sapier"
"I, a Raconteur? Au Contraire[r], by [if player is male]Arturo Caine[else]Torrie Acuna[end if]"
"I, a Soul, Louisa[r], by Ola Sui"
"I: Agnes Gaines[r], by Gia Sen"
"I Am Grainy, Imaginary[r], by [if player is male]Gary Amini[else]Maria Ying[end if]"
"I Am Hound-Humanoid[r], by Damon Hui"
"I and Sly Lindsay[r], by Sandy Li"
"I Aptly Play It[r], by Tal Yip"
"I, As Then, in Haste[r], by [i-n] Tesh" []
"I, Aviva, Via Avi[r], by Vi Avia"
"I Ban to Obtain[r], by Bo Tian"
"I Bash No Ions, Bah[r], by Siobhan Hobains"
"I Be Art: Bear It[r], by Bettie Ibarra" []
"I Better Be Trite[r], by Bret Eit & Bertie T"
"I Blame. Bail Me[r], by Mel Iba"
"I Blaze the Bite, Hazel[r], by Elizabeth Thiel-Baez"
"I Boast, Bait So at Bios to Bias[r], by Bo Asti" []
"I Brush Hubris[r], by Bub Hirsh-Ruis"
"I, Cad, Acid[r], by Cid Dacia"
"I Came to Omit Ace[r], by Tami Coe"
"I, Camera, America[r], by Mia Crae"
"I Can Feed Defiance[r], by Candi Fee"
"I-Can-Gro Organic[r], by Ron Gaci" []
"I Cannot Contain Con Tina[r], by Ann Coit" []
"I Censor Cronies So Nicer[r], by Ric Enos" []
"I, Choker, Hock Ire[r], by Erik Cho"
"I Clear Claire: a Relic[r], by Al Rice"
"I, Clovis, So Civil[r], by Vi Lisco"
"I, Cohort Too Rich[r], by Tori Cho"
"I Commit to Mimic[r], by Tim Cimo"
"I Could Be Bio-Clued[r], by [if player is male]Del Bucio[else]Luci Bode[end if]"
"I, Coveting Cognitive[r], by Voigt Ince"
"I Credit No Direction[r], by Reid Conti"
"I Damn a Mind[r], by Mandi Damin" []
"I, Dapper, Prepaid[r], by Pip Ader"
"I Decry Dry Ice[r], by Cy Reid"
"I Defer Free ID[r], by Ed Frei"
"I Denote One Diet: I Need To[r], by [toti] Dee"
"I Deny St. Ed's Tiny Dine-Sty Destiny[r], by Edy Nist"
"I Deny Ye Din[r], by Ed Yin"
"I, Dismal, Mislaid[r], by Ida Slim"
"I Dock at it, OK, Cad[r], by Doc Kati & Cid Kato"
"I, Doctor Cid Toro[r], by [tt] Cord & [d-t] Rico"
"I Don't Care: a Doctrine (Acrid Note)[r], by [if player is male]Reid Caton[else]Tia Codner[end if]" []
"I Dote to Die[r], by Ed Ito" []
"I, Dourest Outsider[r], by Rude Otis & Sid Toure" []
"I, Dr. Ben Drebin: Inbred[r], by Didi B. Brenner"
"I, Dr. Ted, Reddit[r], by Ed Dirt"
"I, Dr. Uncle, Includer[r], by [if player is male]Eric Lund[else]Luci Dern[end if]"
"I Drag a Grid[r], by Dr. Gia Gardi"
"I Drag On, Adoring[r], by Ian Gord" []
"I, Dreg Man, Dreaming[r], by Amir Deng" []
"I Drew Wider[r], by Dr. Wei Dwire" []
"I Drown, Dr. Wino[r], by Wrondi Dorwin" []
"I, Dullest Duellist, Lust Idle[r], by [if player is male]Sid Tuell[else]Lu Tisdel[end if]"
"I. E. Scrimp Empirics[r], by Sim Price"
"I. E. Space is Peace[r], by [if player is male]Ace Sipe[else]Pei Case[end if]"
"I Eat Ramen, Reanimate[r], by Art Meanie"
"I, Emma, a Mime[r], by Mamie Emami"
"I, Empty: Pity Me[r], by Tim Pye"
"I, Ever Plus Repulsive[r], by Lupe Revis"
"I Fab a Fib[r], by Fifi Baab"
"I Fan a Fin[r], by Nina Faif"
"I, Fan, Naif[r], by Fina Fain" []
"I, Farm-Fed, Affirmed[r], by Riff Dame"
"I Fund to Find Out[r], by [d-t] Funi"
"I Gain Sin: Insignia[r], by Nina Gisi & Gia Innis"
"I-Garble Gabriel[r], by Gil Baer"
"I Gloat to Gail[r], by Io Galt"
"I Go Rage, Georgia[r], by [if player is male]Arie Ogg[else]Gia Gore-Areggio[end if]" []
"I, Gogol, Gigolo[r], by Gil Goo"
"I Govern No Giver[r], by Geri Von Revigno"
"I Grab the Big Heart[r], by Beth Gari"
"I Grade a Dirge[r], by Red Gia"
"I, Grave, a Giver[r], by Virgie Vegara"
"I Guard Rad GUI[r], by Giraud Rigaud"
"I, Gwen Ewing[r], by Ewen Wiggin"
"I Hang in, Gah[r], by Anghi Hanig-Hagin"
"I Harp, a Pariah[r], by Ara Phi"
"I Hate the AI[r], by Athie Heita"
"I Haunt in a Hut[r], by Nat Hui"
"I Heart the Air[r], by Tahari Ethier"
"I, Horseman, Mishear No Harmonies[r], by [if player is male]Amos Rhine[else]Shona Irem[end if]"
"I Interact: Nice Trait[r], by Intricate Traci Tien"
"I, Justice, Juiciest Jesuitic[r], by Ice Tsuji"
"I Knew it's Twinkies[r], by Niki West"
"I Know the Think-Woe[r], by Theo Wink"
"I Know to Win Took No Wit, OK[r], by Toi Kwon"
"I Label a Libel[r], by Al Beil" []
"I, Late to a Toilet[r], by Lea Tito"
"I Lawyer Wearily[r], by [if player is male]Wary Eli[else]Aly Weir[end if]"
"I Lay Aily[r], by Ilya Y. Ali"
"I Learn, Linear, in Real[r], by Arline Lanier"
"I Led, Idle[r], by Edie Dill"
"I, Let So to Lies[r], by Ossie Elliott"
"I Loan Ol['] Ian a Lion[r], by Ilona O'Lain"
"I Lower, We Roil[r], by Lew Rio"
"I, Lynnea, Inanely[r], by [if player is male]Neal Yin[else]Lani Ney[end if]"
"I Manage an Image[r], by Gia Eman"
"I Matter at Merit[r], by Teri Tam"
"I Mature: Um, a Rite[r], by Amir Ute"
"I May Hunt Humanity[r], by Tami Hyun" []
"I Meant to Omit a Net[r], by Moni Tate"
"I Mentor on Merit[r], by [if player is male]Tim Reno[else]Erin Tom[end if]"
"I Mock Ick Mo['][r], by Micko Komic"
"I, Mongol in Gloom[r], by Gino Mol"
"I, Monomania[r], by Naomi Miano"
"I Mope, Lost, Too Simple[r], by [if player is male]Tim Spoole[else]Pet Loomis[end if]"
"I Mosh Him So[r], by Sim Ho"
"I, Mr. Galore Rigmarole[r], by Roger Lima" []
"I Must Bed Dumb Ties[r], by Tim DeBus"
"I Must Near a Terminus[r], by Sue Martin"
"I: My Angst May Sting[r], by Misty Nga"
"I: My Trial, Military[r], by Mia Tyril"
"I Nab a Bin[r], by Abbi Nain"
"I, Named Maiden[r], by Mandie Medina" []
"I Nap in, Pa[r], by Nina Paip"
"I, Nervous Sour Vein[r], by Venus Rio"
"I, Norma Maroni[r], by Mr. Iona Romain" []
"I, Novice In Voice[r], by Vi Cione"
"I, Nuts for No Fruits[r], by Su Fortin"
"I of Scant Factions[r], by Fina Scot"
"I, Old Lilo, Dido[r], by Iolo Dild"
"I, on Soap: a Poison[r], by Sonia Po"
"I Once Had a Chide On[r], by Dinah Coe"
"I Oscillate Localities[r], by [if player is male]Elliot Sica[else]Tillie Caso[end if]"
"I, Pampered: Pipe Dream[r], by Mei Eppard"
"I Pan Pain[r], by Nina Paip" []
"I, Pandora, Paranoid[r], by Dino Paar"
"I Part: a Trip[r], by Patti Parri"
"I Patch it, Chap[r], by Pat Chi" []
"I, Pent, Inept[r], by Pennie Pitt"
"I Plot Years: Epistolary Teary Spoil[r], by [if player is male]Otis Player[else]Rosita Pyle[end if]"
"I, Pregnant, Parenting[r], by Trina Peng & Grant Pine"
"I Racket, Tackier[r], by Kit Cera"
"I, Raimond DiMarino[r], by Mai Rodin"
"I Ran At a Train[r], by Art Ian & Ira Tan"
"I Rang a Grin[r], by Graig Nairn"
"I Rank a Rink[r], by Karin Arkin"
"I Rant in Art[r], by Trina Narti" []
"I, Rarer Barbie[r], by Barrie Ribera"
"I Re-Hatch the Chair[r], by Ari Hecht"
"I Re-Stand, Strained[r], by Ned Raist"
"I Reek, I Reek[r], by Kiree Eiker"
"I Remand a Minder, Name-Rid: Drain Me, [d-word-u] Ire and Mire[r], by Near-Dim Merinda" [x]
"I Renew New Ire[r], by Wernie Weiner & Ren Wei"
"I Retain a Tinier Inertia[r], by Tia-Erin Aritine"
"I Retract a Critter[r], by Art Trice"
"I Revised, Derisive[r], by [if player is male]Vi Seider[else]Si Verdie[end if]"
"I Roam or Aim[r], by Moira Raimo" []
"I Robbed Debb Rio[r], by Bob Reid"
"I, Romantic Mortician[r], by Tim Caroni"
"I, Rudest Studier[r], by Sid True" []
"I Run Close, Cornelius[r], by Luci Rosen"
"I Say, Old Daisy, Lo[r], by Lois Day"
"I-Scam-Gain Magicians[r], by [if player is male]Isaac Ming[else]Inga Masci[end if]" []
"I, Seaman: Amnesia, Anemias[r], by Mia Sean" []
"I Sear Aries[r], by Saira Reise" []
"I Search Cashier Cahiers[r], by Eric Ash"
"I Seen Sin, Ee[r], by Niese Eisen"
"I, Self Files[r], by Fifi Lessel"
"I Send in Des[r], by Sindi Edens"
"I, Serving Grievins[r], by [if player is male]Vern Gisi[else]Vi Singer[end if]"
"I Sew, Wise[r], by Wei Weiss" []
"I Shag: a Sigh[r], by Aisha Higgs"
"I Shake a Sheik[r], by Keisha Haskie"
"I Shape APIs, Eh?[r] by Si Heap"
"I Share a Shire[r], by [if player is male]Isiah Shearer[else]Sherrie Sahia[end if]" []
"I Share No Nose Hair[r], by Rio Hanes"
"I, Skanky Yakkins[r], by Nik Kasy & Kain Sky"
"I Sketch the Sick[r], by Tish Eck"
"I, Sky Den, Kidneys[r], by Nik Syed"
"I Slam Mails[r], by Sam Li" []
"I, Slayer of Lies, Foray[r], by Risa Foley"
"I, Sleek Selkie[r], by Ike Les" []
"I, Sleek Selkie[r], by Kelsie Lieske"
"I, Smiler, Slimier[r], by Mel Risi"
"I Snag a Sign[r], by Ana Siggins"
"I Sneak Sea Ink, a Skein[r], by Si Kane"
"I, Snide, Inside Indies[r], by Si Dein"
"I, Snider Insider[r], by [if player is male]Ned Iris[else]Di Rines[end if]"
"I, Snidest, Insisted: Tidiness[r], by [if player is male]Sid Stein[else]Isis Dent[end if]"
"I, Snug, Using GUI, Guns, Sin[r], by Gigi Sunnus" []
"I, Soccer: Cicero's Co-Cries[r], by Ceci Ros"
"I, Sooner Erosion? No, Rosie[r], by Enos Rio"
"I Source Sour Ice[r], by Sue Rico"
"I Spanked Ken's Paid Kid Aspen[r], by Skip Dean"
"I Spared a Paradise[r], by Asa Pride" []
"I Sparked Side-Park Dark Pies[r], by Sid Repka"
"I Stand and Sit[r], by Tan Sid" []
"I Stare: Ires at Satire[r], by Terisa Serita" []
"I Stared at Rides[r], by Art Dies, Ed Raist & Red Tsai" []
"I Stole: Lies to Lose It[r], by Leotis O'Steil" []
"I Strew Wriest Writes[r], by T. R. Wise"
"I, Surgeon or Genius[r], by Siu Rogen"
"I Take a Kite[r], by Katie Keita"
"I Tangle: Glean It[r], by Eli Tang" []
"I Teach AI Tech[r], by Cathie Ecthia" []
"I Tempt Pet Tim[r], by Em Pitt"
"I, the Talk, Like That[r], by Hal Keitt"
"I, to Gulf of Guilt[r] by Lou Gift"
"I, To Queer Erotique[r], by Teo Quire"
"I, Top Fan of Paint[r], by Pat Fino"
"I Treat: a Trite Attire[r], by Tatia Reitter"
"I, Trivial: a Travail[r], by Iva Trail"
"I Trust Sir Tut[r], by Su Ritt" []
"I Trusted Detritus[r], by [if player is male]Titus Erd[else]Teri Dust[end if]"
"I Try Real Literary[r], by [if player is male]Terry Ali[else]Lita Ryer[end if]"
"I Turned Under It[r], by Teri Dun" []
"I Tut Some Timeouts[r], by Moe Titus"
"I, Uncle Lucien[r], by Len Cui"
"I, Unrapt Puritan[r], by Tai Purn"
"I, Up So Pious[r], by Su Poi"
"I, User So Serious[r], by Sue Rios"
"I, Vagrant, a Girt Van[r], by [if player is male]Art Gavin[else]Gita Varn[end if]"
"I, Vast Vista[r], by Avis Savitt"
"I, Vegan? A Given[r], by Vin Gea"
"I Versus Viruses[r], by Su Siver"
"I Voted to Dive[r], by Dottie DeVivo"
"I Walk the Thaw Like[r], by Kal White"
"I Ward the Weird Hat[r], by Eda Wirth"
"I, Weaver: a Review[r], by Eva Weir"
"I Wend Into a Wide Nation[r], by [if player is male]Dwain Nieto[else]Tonia Edwin[end if]"
"I Whale a While[r], by Eli Hwa" []
"I Won't Be Tebowin['][r], by Bo Twine"
"I Wouldn't, Loud Twin[r], by Ludo Wint"
"I Wreck No Nice Work[r], by Rick Owen"
"I Wrecked, Wickeder[r], by Drew Eick & Rick Weed"
"I, Zen, Zine[r], by Zee Zinni" []
"I'd Alarm Admiral Mad-Rail[r], by Dara Lim" []
"I'd Bar a Bird[r], by Dr. Abi Baird" []
"I'd Barge a Bridge[r], by Brad Ige" []
"I'd Chat: a Ditch[r], by Tad Chi" []
"I'd Clear Dr. Lacie[r], by Ric Dale & Dire Cal" []
"I'd Close Le Disco[r], by Sid Cole" []
"I'd Dwelt: Dewd-Lit[r], by Wild Ted Twiddle"
"I'd Flake, Leaf-Kid[r], by Fidel Ka" []
"I'd Forget Gotfried Forged It[r], by Ted Frigo & [d-t] Grief"
"I'd Hang Gandhi[r], by Ag Dinh"
"I'd Have Hid Eva[r], by Vi Head"
"I'd Let a Detail Lead It[r], by [if player is male]Ted Ali[else]Edi Alt[end if]"
"I'd Once Do Nice[r], by Noe Cid" []
"I'd Rate a Tired READ IT[r], by Tia Erd" []
"I'd See On One Side[r], by Ines Doe"
"I'd Slam Mild as Dismal[r], by Millis Addams"
"I'd Sly Idyls[r], by Lissy Liddy"
"I'd Smack Sad Mick[r], by Dick Sam"
"I'd Sort Dirt So, Dr. Otis[r], by Sid Ort"
"I'd Trust St. Trudi[r], by Stu Dirt"
"I'll Break, Bilk Earl[r], by Lila Berk"
"I'll Mew I'm Well[r], by Lew Lim"
"I'll Push His Pull[r], by Lips Uhl"
"I'll See Ellie's[r], by [if player is male]Les Eli[else]Liesel Leslie[end if]"
"I'll Take Li'l Kate[r], by Elli Tak"
"I'm a Drab Barmaid[r], by Ida Bram"
"I'm a Lot to Liam[r], by Olma Mattioli"
"I'm a Wall: Malwail[r], by Liam Law"
"I'm Alert: Trail Me[r], by Tim Lear" []
"I'm All Ill, Ma[r], by [if player is male]Al Lim[else]Lilla Milam[end if]"
"I'm as a Sim[r], by Masi Sima"
"I'm As Ma Is[r], by Asia Simm"
"I'm Folk of Milk[r], by Flo Kim"
"I'm Les Miles[r], by Selim Emlis"
"I'm No Omni[r], by Mimi Noon"
"I'm Okay, Yoakim[r], by Kai Moy"
"I'm Over Vi Mero[r], by Ev Mori"
"I'm Owed Dim Woe[r], by Mo Wide"
"I'm Sad Midas is Mad[r], by Simi Addams"
"I'm Sara, Ms. Aria[r], by Aramis Simara" []
"I'm Smart as Mr. Tim[r], by Art Mims"
"I'm Sold as So Dismal[r], by Aldo Sims"
"I'm Sunk in Musk[r], by Kim Sun"
"I'm Thrown With Norm: Mirth Now[r], by Mohr Wint"
"I'm Touted To Tedium[r], by Timed-Out Mutt Odie"
"I'm Unable, Alien Bum[r], by Ian Blume"
"I've Done One Dive[r], by Ovid Nee"
"I've Made Evie Mad[r], by Em Davie"
"IBM As-Is: BAM[r], by Ms. Abi Simba"
"Ice Art: I Trace a Citer[r], by Tricia-Tracee Cerita" []
"Ice Bars: a Scribe[r], by Cris Bea"
"Ice Dolls['] Cold Lies[r], by Sid Colle"
"Ice Genius, Nice Guise[r], by Ines Guice"
"Ice Rinks: Nice Risk[r], by Iris Enck"
"Ice Trophy, Toy Cipher[r], by Troy Piche"
"Ice's Rot: Cries to Score It[r], by Ros Tice"
"Iced, Gone, Genocide[r], by Edie Cong"
"Iced Over Divorcee[r], by Evie Cord"
"Iceland's Nice Lads[r], by [if player is male]Sid Lance[else]Candi Les[end if]" []
"Ichors So Rich[r], by Cris Oh" []
"Iciest Deaths: the Die is Cast[r], by Tisa Tedeschi"
"ICK! Host to Hicks So Thick[r], by Kit Ochs" []
"The Icon Hit Once[r], by Teo Chin"
"Iconic? NO[r], by Nico Cino"
"The Icy City, Eh: Ye Itch[r], by Chet Yi"
"Icy Denser Residency[r], by [if player is male]Cris Edney[else]Cyndi Rees[end if]" []
"Id-Theism Times Hid[r], by [if player is male]Sid Theim[else]Edi Smith[end if]"
"Idealism: Aim, Slide[r], by Ida Miles"
"Idealism to Modalities[r], by [if player is male]Otis DeLima[else]Melodi Tsai[end if]"
"Ideas of Oafs Die[r], by Si Dafoe & Ed Sofia"
"Ideology? Goody! Lie![r], by Diego Loy"
"An IDK, Kinda[r], by Kandi Dakin"
"Idle Fens, Life's End: Lee Finds Def Lines[r], by Enid Self"
"Idle Gab? Big Deal[r], by Gil Bade"
"Idle Lied I, Li'l Dede[r], by Edie Dill" []
"Idle List: Die Still[r], by Sid Litle"
"Idle Pap Applied[r], by Pip Adel"
"Idle Pun Lined Up[r], by Ned Lupi"
"Idle Sop, Plied So[r], by Sid Pole"
"Idleness Dens Isle[r], by [if player is male]Sid Elsen[else]Lis Edens[end if]" []
"Idler's Bane: Bread Lines[r], by [if player is male]Andre Biles[else]Linda Brees[end if]"
"Idyl Troop Dirty Pool[r], by Troy O'Dilp"
"I.E. Bland Dan Lieb[r], by Belinda DeBlain" []
"I.E. Sulk Like Us[r], by Si Luke"
"If a Dry Friday[r], by Adi Fry" []
"If Anger: a Finger[r], by Fergina Garfein" []
"If Dale Filed a Fad-Lie[r], by Di Leaf" []
"If Dante Fainted Defiant: a Fit End[r], by [if player is male]Tad Fine[else]Ida Fent[end if]"
"If Elfs Be Fibs, FEEL[r], by Biff Lees"
"If Felon, Offline[r], by Flo Fine"
"If Lame, Fail [']Em[r], by Mia Elf"
"If Lost in Tinfoils[r], by [toti] Fils"
"If No Info[r], by Fifi Noon"
"If Starved, Drive Fast[r], by [if player is male]Dave First[else]Frida Vest[end if]"
"If Taken at Knife[r], by Ike Fant"
"If the Thief Fit, Eh?[r] by Effie Thith"
"If Torn I Front No Rift[r], by Torin F. Fortin"
"If You Slur Furiously[r], by Lori Yusuf"
"Iffy Lust, Stuffily[r], by Ty Fulfis"
"Ignoble, I Belong[r], by Bo Ingle & Gil Bone"
"Ignorant Giant Ron[r], by [toti] Garn"
"Ilk Ween Like New[r], by Wink Lee"
"Ill Better, Belittler[r], by Elli Brett"
"Ill Coders['] Dice Rolls[r], by Red Collis"
"Ill-Dreamt Treadmill[r], by Tad Miller" []
"Ill Fang Falling[r], by Alf Ling"
"Ill Foes['] Follies[r], by Les Foil"
"Ill? I? No, No[r], by Loni Olin"
"Ill Inn: Nil, Nil[r], by Linn Li"
"Ill-Nature Tellurian Until Real[r], by Arlie Lunt"
"Ill Times: I Smell It[r], by Tim Ellis"
"Immersing, Simmering[r], by Ines Grimm"
"Immortal Limo-Mart[r], by Mat Moril"
"Immortalise, Memorialist[r], by [if player is male]Emilio Smart[else]Roselia Timm[end if]"
"Immune Li'l Millenium[r], by Mei Mullin"
"Imperial Mail Pier[r], by Mel Parii"
"Important Titan Romp[r], by Ramon Pitt"
"Impose Not Some Point[r], by Noemi Post"
"Improvised is Improved[r], by Primo Vides"
"In a Sickbed, Back Inside[r], by Sandie Bick"
"In Among Non-Magi[r], by Naomi Ng"
"In Awe of Naif Woe[r], by Io Fewan"
"In-Car Racin['][r], by Nanci Arric"
"In Dark I Drank a Drink[r], by Kindra Kinard" [p]
"In, Foes So Fine[r], by Effie Sonsino"
"In for a Rain of No Fair[r], by Faran Fiorino"
"In Gassy Sayings[r], by Sy Gains"
"In Here, Cat: Eat, Enrich[r], by Teri Hance" []
"In Quay Yanqui[r], by Aniq Yu"
"In Seer Ernie's[r], by Ren Eis"
"In Sun Be Bunnies[r], by Ennis Bu"
"In the Black Kitchen-Lab[r], by Beth Calkin"
"In Ur-Ruin I Run[r], by Nuri Inur"
"In Wet Twine I Went[r], by Newin Witte" []
"Inane Creep? Ire, Penance, Inner Peace[r], by Nancie Peer"
"Inane Rain Arena[r], by Arianne Naraine"
"Inane Sallie's Lineal Anises[r], by Selina Nealis"
"Inane, Trite Barb: I Banter[r], by Bernita Biernat"
"Inane Wit: I Ain't New[r], by Tai Winne"
"Inartistic Cairns: a Racist Intrinsic[r], by Cristina Crisanti"
"Incentives: Nicest Vein[r], by Vince Stein"
"An Inch [']N Achin['][r], by [if player is male]Nic Han[else]Ann Chi[end if]"
"Inch, Age: I Change[r], by Gia Chen"
"Inch Leap: I Can Help[r], by Chip Lane"
"Incognisant Sanctioning[r], by Otis Canning"
"Incomplete Poem Client[r], by Pete Lincom"
"Incubate: a Nice Tub[r], by Tia Bunce"
"Incurable Urban Lice[r], by Lani Bruce"
"India Sands, Naiads['] Dins[r], by Sandi Dains"
"Indicatory Dictionary[r], by Dr. Tony Icia"
"Indulged Deluding[r], by Ed Guldin"
"Inept Cats Can't Spite Pittances[r], by Staci Pent"
"Inert? Ow, Write On[r], by Towerin['] Wit Nero" []
"Infernos for Ennis, Sinner of Iron Fens[r], by Ron Fines"
"Infield Infidel, Find Eli[r], by Del Fini" []
"Infirm Freeman, a Fireman[r], by Fermina Freiman" []
"Inflate, Fat Neil[r], by Ian Felt"
"Info Sum: I'm So Fun[r], by Simon Fu"
"Informal Norm, Fail[r], by Alf Minor"
"The Ink Hit Ken[r], by Keith Hentkin"
"Inklings['] Linkings[r], by King Nils"
"Inmate of Meta Info[r], by Fae Timon"
"Inmost Monist Timons[r], by Monti Stimson"
"Inmost Monist[r], by Ms. Toni Timson-Simont" []
"Insane-Pox Expansion[r], by [if player is male]Nixon Pase[else]Xena Spino[end if]"
"Insatiable Banalities[r], by [if player is male]Blaine Tsai[else]Iliana Best[end if]" []
"Insect, Vine, Incentives[r], by Nevin Stice" []
"Insectean Tenancies[r], by [if player is male]Cain Steen[else]Stacee Nin[end if]"
"Insomnia Mansion: I[r], by Nia Simon"
"Inspector to Princes Trips Once[r], by Cris Ponte"
"Inspectorial Replications[r], by Nicola Priest"
"Inspire, Spinier[r], by Si Perin"
"Instant Oral Translation: Intro Aslant[r], by [if player is male]Alton Strain[else]Nita Ralston[end if]"
"Insular Sun-Lair Urinals As Lurin['][r], by Lu Rains"
"Insured, I Sunder[r], by Ned Rusi"
"Intentional Online Taint[r], by Annie Litton"
"Interim Termini[r], by Erin & Tim Mintier"
"Internal Rant Line[r], by Elin Tran"
"Internets['] Re-Intents: Inner Test[r], by Trent Enis"
"Interstellar Learners['] Tilt[r], by Arnett Siller"
"Into a Fun Fountain[r], by Iona Funt" []
"Intro Fees of Entries Set on Fire: Terse Info[r], by Efren Otis"
"Involved Devolvin['][r], by Viv Eldon"
"Io, Let to Lie[r], by Eliot Leito"
"Io Preens In Repose, Pioneers[r], by Rose Pine"
"Ire Calls Carlisle[r], by Cris Leal" []
"Ire? Nay, I Yearn[r], by Neriya Rainey" []
"Ire's Row: or, Wiser Worries[r], by Ros Weir"
"Iridescent, Indiscreet[r], by Denice Rist & Enid Crites"
"Irk Eerie Kirk[r], by [if player is male]Erik[else]Keri[end if] Kier-Reik"
"The IRL Hitler[r], by Teri Hillerth"
"Irons, Sin or Rosin[r], by Ronin Rossi & Sorin Rison"
"Ironside's Derisions[r], by Enid Rossi"
"IRS Vs Irv[r], by Viv Sirrs"
"Is My Blog Slimy Gob[r], by Gil Mosby"
"Is Plot to Slip[r], by Isis Lott-Lopp"
"Is Valor So Viral[r], by Val Rios"
"Isenhower: Hero/Swine[r], by Erin Howes & Sheri Owen"
"Island-Booted, Bloodstained Bandit Loosed[r], by [if player is male]Addison Bolte[else]Soledad Tobin[end if]"
"An Isle, Saline[r], by Alisia Nelsen"
"Issues Dig Disguises[r], by Sid Gussie"
"Istanbul: I Ban Lust[r], by Lisa Bunt"
"It Forks OK First[r], by Si Kroft & Tor Fisk" []
"It Holds Old Hits[r], by Sid Holt"
"It Makes a Kismet Mistake at Mike's[r], by Kim East"
"It Pulsated Platitudes[r], by Titus Delap"
"It Reads Sit, Dear[r], by Ida Rest" []
"It Revived a Derivative[r], by [if player is male]Dave Viteri[else]Evita Verdi[end if]"
"It Rivals Trivials[r], by Travis Li"
"It Spoke to Spike[r], by Kip Seto"
"It's a Dopy Dystopia[r], by [tt] Spady"
"It's Huw With Us[r], by Tish Wu"
"It's Only Lions, Ty[r], by [if player is male]Tiny Sol[else]Lin Yost[end if]"
"It's Posh, Sophist[r], by Tip Hoss"
"It's So I Toss to Sis[r], by Isis O'Stots"
"It's Too Late to Totalise[r], by Lottie Sato"
"It's Top to Spit[r], by Si Pott" []
"Itch, React, Architect[r], by Catt Reich" []
"An Item I Meant[r], by Mattie Nieman"
"Its Plot to Split[r], by Sol Pitt"
"Its Treks: Skitters[r], by Tess Kirt"
"IV Lens Livens Elvins[r], by Nevil Vesslin"
"Ivan Tal, Valiant Latvian[r], by Vi Natal"
"Iverson's Versions[r], by Erin Voss"
"The Ivy's Sty-Hive[r], by Tish Vey" []
"Ja, Nix a Jinx[r], by Jan Xi"
"James, Rule Jerusalem[r], by Erma Jules"
"Jealousy, Louse Jay[r], by Joey Saul"
"Jeer Yon Hut: the Journey[r], by [if player is male]Joey Hunter[else]June Yother[end if]"
"Jellison's Jolliness[r], by Jessi Noll"
"A Jest, My Majesty[r], by Steamy J & Ty James"
"Jet on to Jen[r], by Jojo Ennett"
"Jim, Lay My Jail[r], by Jay Lim"
"Jingle: a Lean Jig[r], by Jane Gil"
"Jingos['] Jog-Ins[r], by Si Jong"
"A Jinx, a Jinx[r], by AJ Nix & Jan Xi" []
"Jo's Lunar Journals[r], by [if player is male]Rajon Sul[else]Ros Lujan[end if]"
"Job Notice Objection[r], by Joi Becton"
"Jocks Are a Jerk [']Cos[r], by Jack Rose"
"Jocose Print Projections[r], by Prince Joost" []
"Join the Tie, John[r], by Thin Joe"
"Joints St. Joni Jots in[r], by O. J. Nist"
"Joke About: a Jute Book[r], by Joe Kubota"
"Jokers to Jerks, Too[r], by Joe Korst"
"Joliet's Jet Silo[r], by Joe List"
"Jolted Old Jet[r], by TJ Odle"
"Josh Went: Hewn Jots[r], by John West"
"Journalist Roils Junta, Runs to Jail[r], by Lorina Just"
"Journeyman: Men on a Jury[r], by Jenny Mauro"
"Joy, Mints, My Joints[r], by Jim Tyson"
"Joy Rune Journey[r], by June Roy" []
"The Joys: Josh Yet[r], by Jes Hoyt"
"A Judge's Ade Jugs[r], by Gus Deja"
"Judoist Studio J[r], by Judi Tso"
"Juliet's Just Lie[r], by Luis Jet"
"June of UFO Jen[r], by Fun Joe"
"Junk Mail? J/K, Alumni [r], by [if player is male]Juan Milk[else]Kim Lujan[end if]"
"Jupiter's Just Ripe[r], by Jeri Pust"
"Just a Low Lout's Jaw[r], by Lu Wojtas"
"Just More Jets-O-Rum[r], by [if player is male]Joe Sturm[else]Jo Sumter[end if]"
"Just Today: a Dusty Jot[r], by Joy Staudt"
"Kabuki Cot Kickabout[r], by Buck Tokai"
"Karstens's Starkness[r], by Stan Kress & Ernst Kass"
"Kasparov as Karpov[r], by Avo Parks"
"Keatts's Tsatske[r], by Kat Tess"
"Kelpies['] Lips, Eek[r], by Skip Lee"
"Kelsey's Keyless[r], by El Sykes"
"Kent Gaol: Long Take[r], by Oleg Kant"
"Ker-Blam, Mr. Blake[r], by Mel Bark"
"Kera-Beth the Baker[r], by Bret Hake"
"Ketcham the Mack[r], by Mat Heck" []
"Key Cables, Black Eyes[r], by [if player is male]Caleb Skye[else]Becky Seal[end if]" []
"Kick Tires: Ike's Trick[r], by Rikki Stec"
"Kid Crew I'd Wreck[r], by Rick Dew"
"Kid, Lamb, Bad Milk[r], by Kim Bald"
"The Kid's Kit Shed[r], by Ted Kish"
"A Kidder's Dead-Risk Dark Side[r], by Dirk Desa" []
"Kill Dreams, Smaller Kid[r], by Drake Mills"
"A Kind Kid? Na[r], by Kandi Dakin" []
"Kind Old Odd Link[r], by Lon Kidd"
"Kind Sen. Denkins[r], by Ned Sink"
"Kindles Slinked[r], by Len Disk" []
"King Lew, a Weakling[r], by [if player is male]Gale Wink[else]Keli Wang[end if]"
"Kingward, Darkwing[r], by Dirk Wang"
"Kinslaw Walks In[r], by Sal Wink"
"Kinsley's Skylines[r], by Lin Sykes"
"Kiss, Foe of Skies[r], by Ike Foss"
"Kiss, Nag, Askings[r], by Sis Kang"
"Kiss Roy: So Risky[r], by Sky Rios"
"Kit, When We Think[r], by Ken Whit" []
"Kit's New Wet Skin[r], by Ken Wist"
"Kite Mill: Kill Time[r], by Mike Till"
"Klein-Sasser Larkinesses[r], by Selena Kriss"
"Knead, Naked[r], by Kenda Kaden"
"Kneisel's Likeness[r], by Lee Sinks" []
"Knife a Fake IN[r], by Ike Fan"
"A Knife, Fake, In[r], by Ike Fan"
"Knotted[r], by [d-t] Kent"
"Know, False Snowflake[r], by Fawn Kelso"
"Know-Heads['] Shakedown[r], by Don Hawkes"
"Know it to Wink, OK Twin[r], by Nik Two Kotwin"
"Know This Wish Knot[r], by Wink Tosh"
"Koester Re-Tokes[r], by Ester Ko"
"Kornfeld Nerdfolk[r], by Rolf Denk"
"Kubiak's Kabukis[r], by Suki Bak"
"La, My Itch, Mythical[r], by [if player is male]Mitch Lay[else]Cathy Lim[end if]" []
"La, Tough to Laugh, Lout-Hag[r], by Al Ought" []
"La, Vigor, Go Viral[r], by Vi Gorla & Lora Vig"
"Lab Fest Last Feb[r], by Alf Best"
"Lab Term Table, Mr.[r], by Lambert Beltram-Bramlet" [] [p]
"Label a Hug Laughable[r], by Helga Blau"
"Label My Yell: Bam[r], by Alby-Lem Bellamy" []
"Labors, Men: No Rambles[r], by Rosenbalm Lamberson" []
"Labors of Bar Fools[r], by Flor Sabo"
"Lace, Ink, a Nickel-[r], by Kaci Len"
"Lack No Clonk: a KO Clan[r], by Al Nock"
"Lack Not Talk, Con[r], by Colt Kan"
"Lack Pie? A Pickle[r], by Kip Cale & Eli Pack"
"Laconic, Can Coil[r], by Al Cinco"
"Lad Drew, Rad Lewd Dawdler, Drawled[r], by Del Ward"
"Lad, I've a Devil[r], by Dave Li"
"Lad, Sow Low Ads, Do Laws[r], by Sal Dow" []
"Lad, Stay Sadly at Last Day[r], by [if player is male]Ly Sadat[else]Dy Atlas[end if]"
"Laden Here, He Learned[r], by Lee Harden"
"Laden, Leaden Land[r], by Alden Andel"
"The Ladies['] Deaths Lie[r], by Edie Stahl"
"Ladroon Orlando[r], by Al Rondo" []
"Lady, a Bro, Labor Day[r], by Lara Boyd"
"Lady, Moth, My Old Hat[r], by Ty Oldham"
"Lag Very Gravely[r], by Val Grey"
"Laggers['] Gargles[r], by Greg Sal"
"Lair at a Trail[r], by Tara Li"
"Lair of Fail or Frail, O[r], by Alf Rio"
"The Lair's This Real[r], by Lise Hart"
"The Lamb Blameth THEM-LAB[r], by [if player is male]Mel Bath[else]Beth Alm[end if]" []
"Lame Candy: A Calm Deny[r], by Clay Maden"
"Lame Cory Claymore[r], by Mary Cole"
"Lame, Dire, Remedial[r], by Liam Reed"
"Lame Doc Mad Cleo[r], by Cold Mae Macleod"
"Lame-Duck Calm Duke[r], by Mac Ludke" []
"Lame Peter, Tame Leper, Maple Tree[r], by Elmer Pate"
"Lamenting Alignment[r], by Tim Langen"
"Lanced Candle[r], by Declan DeLanc" []
"A Land and Al[r], by L. A. Dan"
"Land of Top Plant Food[r], by Adolf Pont"
"Landslide, Sadden Ill[r], by Del Island"
"Lang's Slang[r], by Lans G. Glans-Sangl"
"Lapsing Sapling[r], by Gil Span" []
"Larcenous Euro-Clans[r], by Luna Score"
"A Larch Lecher[r], by Rachel Lacher"
"Large, Galdder Elder Laggard[r], by Gerrald Dagle" []
"The Lark: Her Talk[r], by Art Kehl"
"Larriby Library[r], by Barry Li"
"Larvae I Re-Avail[r], by [if player is male]Ira Veal[else]Valarie Valeria[end if]"
"Lass-Free, Fearless[r], by Alf Esser"
"Lasso Alsos[r], by Sal LoSasso" []
"Last Day at Lady's[r], by Ty Aldas"
"Last-Five Festival[r], by Val Feist" []
"Last Men: Laments[r], by Mantell Tessman"
"Last-Ogled Lost Glade Gold Steal[r], by [d-t] Segall"
"Last, Ol['] St. Lola, So Tall[r], by Sal Olt"
"Last One: Lose, Nat![r] by Al Stone"
"Last One, St. Leona[r], by Leo Nast" []
"Last We Slew at Set Law[r], by Al West"
"Last Week Let Askew[r], by Lew Keats"
"Last Week: Wet Lakes[r], by Walt Kees" []
"Last Year, Stay Real[r], by Art Ayles"
"Lastly I Stay Ill[r], by Lita Sly"
"Lastly We Stay Well[r], by Twyla Les"
"Late Life Leaflet: I[r], by [if player is male]Eli Tafel[else]Leia Felt[end if]"
"Late Retro Tolerater Errol Tate[r], by Lea Rotter"
"Later Ed Related, Altered[r], by Lee Dart" []
"Later Now: a Low-Rent Real Town[r], by Al Wroten"
"Latvians['] Last Vain Tan Vials[r], by Nat Silva"
"Laud Grief, Lifeguard[r], by Fidel Guar"
"Laughter's Slaughter[r], by Ruth Segal" []
"Laundry is Ruin, Sadly[r], by [if player is male]Yuri Lands & Daryn Luis[else]Sindy Raul[end if]"
"Lawrence's Clear News[r], by [if player is male]Neal Crews[else]Celsa Wren[end if]"
"The Laws? Haw, Let's[r], by Hal West"
"A Lay Cult, Actually[r], by [if player is male]Clay Ault[else]Lucy Lata[end if]" []
"Lay Dirt Tardily[r], by Ty Laird"
"Lay Need, Deny Ale[r], by Andy Lee"
"Lay Right Thy Grail[r], by Gil Harty"
"Lay Up, Pauly[r], by [if player is male]Pal Yu[else]Lu Yap[end if]"
"Laymen Shod Handsomely[r], by [if player is male]Ahmed Lyons[else]Dyan Holmes[end if]"
"Lazy Times['] Zesty Mail[r], by Zita Myles & Emily Satz"
"Le Chic Cliche[r], by Li Cech"
"Le Crash[r], by Charles Lascher"
"Le Fab Baffle Bale[r], by Baba Leffel"
"Le Fine Feline Feelin['][r], by Len Fei"
"Le Hard Herald[r], by Al Herd"
"Le Snug Gunsel Lunges[r], by [if player is male]Gus Len[else]Su Glen[end if]"
"Le Thief: the Life I Left, Eh?[r] by Lee Hift" []
"Le Tux: Exult![r] by Tex Lu"
"Le Vista Alivest[r], by Vi Stael"
"Le Yowl, Yellow[r], by Ly Lowe"
"Lead, Iron: A Lonelier Android in Ordeal[r], by Reinaldo Andreoli" []
"Lead On, Lad Neo[r], by Ol['] Dean Delano" []
"Leaden Lean Dell[r], by Danelle Allende"
"Leaking Linkage[r], by Gil Kane"
"Leaky Roof for a Yokel[r], by Fay Looker"
"Lean Log Galleon[r], by Leola Ng" []
"Lean Low, One Wall[r], by Leon Law"
"Lean on Ole Nan[r], by Ann Leo"
"Leap, Thing: Plan Eight[r], by [if player is male]Phil Tegan[else]Pat Hingle[end if]" []
"LeapTech: the Place[r], by Pat Leech"
"Learn by Blarney[r], by [if player is male]Al Byrne[else]Lyn Baer[end if]"
"Learn'd Randle Aldner[r], by Darnel Lander" []
"Leased, Sealed[r], by Deedee Sallas"
"Leashing Healings[r], by Nigel Ash" []
"Leaving Lavigne[r], by Gil Evan"
"Lebanon's Neon Labs[r], by Al Benson"
"Lee IX, Exile[r], by Lexie Xiele"
"Lee Roth's the Loser[r], by Lester Ho"
"Leer: Ben's Beer Lens[r], by Les Breen"
"Leermost Molester Storm Lee[r], by Mr. O. Steel"
"Leery Al, a Yeller[r], by Earl Ley"
"Leery Ol['] Eye-Roll[r], by Elly Roe"
"Left is Fliest[r], by Si Felt"
"Lefties['] Lie Fest[r], by Les Feit" []
"Lefty is Set: I Fly[r], by Ty Slife"
"A Lefty: Ye Flat Fealty[r], by Ty Leaf"
"Lefty's Flytes[r], by Sy Felt" []
"Lefty's Lie Lifestyle[r], by Lyle Feist" []
"Legacies Cage Lies[r], by Leci Sage" []
"Leif's Files: I, Self[r], by Effie Sills" []
"Leigh's Sleigh[r], by [if player is male]Helgis Gleish[else]Shellie Higgs[end if]"
"Leila's Allies[r], by Sallie Ellias" []
"The Lemon: No Helmet[r], by Helen Tom-Heelmont"
"Lend Drama, Dreamland Ladder Man[r], by Nedd Lamar"
"Lend Ire, Dr. Eline[r], by [if player is male]Len Reid[else]Lin Deer[end if]"
"A Lend-Laden, Leaden Land[r], by [if player is male]Dean Leland[else]Deanna Dell[end if]" []
"A Lens Leans[r], by [if player is male]Sean Ansell[else]Lenna Sales[end if]" []
"Lentils, Lintels[r], by Les Lint"
"Leonardo, One Lardo[r], by Rod O'Neal" []
"Leprechaun: Her Cleanup[r], by Prue Chanel"
"Leprechauns['] Chapel Runes[r], by Claus Hepner"
"LeRon or Len[r], by Errol Nolen"
"Les Flew, Wes Fell[r], by Lew Self"
"Less Drive: Diss, Revel[r], by Ed Silvers"
"Less of a Lass-Foe[r], by Elf Sosa"
"Less-Proud Pros['] Duels[r], by Ross Plude"
"Less Rude Elders, Us[r], by Ed Sulser"
"Lest God Gets Old[r], by Del Gost"
"Lestat's Stalest[r], by Tess Tal"
"Let Abe Be Late[r], by [if player is male]Lee Abt[else]Bet Lea[end if]"
"Let Burn Blunter[r], by Len Burt"
"Let Foam, Fat Mole of Metal[r], by Tom Leaf" []
"Let Go to Gel[r], by Toto LeGelg" []
"Let God Get Old[r], by E. T. Gold"
"Let in Much Lunchtime[r], by Clint Hume & Che Tumlin"
"Let Roar Art Lore, Rare Lot[r], by Al Torre"
"Let This Lithest Thistle[r], by Les Hitt"
"Let Tom Melt to Mottle[r], by [if player is male]Mo Lett[else]Em Lott[end if]"
"Let Us: a Salute[r], by Lulu Tate-Seas" []
"Let's Cool Eco-Tolls[r], by Lost Cleo Costello" []
"Let's Fail Life Last[r], by [if player is male]Tai Fells & Fat Ellis[else]Lita Self & Fae Still[end if]"
"Let's Hold the Dolls[r], by [d-t] Shell"
"Let's Kinda Stand Like Idle Tanks[r], by [if player is male]Tad Elkins[else]Kit Landes[end if]"
"Let's Play All Types[r], by Sly Patel" []
"Let's Play Style, Pal[r], by Pat Lyles" []
"Let's Study Tests Duly[r], by Sy Duttles"
"Let's Vote: Test Love[r], by Steve Olt"
"Let's Work: Slow Trek[r], by Stew Krol" []
"Lethargic Grail Tech[r], by Gita Lerch" []
"A Letter's Real Test[r], by Al Street"
"Lev Has Halves[r], by Val Esh"
"Level Slow Swell Love[r], by Les Vowell"
"Levi's Lives[r], by Elvis Slive"
"Levin's Snivel[r], by Vi Nels" []
"Lew, Stu: We Lust[r], by Lu West"
"Lew's Got Two Legs, Gets Low[r], by Wes Golt & Stew Log"
"Lexicon Clone XI[r], by Ox Cline & Cole Nix"
"Lexy, Act Exactly[r], by Tex Clay"
"A Li'l Grue Guerilla[r], by [if player is male]Gil LaRue[else]Lula Iger[end if]" []
"Liane's Saline Aliens[r], by Sean Li" []
"Liar, Liar[r], by Raia Rill" []
"Liars['] Lairs[r], by Sir Al Sarli"
"Liberal Braille[r], by Bill Rea & Ira Bell"
"Liberty's Blistery, Sly Tribe[r], by Elsy Brit"
"Lich Crone's Chronicles[r], by Chris Cleon"
"Lie and Leadin['][r], by Daniel Aldine"
"Lie As Elias, I.E. Sal[r], by Elisa Ailes" []
"Lie Astir: Is it Real?[r] by [ta] Riles"
"Lie, Bible: Bile[r], by Bebe-Lili Lieb" []
"Lie, Drab Rail Bed[r], by Ed Blair"
"Lie, Fur: a Failure[r], by Ariel Fu"
"Lie Ill, Li'l Eli[r], by Elli Li"
"Lie is Loose[r], by Elois Sileo"
"A Lie to Eat Oil[r], by Teolia Leitao" []
"Lies by Sibley[r], by Sy Beil"
"Life or Death: Other Failed[r], by Tilda Hoefer" []
"Life's Aim: Families[r], by Mei Fasil"
"Lights Out, Guilt-Shot[r], by Hugo Litts"
"Like Mild Deli Milk I'm Killed[r], by [if player is male]Mike Dill[else]Kim Lidle[end if]"
"Like Not One Kilt[r], by [if player is male]Lon Kite[else]Kit Leon[end if]"
"Like This, Lit Sheik[r], by Kit Hisle"
"A Liked Dalek, I[r], by Ed Kail"
"A Likely Kill, Aye: Leakily, I Key All[r], by Kai Lyle"
"A Limner's Minerals[r], by Ren Smail"
"The Limo Moileth[r], by Theo Lim"
"Linda's Island[r], by Sad Lin Landis" []
"Line Gangs['] Gleanings[r], by [if player is male]Nigel Gans[else]Agnes Ling[end if]"
"Lingo, OK-Looking[r], by Gil Koon"
"Link the Thin Elk[r], by Ken Hilt"
"Links to Lost Kin[r], by Nik Solt"
"Lint Hole Into Hell[r], by [if player is male]Lon Leith[else]Elin Holt[end if]"
"Lint Owl Will Not Lilt Now[r], by Lon Wilt"
"The Lion Noel Hit[r], by Eli Noth & Theo Lin" []
"A Lion's Slain, O[r], by Sonia Allison" []
"Liquor Be Obliquer[r], by Eriq Lubo"
"Lisanne Leans In[r], by Ali Senn"
"List Not Lost Tin[r], by Nils Ott-Stilton"
"A List of Fat Oils[r], by [if player is male]Alf Otis[else]Flo Tsai[end if]"
"Lite-Tile E-Lit[r], by Eli Title"
"Lithe Vow With Love[r], by Wilt Hove"
"Little Boys['] Bits to Yell[r], by [if player is male]Toby Estill[else]Betty Ollis[end if]"
"Live Again, Lava Genii[r], by Gia Lavine"
"Live Chat: Halt Vice[r], by [if player is male]Chet Vail[else]Eva Licht[end if]"
"Live Ever Aerial[r], by Valerie Larivee"
"Live for a Fail-Over, Viler Oaf[r], by Rafi Love"
"Live, Levi[r], by Viv-Ellie"
"Live Long, Try Revoltingly: Very Tolling[r], by Tyler Loving"
"Lo, a Debt, Bloated[r], by [d-t] Abel"
"Lo, Able Ole Lab[r], by Al Loeb-Bollea"
"Lo, Abort to Labor[r], by Bartolo Ort-Albo"
"Lo! Ashes. She Also Heals So[r], by ******* Sol Shea"	40
"Lo, Draw a World[r], by Rod Law"
"Lo, Dwarf of Drawl[r], by Flo Ward-Waldorf" []
"Lo, Ester: Ere Lost to Leers or Steel[r], by Sol Tree"
"Lo-Fault Fallout[r], by Flo Ault"
"Lo, Flay a Folly[r], by Ola Fly"
"Lo, I Sell Lollies[r], by Sol Lile" []
"Lo, I'm Not Moonlit[r], by Tom Olin"
"Lo, Inure Ole Ruin[r], by Oren Liu"
"Lo, Lorn Aim? I'm on a Roll[r], by Lorna Milo" []
"Lo-Mend Old Men[r], by Delmon & Meldon LeMond" []
"Lo, Mine Oil, Men[r], by Meline Molino" []
"Lo, Rare Aloe: a Lore[r], by Leora LaRoe"
"Lo-Scale Locales[r], by Sal Cole"
"Lo, Son, Be So Noble[r], by Len Boos"
"Lo-Spine Pile-Ons[r], by Sol Pein & Les Pino"
"Lo-Style LOLS, Yet, to Yells[r], by Sly Leto"
"Lo, Toys Too Sly[r], by Ly Soto"
"Lo, Votes to Solve[r], by Lev Soto"
"Lo, Whine? No, While in Whole[r], by Lin Howe"
"Loath Tumors, Thou Mortals[r], by LaMott Roush"
"Loathings, I Hang Lots[r], by [if player is male]Gil Ashton[else]Sona Light[end if]" []
"Lob a Full Foul Ball[r], by Flo Bulla"
"Loci Set To Slice it Close[r], by Eli Cost"
"Locked-In Clone Kid[r], by Enid Lock"
"Locked-in Olde Nick[r], by Dick Leno" []
"A Locker's Ol['] Creaks[r], by Sal Coker & Clark Ose"
"Locust Clouts[r], by Col. Stu Coltus" []
"Lodge Unto Old-Tongue Tuned Logo[r], by Doug Elton"
"Lofting Glint of Flint, Go[r], by [if player is male]Gil Font[else]Flo Ting[end if]" []
"A Lofty Flay to Yo['] Flat[r], by Al Foyt" []
"Lofty to Fly! T/Y, Flo![r] by Ty Lof"
"Log in by, Yobling[r], by Gino Bly" []
"Log Ires, Sir? Ogle Glories[r], by Gil Rose"
"Log: Meant to Mangle[r], by Galen Tom"
"Logan's Slogan[r], by Al Song"
"Lola's End: All's Done[r], by [if player is male]Les Dolan[else]Lena Olds[end if]"
"LOLscape: All Copes Collapse[r], by Cal Lopes" []
"Lone Dismal Medallions[r], by [if player is male]Damon Lisle[else]Dione Small[end if]"
"Lone Ditch in the Cold[r], by Ted Nichol"
"Lone Felon Freer[r], by Florene Fleenor"
"Lone Fix: I Flex On[r], by Elin Fox"
"Lone Id Lied On[r], by Leonid DeLino"
"Lone Leon Leno[r], by Elle Noon" []
"A Lone Pet Antelope[r], by Poet Neal"
"Loners: Ron, Les, Sol, Ren[r], by Lerner Olsson"
"Long Tail Got All In[r], by [if player is male]Gil Alton[else]Lila Tong[end if]"
"Longevity, Tiny Glove[r], by Elyn Voigt"
"Longtime Met-Lingo[r], by Tom Ingle" []
"Look at Kal Too[r], by Kat Loo" []
"Looks for Solo Fork[r], by Flo Rooks"
"Looming in Gloom[r], by Gil Moon & Milo Ong" []
"Loon-Dance Colonnade[r], by [if player is male]Dean Colon[else]Donna Cleo[end if]"
"Loon Got Too Long To Log On[r], by Ol['] T-Goon Otlongo"
"Loony Em[r], by Lo-Money Moloney"
"The Loop Hotel Op[r], by Holt Poe"
"Loose Bandit Blaine Stood[r], by Leonida Bost"
"Loose-Knit, Too Silken: Not Like So[r], by [toti] Klose"
"Loose Lips Spool Lies[r], by [if player is male]Sol Pelosi[else]Lois Lopes[end if]"
"Loot Inset on Toilets Too Silent[r], by [if player is male]Otis Nolte[else]Lois Otten[end if]"
"A Looter Too Real[r], by Lea Root"
"Lootery: Toy Lore[r], by Ry Toole"
"Lord Abe Labored[r], by Rod Beal" []
"Lord Mayor Mr. Rolo Day[r], by Daryl Romo"
"A Lord or Lad[r], by Roald Doral" []
"Lord Rey: Orderly, Dry Lore[r], by Rory Eld"
"Lord Saw a World's Old Wars[r], by Sal Drow"
"Lord Ted's Toddlers[r], by Del Dorst"
"The Lord Told Her[r], by Red Holt"
"Lord Yawp & Lady Prow: Yorpwald Day Prowl[r], by Apryl Dow"
"Lords['] View: Evil Words[r], by Wes Dorvil"
"Lore Infects Reflections[r], by Foster Clein"
"Lorn Coat, Color Tan[r], by [if player is male]Carl Toon[else]Lona Cort[end if]"
"Lorn Days, Rosy Land: Any Lords?[r], by Alys Dorn" []
"Lose Faith Also, Thief: Those Fail[r], by Sofia Helt"
"Losing Cohort Chronologist Nichols Groot[r], by Rico Gholston"
"The Loss Hostels[r], by Les Tosh"
"Lost Ace Locates a Closet[r], by Sal Cote" []
"Lost Achy Holy Cats[r], by Clay Tosh"
"Lost Boys, Bossy Lot[r], by Slyboots" []
"Lost Boys by Stools[r], by Bo Soltys"
"Lost Fair Trails of a Florist: Oral Fits[r], by [if player is male]Sal Forti[else]Ali Frost[end if]"
"Lost Fame to Flames: Last of Me[r], by Amos Felt" []
"Lost Fey Style of[r], by Ty Foles" []
"Lost-Greed Rest Lodge Gets Older[r], by [if player is male]Ted LeGros[else]Ester Gold[end if]"
"Lost Heir: This Role To Relish[r], by [if player is male]Otis Lehr[else]Lori Seth[end if]" []
"Lost Hits Hotlists[r], by Sol Stith"
"Lost Key to Kyle's[r], by [if player is male]Ty Kelso[else]Elsy Kot[end if]"
"Lost-Name Salmonet[r], by [if player is male]Stan Elmo[else]Nola Smet[end if]" []
"Lost Ray Taylor's Ol['] Stray[r], by Sal Troy" []
"Lost Slain Stallions[r], by Alton Liss" []
"A Lost Twin Wants Toil[r], by Loni Watts"
"Lost Vine[r], by Vin Toles-Leviston"
"Losted Old Set[r], by [d-t] Les" []
"Lot I'm In: No Limit[r], by Tim Olin"
"A Lot to Al[r], by Lala Otto" []
"A Lot to LA[r], by Lala Otto"
"Lots Die to Slide[r], by Del Otis"
"Lots View Two Evils Wits Love[r], by Tevis Low"
"Lotta Total Ol['] Tat[r], by Al Ott"
"Lou, Be as Lo-Abuse Soul [a-b][r], by Beau Sol"
"Lou Takes Out Leaks[r], by Luke Tsao"
"Loud Brave Boulevard[r], by Bud Valero" []
"Loud Ice is Delicious[r], by Luci Desio"
"Loud Wars, Soulward[r], by Saul Drow"
"Loudish? I Should[r], by Lu Doshi"
"Louse, I Use Oil[r], by Louise Louise"
"A Louse's Soul-Sea[r], by Lue Sosa"
"Lousy Ebb, Blues Boy[r], by Leo Busby"
"Lovable Bo Valle[r], by Abe Voll"
"Love for Rev. Olof[r], by Flo Vore"
"Love Has a Shovel[r], by [if player is male]Sal Hove & Hal Vose[else]Eva Losh & Val Shoe[end if]"
"Love Hate Vote Heal[r], by Theo Vale"
"Lovebirds['] Sob-Drivel[r], by Bevis Lord"
"Low-Beg Web Log[r], by 'Bowleg' W. Goble"
"Low Fares for Wales[r], by Wes Flora"
"Low Grate: Waterlog[r], by Walt Gore"
"Low Hands Shown, Lad[r], by Hal Downs"
"Low Haters Heal Worst[r], by Theo Rawls-Showalter" []
"Low, I Learn Orwellian[r], by Lola Erwin"
"Low Rated Word Tale[r], by Rod Ewalt"
"Low-Stress Slowsters[r], by Wert Sloss"
"Lowest Towels We Lost[r], by Lew Tso"
"Lowland, Wan Doll[r], by Don Wall"
"LSD Puree Preludes[r], by Les Dupre"
"Lt. Base, Be Last[r], by Al Best"
"Lu's Pa Paul's a Plus[r], by Su Alp"
"Lucid, Sour, Ludicrous[r], by Ruud Cislo"
"Luddites['] LSD-Itude[r], by LISTDUDE"
"Lumbering in, Grumble: Bring Mule[r], by Inger Blum"
"Lushest Sleuths[r], by Tess Uhl" []
"Lust for Lost Fur[r], by Stu Rolf"
"A Lust to Outlast[r], by Saul Ott"
"Luther's Hustler Hurtles[r], by Les Urth" []
"Lutzke's Klutzes[r], by Su Keltz"
"Lyin['] Inly[r], by Ilyi Lynn"
"Lyla Be Label-y: by Ella[r], by Lea Bly" [p]
"A Lyre, Early[r], by Larry Ealey" []
"M'kay, Arm My Karma[r], by Mark May"
"Ma, Icon, In Coma[r], by Monica Camino"
"Ma, This is Math[r], by A. Smith" []
"Ma Threw Mr. Wheat the Warm[r], by Ham Wert"
"Ma, Try My Art[r], by [if player is male]Matty Rymar[else]Tammy Tarry[end if]" []
"Ma, We're Mere, Aw[r], by Em Ware"
"Ma's Gripe-Epigrams[r], by Pa Grimes"
"Ma's Pic is Camp[r], by Scamp Campisi"
"Ma's Rad Madras Dramas[r], by Sam Ard"
"Mac Miller's Small Crime[r], by Sim Marcell"
"Mac, Rub a Crumb-Bum Car[r], by Cam Bur"
"MacLean's Manacles[r], by Sam Lance"
"Mad Bane be a [d-word-u] Bad Name[r], by Ben Adam"
"Mad Binges, Big Amends[r], by Deb Sigman, Meg Sinbad & Gab Mednis"
"Mad Bones, Bad Omens[r], by [if player is male]Bo Madsen[else]Bea Monds[end if]"
"Mad Cash Dash-Cam[r], by Chad Sam"
"Mad for a Drama of a Farm-Do[r], by Mo Farad" []
"Mad Glee Gleamed[r], by Meg Dale"
"Mad Grace's Card Games[r], by Cam DeGras"
"Mad Liar Admiral[r], by Mila Ard" []
"Mad Picks, Kid Scamp[r], by Pam Dicks"
"Mad Winter Twin Dream Writ-Amend[r], by [if player is male]Tim Andrew[else]Wendi Mart[end if]"
"Mafeking Megafink[r], by [if player is male]Mike Fang[else]Kim Fagen[end if]"
"The Magic Game Itch[r], by Meg Chait"
"Magic Key: a Gem, Icky[r], by Mick Gaye"
"Magic Trees Merit Cages[r], by Mac Steiger"
"Magic World? Go, Crawl Dim, Low Grim Cad[r], by Lido McGraw"
"Magma Gee: a Gem[r], by Gemma Gea"
"Magpies, Sage Imp, Same Pig[r], by [if player is male]Sam Gipe[else]Peg Amis[end if]"
"The Magus Games Hut[r], by Gus Mehta"
"The Maid Had Time Amid the Dim Hate[r], by Tad Heim"
"Maid Lee Emailed Limeade[r], by Imelda E"
"Maiden, I Amend[r], by Maddie Nieman" []
"The Mail Hit Lame[r], by Tim Leah" []
"Mailboxes So Mixable[r], by Isobel Max"
"Mailer's Realism is Lamer[r], by Irma Les"
"Maim Lore[r], by Romi Elam"
"Majestic Scam: I Jet[r], by Jim Cates" []
"The Major Other Jam[r], by [if player is male]Joe Marth[else]Jo Mather[end if]"
"Majorities['] Armies: I Jot[r], by Josie Tamir"
"Make Do, OK, Dame?[r] by Mo Dake"
"Making Do: a Kingdom[r], by Kim Dogan"
"Making Up a Pink Mug[r], by Mika Pung"
"Males[r], by Selma Salem"
"Mali, Lima, Mail[r], by Mia Milla & Ammi Lila"
"Malinger, a Gremlin[r], by Mean Girl Erma Ling"
"Malinger, Germinal Maligner[r], by Amir Glen" [p] []
"Malpractice's Clear Impacts[r], by [if player is male]Clem Scarpati[else]Clarice Stamp[end if]"
"Malvina's Vain Slam[r], by Alvin Sam"
"Mama, Rec Macrame[r], by Emma Arc"
"The Man, Dr. Math Nerd[r], by Ned Marth"
"Man, I Try My Train[r], by Tim Ryan"
"A Man So Samoan[r], by Mo Naas"
"Man, with Math, WIN[r], by Tim Hawn-Whitman"
"Man's Flaunted Fundamentals[r], by Stefan Umland"
"Man's Rage Managers[r], by Sam Regan"
"Man's Work: Ask Now, Mr[r], by Mark Snow"
"Manage a Nag, Me?[r] by Meagan Gaeman"
"Mandibles, Able Minds, Sin, Bedlam[r], by [if player is male]Denis Lamb[else]Deb Sliman[end if]" []
"Manic-Gasp Campaigns[r], by Mica Spang"
"The Manic Mean Itch[r], by Tim Hance"
"Manifesto of Inmates[r], by Tomas Fine" []
"Mankind and Mink[r], by Dann Kim"
"Manlier Mineral Railmen[r], by Al Merin" []
"Manlike? Lamenik[r], by Kim Neal" []
"Manly Cheek? Many Heckle[r], by Helen McKay"
"Manor O['] Maroon[r], by Namoor Romano" []
"Many Cited Mendacity[r], by Dita McNey"
"Many of Us May So Fun[r], by Fay Munos"
"Many Tell Mentally[r], by [if player is male]Ly Mantel[else]Lyn Telma[end if]"
"Map in Desk: Speak, Mind[r], by Skip Amend"
"Maples['] Elm Sap Sample, Slap Me[r], by Pam Les" []
"Mapmakers: Spark [']Em, Ma[r], by [if player is male]Samar Kemp[else]Emma Parks[end if]"
"March in, Rich Man Mr. China[r], by Mac Hirn"
"Marci's Racism[r], by Sir Mac Cairms"
"Marg My Grammy[r], by Gamy Mr. A. Grymm"
"Mark of OK Farm[r], by Ma Fork"
"Mark One Monk Era[r], by Ken Mora-Romanek"
"Mark Thee the Maker[r], by Kath Emer"
"Markets: Ma's Trek[r], by Em Stark"
"Marlette's Streamlet[r], by Matt Sleer"
"Marquees Mas Queer[r], by Em Square" []
"Marriage: a Grim Era[r], by Amie Garr"
"Marseille: A Smellier Slier Male[r], by [if player is male]Al Meisler[else]Ellie Mars[end if]"
"Martha's Art-Sham[r], by [if player is male]Sam Hart[else]Tam Sahr[end if]"
"Marty-Jo's Story Jam[r], by Joy Smart"
"Marxist Tram Six[r], by Max Rist"
"Mary, Be My Bear[r], by Em Bray"
"Masonry To Astronomy[r], by [if player is male]Omar Tyson[else]Rosa Monty[end if]"
"Mass-Id Sadism[r], by Sid Sam"
"The Mast Sat Them[r], by Matthes Stetham" []
"Match by My Batch[r], by Cym Bath"
"Matches: The Scam[r], by Cam Tseh" []
"Materialistic, Satirical Time[r], by Mattie Carlisi"
"Maternity: a Tiny Term[r], by Tami Tyner"
"Math Fer The Farm[r], by Father M"
"Matheis: His Mate, Tame-Ish[r], by Tim Shea" []
"Mathy? My Hat! A Myth! Thy Ma![r], by Ty Ham"
"A Matter: Meta-Art[r], by Matt Rea"
"Maturing Grim Aunt[r], by Trina Gum"
"Maunder, Rude Man[r], by Ned Maur"
"Mauro's Amours[r], by Su Mora"
"Maw's Li'l Sawmill[r], by Will Sam"
"Maxims : Ma's Mix[r], by Ax Mims"
"May Second: Some Candy, Many Codes[r], by [if player is male]Cody Means[else]Dyan Cosme[end if]"
"Maybe Do My Abode, Bay Dome[r], by Mae Boyd"
"Mb. If U, Um, Fib[r], by Fifi Bumbum"
"McShane, a Mensch[r], by Sam Chen"
"Me, a Blot to Blame[r], by Tom Beal" []
"Me, a Gym: My Game[r], by Meg May"
"Me and Ad Men Amend[r], by Dede Ammann" []
"Me, Archangel, Charlemagne[r], by [if player is male]Herman Cagle[else]Megan Rachel[end if]"
"Me, I Rust, Mustier[r], by Sue Trim"
"Me, Mayor: a Memory[r], by [if player is male]Roy Emma[else]Mary Moe[end if]" []
"Me, Tiny Enmity, Ye Mint[r], by Tim Ney"
"Meager Mr. Agee[r], by Meg Rea"
"Mean Dark Mandrake[r], by Mark Dean"
"Mean Folks, False Monk[r], by Flo Manske"
"Mean-Guts Aunt Meg's[r], by Gus Ament" []
"Mean, Mad, Man-Made[r], by Dan Emma"
"Mean Ol['] Man Leo Malone[r], by Len Mao"
"Mean Seeks a Meekness[r], by Sean Meske"
"Mean Short Hoster Man[r], by [if player is male]Homer Nast[else]Sam Thorne[end if]" []
"Mean Tot Meant to Team? Not[r], by [n-t] Tom"
"Mean Words, Demon Wars, Now Dreams[r], by [if player is male]Drew Mason[else]Dawn Morse[end if]"
"Meander, Renamed Amender[r], by Mad Rene Deerman"
"Measles Seals Me[r], by [if player is male]Les Ames[else]Sam Seel[end if]"
"Measured Dream Use[r], by Maud Rees"
"Measuring Geraniums[r], by [if player is male]Gus Manier[else]Agnes Muir[end if]"
"A Mecca, Doomed[r], by Doc Mae Macedo"
"Medal of Old Fame[r], by Flo Mead"
"Medaling, Maligned[r], by [if player is male]Al Deming[else]Madge Lin[end if]"
"Medals to Old Mates[r], by Tom Dales"
"Media St.: It's Made[r], by Tim Eads"
"Mediocre Micro Dee[r], by Moe Redic" []
"Meet, Sojourn: Just One More[r], by Jo-Sue Merton & Junee Ostrom"
"The Mega-Heat Gem[r], by Tam Ghee"
"Mega-Snivel Evangelism[r], by [if player is male]Melvin Sage[else]Megan Slive[end if]"
"Meh, Crabs['] Chambers[r], by Mab Resch"
"Meh, Toss Moss the Hot Mess[r], by Tom Hess"
"Meinhardt's Hardiments[r], by [if player is male]Dash Minter[else]Mandi Herst[end if]"
"Melba's Ambles[r], by Lem Bas"
"Melbourne: One Rumble, Bluer Omen[r], by Bruno Mele & Leo Number" []
"Melisa Emails a Smile[r], by Amelia Lessim"
"Melisa Emails Ma Lies[r], by Esmail Maisel" []
"A Mellow Lame Owl: Allow Me[r], by Moe Wall"
"Melodrama Made Moral[r], by [if player is male]Adam Morel[else]Emma Lardo[end if]"
"Melt a Metal, Tame Mallet[r], by Alla Emmett"
"A Melting Ligament[r], by Milt Egan"
"Members Only: Somberly, Men[r], by [if player is male]Bryson Lemme[else]Beryl Emmons[end if]"
"Memoir: I'm More[r], by Mo Meir"
"Memoir Plus Lorem Ipsum[r], by Elmo Primus"
"Memory Can't Cry a Moment: Commentary[r], by [if player is male]Tommy Crean & Monty McRae[else]Tammy Corne & Emmy Carton[end if]"	50
"Memos Unto Mute Moons[r], by Mose Mount"
"Men Ask It: Mistaken![r], by Kent Amis"
"Men Grow [']Em Wrong[r], by Gwen Mor"
"Men Loath A Menthol-Methanol[r], by Hotelman Lon Mehta" []
"Men, Shoot the Moons[r], by Shon Mote & Honest Mo"
"Men's Epic Specimen[r], by Sim Pence"
"Men's Woe Now Seem New, Some[r], by Wes Moen"
"Mend Our Mourned Dour Men[r], by [if player is male]Moe Durn[else]Noe Drum[end if]"
"Mend Richly, My Children[r], by Mercy Lindh"
"Menial, Mainline, Lame[r], by Melina Elamin"
"Menials['] Seminal Lies, Man[r], by Liliana Semmens"
"Mentions: None Smit[r], by Tim Sonne"
"Merciful M. Lucifer[r], by Leif Crum" []
"The Mercy-Cry Theme[r], by Chet Remy"
"Mere Gags at Great Games[r], by Marge Gates"
"Mere? No, Enorme[r], by Ron Mee & Mo Rene"
"Mere Room, Me, or More[r], by Mo Roemer" []
"Mere Sin: Men's Ire, Me, Risen[r], by Meisner Meiners" []
"Meredith the Mired[r], by Ted Riehm"
"Merely Lame Year[r], by [if player is male]Al Emery[else]Marylee Remaley[end if]" []
"Merge No Ogre Men[r], by Mo Green"
"[']Merica: a Crime[r], by Marcie Camire" []
"Meritocracy: a Comic Retry[r], by Torie McCray"
"Merman Grange[r], by German Engram-Magner"
"Merry Con: My Corner[r], by Ron Mercy"
"Merson's Sermons[r], by Ren Moss"
"Meshiest Smithees[r], by [if player is male]Tim Hesse[else]Tess Heim[end if]"
"Mess Bay Embassy: Mass Bye, My Bases[r], by Bess May"
"Mess With the Swims[r], by Wes Smith"
"Messiah Nut Enthusiasm[r], by [if player is male]Hunt Massie[else]Shanti Muse[end if]" []
"Metabolism Omits Blame[r], by Tammi Boles"
"Metadata: a Tad Tame[r], by [if player is male]Adam Tate[else]Ada Matte[end if]"
"Metal Pest Templates[r], by Pam Settle" []
"A Metal Tamale[r], by Tamela Almeta"
"Metaphysic Impacts, Hey: My Pastiche[r], by Macy Speith"
"Metcalf Left, Mac[r], by Cam Felt" []
"Mew a Lot, Low Mate[r], by Walt Moe"
"Mexico E-Comix[r], by Mei Cox"
"Mia's Aims: Siam[r], by Sami Amis" []
"A Mic, I Cam[r], by Mica Maci" []
"Michelle's Schlemiel[r], by Clem Hisle"
"Mick Rave, Maverick[r], by Kev Cimra"
"Microfloral Coralliform[r], by Friar Collom"
"Midst Hub, Thumb Dis[r], by Bud Smith"
"Midwest Dew-Mist[r], by Dim Stew Wimsted"
"Migraine Imaginer[r], by Amie Ring" []
"Migraines Raising Me[r], by [i-n] Grimes"
"Miguel's Smug Lie[r], by Sue Glim"
"Milady's Sly Maid[r], by Slim Day"
"Mild, Bo? I'm Bold[r], by Di Blom"
"Mild Row[r], by Wlodmir Wildmor"
"Mildest, Mist-Led[r], by Del Smit"
"Milk Cries: Limericks[r], by Slick Emir Rick Miles"
"Milk for Rim Folk[r], by Kim Flor"
"Milk, Honey, Elk, Hominy, Homely Kin[r], by [if player is male]Milo Hynek[else]Emily Kohn[end if]"
"Milk of Mo['] Filk[r], by Flo Kim"
"Milk, Soup: OK, I Slump[r], by [if player is male]Kip Solum[else]Lois Kump[end if]"
"Milker Kilmer[r], by Mikki Merrell"
"Minaret Raiment[r], by Martine Armenti" []
"Mincemeat: Men, It Came[r], by Timm Neace"
"Mind-Trap, [d-word-u] Trip[r], by Pam Rindt"
"Minecraft: Me, Frantic[r], by Tim France"
"Minerva, a Vermin[r], by Marvin E. Van Mier"
"A Minger, Mangier[r], by Mariam Greening"
"Mini Lols? Millions[r], by Slim Olin" []
"Mini-Moon, I'm On[r], by Moni Mino" []
"A Minimal Mailman, I[r], by Mia Milan"
"Mink-Dog Kingdom[r], by Kim Gond"
"Minks Leak Snake Milk[r], by Ken Klimas"
"Minnesota Nominates No Inmates[r], by Stan Noemi"
"The Minor Hero Mint[r], by [if player is male]Tim Horne[else]Mei North[end if]"
"Minotaurs? I, a Nostrum[r], by Naomi Rust"
"Mire Folk Filk More[r], by Mike Rolf"
"The Mire: I'm There[r], by Tim Rhee"
"The Mirror-Him Terror[r], by Torri Rehm"
"Mirth, a Keg: Make Right[r], by Mike Garth"
"Miscaption Impactions[r], by Pati Scomin"
"A Misclick: Sick Claim[r], by Mick Scali"
"Misdealt Medalist[r], by [if player is male]Tim Slade[else]Lea Smidt[end if]" []
"Misdone to Demotions[r], by [if player is male]Tom Edison[else]Enid Smoot[end if]"
"Miserably by Realism[r], by [if player is male]Emil Byars[else]Sybil Amer[end if]" []
"Miseri is Emir[r], by Em Iris"
"Misrender Reminders[r], by Red Misner"
"A Missing Magi Sins[r], by Isis Mang"
"A Misstep: Pastimes[r], by Pam Estis" []
"Mist Canyon: Manic Stony Sanctimony[r], by Simon Canty"
"Mist Over a Movie Star[r], by [if player is male]Travis Moe[else]Evia Storm[end if]"
"Mist-Smit Mt. Miss-It[r], by Tim T. Sims"
"Misused: MD Issue?[r], by Sim Deus"
"Mitch Found Much to Find[r], by Dot Finchum"
"Mitcham's Mismatch[r], by Si McMath & Mac Smith"
"Mm, Deary, My Dream[r], by Emmy Ard"
"MM, I Rose Mom's Ire: Memoirs[r], by Sim More"
"Mo's Direr Misorder[r], by Ed Morris"
"Mo's Rant Transom[r], by Mort-San Marston-Stroman"
"Mo's Wrath: How Smart[r], by Sam Worth"
"Mo['] Cart to Cram[r], by Mottram Rocca"
"Mo['] Creaky? A Mockery[r], by Marco Key"
"Mo['] Crust: Mr. Scout, Ms. Court[r], by Tom Crus" []
"Mo['] Rigs So Grim[r], by Si Grom"
"Mo['] Sins in Moss? No, Miss Simons[r], by Ms. Sion Simson"
"Mo['] Vibes: B-Movies[r], by Bev Isom" []
"Moan Gee: One Game, Mean Ego[r], by Gene Mao"
"Moan, Nat 'Not-a-Man' Montana[r], by Anna Tom" [p]
"Moaner or Mean?[r] by [if player is male]Monroe Manera[else]Reena Moorman[end if]"
"Moaner Ren Mao, Meaner Maroon[r], by Remona Mareno" []
"Moaning Man Gino[r], by Naomi Ng"
"Mob-Size Zombies[r], by Oz Bemis" []
"Mobocracy: Cry Boo, Mac[r], by [if player is male]Rocco Byam[else]Coco Mabry[end if]"
"Mobs['] Yen: Men, Boys, Omens by My Bones[r], by Mo Bynes"
"Mock Dive, [dick-u] Move[r], by Vic Domke" [x]
"Mockery is Risky, Come[r], by Rick Moyes"
"Mod Racy Army Doc[r], by Mad Cory Carmody"
"Model the Old Theme[r], by Ted Holme"
"Models Seldom Meld So[r], by Dom Les"
"Moderated Dream-Dote[r], by Ted DeRamo"
"A Modern Dream: No Admen or No Armed Roadmen[r], by Ed Moran & Dan Rome" []
"Modern Teens Need Mentors['] Endorsement[r], by [if player is male]Emerson Dent[else]Deneen Storm[end if]"
"Moisture's Mouse, Stir[r], by Teri Musso"
"Molasses Lassos Me[r], by Sal Moses"
"Molby's Symbol[r], by Sy Blom"
"Mold in the Moth-Lined Nil-Method Idle Month[r], by Tim Holden"
"Mold Thy Old Myth[r], by Tom Hyld"
"Mollify [']Im, Folly: of My Ill[r], by Milo Fly"
"Molly Ran Normally[r], by Arny Moll" []
"A Molten Telamon[r], by Tom Neal-Almonte"
"Mom, Deny My Demon[r], by Don Emmy"
"Monasterial Ameliorants[r], by [if player is male]Salim Renato[else]Alison Marte[end if]"
"Money's My Nose[r], by Semyon Moynes"
"Mongillo's Goon Mills[r], by Ling Olmos"
"Monitor Naif Information[r], by Mario Finton & Afton Morini"
"A Monk: OK, Man[r], by Koko Ammann"
"Monsieur Inermous[r], by [if player is male]Simon Ure[else]Sue Minor[end if]"
"Monstrosity: Inmost Story[r], by Otis Nystrom & Tory Stimson"
"Montague's Age Mounts[r], by Mungo East"
"Montgomery's Gory Moments[r], by Tommy Gonser"
"Month, Meet the Moment[r], by Tom Nemeth"
"The Moods: Hot Demos[r], by Seth Odom"
"Moody's Sodomy[r], by Sy Odom"
"Moon-Panic Companion[r], by Nino Campo"
"The Moon's Omen-Shot[r], by Tom Shoen" []
"Moonside Dominoes[r], by Mo Edison" []
"Mootest Mottoes[r], by Tom Seto"
"Mopey Else Ye Sleep Mo['], Employees[r], by Posey Elem"
"Mopheads['] Mad Hopes[r], by Pam Hodes"
"Mopiest Man Pantomimes[r], by Noemi Stamp"
"Morally Loyal Mr. Ray Moll[r], by Mary Oll"
"Morbid Dim Rob[r], by Mo Bird"
"More-Class Scams Lore[r], by [if player is male]Carl Moses[else]Elma Cross[end if]"
"More Faith, Hermit Oaf[r], by Tami Hofer" []
"More Pews, Moper Wes[r], by Em Powers" []
"More Space: Romp, Cease, Some Recap[r], by [if player is male]Casper Moe[else]Mae Crespo[end if]"
"More Taxes, Rote Exams[r], by Rex Moates & Max Rosete"
"More Than the Manor or Anthem[r], by Ron Hamet" []
"Mortar Maggot[r], by Margot Gotram"
"A Mosh to Moats, Oh[r], by Ham Soto"
"The Moss Stems, Oh[r], by Tom Hess" []
"Most Curs['] Scrotums[r], by Curt Moss"
"The Most-Hot Stem[r], by Tom Tesh"
"Most Lie to Slime[r], by [if player is male]Tim Sole[else]Mei Olst[end if]"
"Most Lie to Smile[r], by Mel Otis" []
"The Most Raw Who Matters[r], by Homer Watts"
"Most Vile Love Mist[r], by Emil Vost"
"Motel Spy Ptolemy's Sly Tempo[r], by Tom Pyles"
"Moth-Eaten to Methane: Not a Theme[r], by Moe Hatten"
"A Mother: Roam the Heart Mo['][r], by [if player is male]Tom Hare[else]Mae Hort[end if]"
"Motliest Lost Time[r], by Miles Ott"
"Motown's Tom Snow[r], by Wm. Snoot"
"Mountainside Un-Mediations[r], by [if player is male]Austin Domine[else]Dionne Matsui[end if]"
"Mourn, Stoic Consortium[r], by [if player is male]Tom Rusconi[else]Cris Mouton[end if]"
"Mourned [']N Rude Mo Dunmore[r], by Ned Orum" []
"Mousy St. So Musty[r], by Susy Tom"
"Move Icy, My Voice[r], by Vic Moye"
"Move Til Mt. Olive[r], by Tim Love"
"Mr. Abe, a Bar Member[r], by Amber Bream" []
"Mr. Ade's Dreams[r], by Medders Armas" []
"Mr. Art be At Me, Brr[r], by Bertram Rambert"
"Mr. Cain's Narcism[r], by Marc Sin"
"Mr. Cobie Crombie[r], by Mo Brice"
"Mr. Diode Did More[r], by Rod Diem"
"Mr. Eero's Remorse[r], by Em Serro"
"Mr. Hou's Humors[r], by Mo Rush" []
"Mr. Ingle, Gremlin Mingler[r], by Len Grim"
"Mr. Lane, a Real Man[r], by Marlena LaMarne" []
"Mr. Manifest-Firmaments[r], by [if player is male]Mats Fremin[else]Tammi Ferns[end if]"
"Mr. Not-As-Smart on Matrons[r], by Sam Torn" []
"Mr. Oates: Some Art Maestro[r], by Rose Tam" []
"Mr. Ocean's Romances[r], by Sam Corne"
"Mr. Pete's Tempers[r], by M. Streep"
"Mr. Pie-Prime[r], by Pepi Rimmer"
"Mr. Pile's Simpler Prelims[r], by Mel Pris"
"Mr. Rios or Sir M[r], by Ms. Rori Morris"
"Mr. Tate's Matters[r], by Art Mest" []
"Mr. Theo's Mother's Thermos[r], by Tom Sher"
"Mr. Yob, My Bro[r], by Roby M. Ormby" []
"Mrs. Tea-Master[r], by Terresa Stamm"
"Ms. Bustle-Stumbles[r], by Tess Blum"
"Ms. Dole Seldom Sold Me Models[r], by Lem Sod" []
"Ms. Mingle-Lemmings[r], by Glen Mims"
"Mt. Shy Myths[r], by Ty 'SMH' Smyth"
"The Mud Med Hut[r], by Ed Thum-DeMuth"
"Muddier Druid, Me[r], by Mei Rudd"
"Mulrooney's Enormously Lemony-Sour[r], by [if player is male]Lon Seymour & Reynoso Lum[else]Lorey Osmun[end if]"
"Munch as Mush Can[r], by Sam Chun"
"Mundane Duneman[r], by Ned Manu"
"Murkiness, Resin, Musk[r], by Kim Nusser"
"Muse-Loci Coliseum[r], by Luci Mose"
"Mush By My Bush[r], by Shy Bum Ms. Huby"
"Muskrat at Murks[r], by Stu Mark & Kam Rust"
"Musty-Odor Study Room[r], by Rudy Smoot"
"Musty Rag, Smart Guy[r], by Gus Marty"
"A Musty, Um, Stay[r], by Stu May"
"A Mutt? Tut, Ma Tatum![r] by Matt U"
"My, a Loan Anomaly[r], by Alan Moy"
"My Ales Slay [']Em[r], by Les May"
"My Amusing Gymnasium[r], by [if player is male]Sammy Guin[else]Amy Mingus[end if]"
"My Angle: Lean Gym[r], by Mel Yang"
"My Ann[r], by Manny Nyman"
"My Art, or to Marry[r], by [if player is male]Rory Tam[else]Mary Ort[end if]" []
"My, As I Say I'm Si May[r], by Missy Amayi"
"My Bills by Li'l Ms[r], by Slim Bly"
"My Boat By Moat[r], by Tom Bay"
"My Cap, Campy[r], by MC Yap"
"My Card, Dry Mac[r], by Maddy McCrary" []
"My Care: a Mercy[r], by [if player is male]Mac Rey[else]Maye McCreary[end if]"
"My Cat is a Mystic[r], by Tim Casy"
"My Cats['] Sty, Mac[r], by Ms. Tacy St. Macy"
"My Class? Sly Scam[r], by Cass Lym"
"My Clean Clay Men[r], by Len Macy & Al McNey" []
"My Clear Calm Rye[r], by Marc Ley"
"My Coarse Sycamore[r], by Rose Macy" []
"My Dirt, Dmitry[r], by Dry Tim"
"My Drug: Dry Gum[r], by DRM GUY"
"My Earth Era Myth[r], by Mr. Hatey"
"My Failed Family-Ed[r], by Amy Field" []
"My Fails: a Flimsy Film, Say[r], by Slim Fay"
"My Faith, If a Myth[r], by Tim Fahy"
"My Hand's Damn Shy[r], by Sam Dynh"
"My Hands [d-word-u] Shy[r], by Sam Hynd"
"My Hole, Homely[r], by Mel Hoy"
"My Horse More Shy[r], by Moe Rhys"
"My Hot Pal Polymath[r], by Hoyt Lamp"
"My Ice-Hot City Home[r], by Mitch Yeo"
"My Idea May Die[r], by Mei Day & Meda Yi"
"My Ideas: Deism, Ay, Ye Maids[r], by Sid Maye"
"My Lane: Any Elm[r] by Len May" []
"My Last Alm Sty[r], by Lt. Mays"
"My Lone Elm Yon[r], by Lemony Lyn Moe"
"My Lone Only Me[r], by Len Moy" []
"My Matrices, Asymmetric[r], by [if player is male]Timmy Cesar[else]Misty McRae[end if]"
"My, Maud, a Dummy[r], by Dy Muma"
"My Name is Sam Yenim[r], by Mia Mynes"
"My Nickel McKinley[r], by Kim Clyne"
"My Oath: Yo, Math[r], by Tom Hay"
"My Orbit: Mob, I Try, Trim Boy[r], by Tom Irby"
"My Other Home Try[r], by Tom Hyre"
"My Papers, Ms. Yapper[r], by Myra Epps"
"My Peace Came, Yep[r], by Macy Pee"
"My Plague: Gamely Up, Lumpy Age[r], by [if player is male]Guy Maple[else]Meg Pauly[end if]"
"My Range, Grey Man[r], by Meg Ryan"
"My Rant: Try, Man![r] by Tamryn Rymant"
"My Rat Marty[r], by Myrta Tamyr" []
"My Richest Chemistry[r], by Misty Cher"
"My Salient Misty Lane: Tiny Meals[r], by [if player is male]Myles Tian[else]Linsey Tam[end if]"
"My Scare: Screamy Marc, Yes[r], by Cyr Ames"
"My Seats: a System[r], by [if player is male]Sam Esty[else]Tess May[end if]"
"My Sheep Hypes Me[r], by Shep Mey"
"My Short Mosh Try[r], by Tom Rhys"
"My Spite is Empty[r], by Tim Espy" []
"My Tea's Steamy[r], by Ty Ames"
"My Tears Stray [']Em, Mr. Yates[r], by Ty Mears" []
"My Tears['] Mastery: Yes, Mart[r], by [if player is male]Trey Sam[else]Myra Tse[end if]" []
"My, the Methy Thyme[r], by Ty Ehm"
"My Toad, Mad Toy[r], by Tom Day & [d-t] May"
"My Tongue? Guy, Not Me[r], by Meg Yount"
"My Tons Hip Hypnotism[r], by Tony Shimp"
"My Tower: Wry Tome[r], by Ty Merow"
"My Trail to Mortality: Rail, My Tot[r], by [if player is male]Tim Taylor[else]Lori Myatt[end if]"
"My Valises, Massively[r], by [if player is male]Sam Slivey[else]Avis Myles[end if]"
"My Water, Wry Mate[r], by Mary Tew"
"My World: Mold, Wry[r], by Myrl Dow"
"Myotic Comity[r], by Tim Coy"
"Mysterious Stories, Yum[r], by [if player is male]Timo Russey[else]Misty Rouse[end if]" []
"Nag, Howl, Hang Low[r], by Hal Wong" []
"Nag or Groan[r], by [if player is male]Ron Gargano[else]Rona Grogan[end if]" []
"Nag-Trick Tracking[r], by Rick Gant"
"Nah, Must Shut, Man[r], by Sam Hunt"
"Nah, Old Hand, Lo, Land Ho![r], by Dan Ohl-Haldon"
"Naifest Fansite[r], by Estifan Stefani"
"Nail Burt, Turn Bail: Urban Lit[r], by Art Lubin" []
"Name For One Farm Foreman[r], by Fran Moe"
"The Name He Meant[r], by Mae Neth"
"Name of No Fame[r], by Moe Fan"
"Nana Gege[r], by Anne Gage" []
"Nap More, Repo Man[r], by Pam Reno"
"Nap Til I Plant[r], by Pat Lin"
"Naptime's Aim Spent[r], by [if player is male]Tim Snape[else]Pam Stein[end if]"
"Narc to Contra, or Can't Co-Rant[r], by Carton Atcorn"
"Narcolepsy-Only Capers[r], by [if player is male]Percy Sloan[else]Lacy Posner[end if]"
"Narcs or Rancors[r], by [if player is male]Son Carr[else]Ros Carn[end if]"
"Nastiest Sin-Taste[r], by Tina Tess"
"Nasty Day: a Dynasty[r], by Andy Tsay"
"Nat [']N Co Cannot[r], by Canton Conant"
"Nat Goes, Sean Got on Stage[r], by Geo Nast" []
"Natal-Point Plantation[r], by [if player is male]Alton Patin[else]Patti Nolan[end if]"
"Natatorium Maturation[r], by Tatia Munro & Amina Trout"
"Nate, Be Beaten[r], by Annetta Beebe"
"The Nation: A Thin Note[r], by Tito Henna"
"Nations['] Tide Instead Into Inane Dittos[r], by [if player is male]Denison Tait[else]Andie Sitton[end if]" []
"Natural Nut Lara[r], by Al, A Runt & Taran Lu" []
"Naturals Turn, Alas[r], by [if player is male]Raul[else]Lura[end if] Nast" [x]
"Nature's Saunter[r], by Ernst Au"
"Near East Nest Area[r], by Tana Rees"
"Near Erna[r], by Rene Aran"
"Near Mr. Mean[r], by Maren Erman" []
"Near Old Leonard and Erol[r], by Don Lear" []
"Near Pop on Paper[r], by Noe Rapp"
"Near Soil So Linear[r], by Ali Rosen"
"Neat Big Beating: It Began[r], by Abi Gent" []
"Neat Irks a Stinker[r], by Risa Kent" []
"Nebraska: Bask Near Bane's Ark[r], by Ken Baars"
"Neck Pain, Pink Acne[r], by Nina Peck"
"Necropolis Solo Prince[r], by [if player is male]Colin Soper[else]Loni Crespo[end if]"
"Nectared Decanter, Recanted[r], by Ted Crane"
"Ned, a Hip Pinhead[r], by Enid Hap"
"Ned's Lyric Cylinders[r], by Cris Lynde"
"Ned's Ma Amends[r], by Dede Massmann" []
"Nedster Tenders Dr. Steen[r], by Dre Enst & Ed Stern"
"Needers Sneered, Seen Red[r], by Ned Rees & Sed Rene"
"Needily Yen, Idle[r], by Enid Ley"
"Needler Del Erne[r], by Len Reed"
"Needles['] Lendees[r], by Les Eden"
"Needy Al Delaney[r], by Andy Lee"
"Nefertiti's Entire Fits[r], by [if player is male]Terin[else]Trine[end if] Feist"
"A Neg, Ange[r], by Gena Egan" []
"Neighbors, He's Boring[r], by [if player is male]Herb Goins[else]Inge Brosh[end if]" []
"Nemo's Meson Omens[r], by Moses Menon"
"Neon Memo, Omen on Me[r], by Nemo Nome"
"Neorealistic Lectionaries[r], by [if player is male]Ernesto Cilia[else]Leticia Norse[end if]"
"Nepo? NOPE[r], by Pepe Noon"
"Nerd, Sow Downers[r], by Wes Dorn" [p] []
"Nerd to Trend-O: Ed, Torn[r], by [if player is male]Trent Redondo[else]Donnette Dorr[end if]" []
"Nerdage Rage, End[r], by Reg Dean & Ed Regan" []
"Nerdier Naiad Air Den[r], by Nerida & Adrien Naderi" []
"Nerdy Bum: My Burden[r], by Ned Byrum"
"Nereid Denier[r], by Derien Indree"
"Nerf Ball: Barn Fell[r], by Fran Bell"
"Nero the Thereon Not Here[r], by Rhet Eno" []
"Nerve to Veer Not[r], by Rev. Teno Ventore"
"Nerves, Fool: Floor Seven[r], by Evon Flores" []
"Nerviest? Reinvest[r], by Vi Ernest"
"Nervously Lone Vyrus[r], by Roselyn Vu"
"Nervy? Fie, Very Fine[r], by [if player is male]Ervin Fey[else]Fern Ivey[end if]"
"Nervy? Fie, Very Fine[r], by Fern Ivey"
"Nesbit is Bent[r], by Ennis Tibbets"
"Net Meager Agreement[r], by [if player is male]Gene Marte[else]Garnet Mee[end if]"
"Nets Did Distend[r], by Sid Dent"
"Nettin['] Intent[r], by Nitti Tennent"
"Neuralgia, Rule Again[r], by [if player is male]Reagan Liu[else]Angie Raul[end if]"
"Neurotics['] Nice Tours[r], by Si Cureton" []
"Nevan Ave.: Even a Van[r], by Evan Vane"
"Never Ask, Ever Sank[r], by Ken Veras"
"Never Mask Even MArks[r], by Keven Mars"
"Never to Rot, Even[r], by Trevone Everton" []
"New Aura, Unaware[r], by Erna Wau"
"New Coats: Scant Woe[r], by [if player is male]Ace Towns[else]Cat Owens[end if]"
"New Day Yawned[r], by Dwayne Dawney"
"New Girl Grew Nil[r], by Lew Ring"
"New Goon Gone Now[r], by Gwen Ono & Noe Wong"
"New I Sat, Sweatin['][r], by Wes Tian"
"New Ideas, Snide Awe[r], by [if player is male]Wade Nies[else]Edie Swan[end if]"
"New Job Now, Jeb[r], by Jon Web"
"New Kilts['] Twinkles[r], by Link West"
"New Labels Swell? Bane[r], by Belle Swan"
"New Li'l Beg: Well Being[r], by Ewing Bell"
"New Pig in Winnipeg[r], by Gwen Pini"
"New Sod Endows No Dews[r], by Ed Snow"
"New Year: We Yearn[r], by Ewen Ray"
"Newbies Be Swine[r], by Ben Wise"
"Newbies['] Wee Bins[r], by Wes Bein & Ben Wise" []
"Newborn Bronwen[r], by Bo Wrenn" []
"Newest Tweens[r], by Tweet Swensen"
"Newish Whines[r], by Wen Shi"
"Nice Boy Bein['] Coy[r], by Cobi Ney" []
"Nice, or JET: Rejection[r], by [if player is male]Jon Tierce[else]Jeri Conte[end if]"
"Nice Smells Scene Mills[r], by Clem Sinsel"
"Nice Wart Can Write[r], by Traci New"
"Nicely, Lynice[r], by Cicely Linney" []
"Nicely Slam Miscellany[r], by [if player is male]Lyman Celis[else]Elsy McLain[end if]"
"Nicer Song Censoring Rings Once, Cringes On[r], by Ren Scogin"
"Nicest Boy Obscenity[r], by Tyson Bice"
"Nick's Lot: to Clinks[r], by Lin Stock" []
"Nigel the Night Eel[r], by Eli Ghent"
"A Night Nigh At Hating[r], by [if player is male]Ian High-Gantt[else]Gigi Thanh-Tan[end if]" []
"Nightless Lightness[r], by St. English"
"Nightmare Germ: a Hint, the Margin[r], by [if player is male]Garth Mein[else]Meg Nihart[end if]"
"Nika, Akin[r], by Anna Kiki" []
"Nil-Anger Learning[r], by Ira Glenn"
"Nine Best Teen Bins[r], by Ben Stein"
"Nine Loser One-Liners[r], by Lorie Senn" []
"Nine Mime Mine[r], by Em Minnie"
"Nine Sots['] Tensions is Tonnes[r], by Otis Senn"
"Nine Sound Innuendos[r], by Dion Nunes"
"Nine Sour Reunions: Ronni, Sue[r], by [if player is male]Rio Nunes[else]Sunni Roe[end if]"
"Nineties, Einstein[r], by Ines Tien"
"Nip, Scathe: Chest Pain[r], by [if player is male]Pat Schein[else]Steph Cain[end if]" []
"Nitsche's Snitches[r], by Tess Chin"
"Nixed Ole Exile Don[r], by Lee Dixon"
"No Apology: A Nopology[r], by Paolo Yong"
"No Arid Inroad[r], by Dorian Ardoin"
"No Armies Remain So[r], by [if player is male]Simon Rea[else]Erin Amos[end if]"
"No Armies Remain So[r], by Mina Rose" []
"No Bars or Bans[r], by Sabra Bronson & Rosanna Robbs"
"No Beads Based on Bad Ones[r], by Dan Bose" []
"No Blade, Old Bean[r], by Don Beal"
"No, Blame One Lamb, Noble Ma[r], by Lon Beam"
"No-Blamers Snob Realm[r], by Lamberson Rosenbalm" []
"No Blurting, Burlington Goblin Runt[r], by Gil Brunton"
"No Boat Ran on Oat Bran[r], by Anton Bora"
"No Boost to Noobs[r], by Bo Snoot"
"No Bread, Drab One[r], by Ben Roda"
"No Break, O Banker[r], by Rob Kane & Abner Ko"
"No Brief Bonfire of Brine[r], by Rob Fine"
"No Bright Thing, Bro[r], by Rob Night" []
"No Calf of Clan Falcon[r], by Flo Anc"
"No Cheaper Ache-Prone Chaperone[r], by Hope Crean"
"No-Chores Schooner[r], by Rose Cohn"
"No City, TinyCo[r], by Nic Toy"
"No Dark or Dank[r], by Konrad Akdorn"
"No Depth the Pond[r], by Ned Hopt & Ted Phon"
"No Dreams or Amends as Modern[r], by Mad Soren Soderman"
"No Eclat to Clean[r], by Al Conte & Nat Cole"
"No Eighth High Note[r], by Theo Hing"
"No Email, I'm Alone[r], by Mae Olin"
"No Emir in Rome[r], by Normie Merino"
"No Eyes See Yon[r], by Enos Ye"
"No Fad of DNA[r], by Dodo Fanfan"
"No Fakers: Forsaken Foe Ranks[r], by [if player is male]Frank Seo[else]Fern Sako[end if]" []
"No Fear of Near[r], by Reena Aronoff" []
"No Fevers of Nerves[r], by [if player is male]Von Frees[else]Fern Vose[end if]"
"No Firmer Informer[r], by Fern Miro"
"No Flirt or Flint[r], by Lin Fort"
"No Forest Soon: Fret[r], by [if player is male]Enos Fort[else]Noe Frost[end if]"
"No Fray of Yarn[r], by [if player is male]Roy Fan[else]Fran Yo[end if]"
"No Freaks Forsaken[r], by Kera Fons" []
"No Friend of Dinner[r], by Dino Fern"
"No Fudge: Go Unfed[r], by Doug Fen" []
"No, Gals: Slogan O['] Slang[r], by Sal Ngo" []
"No-Gamers Megarons[r], by Erma Song"
"No Giant Atoning[r], by Gino Tan"
"No Grit to Grin[r], by Ringo Torting"
"No-Gun Day? Gay Do, Nun[r], by [if player is male]Dan Young[else]Donna Guy[end if]"
"No Hair: Oh, I Ran[r], by Rina Ho-Hirano" []
"No Hot Bike in the Book[r], by Tobin Hoke"
"No, I Feel One Life[r], by Leo Fine"
"No Kids So Kind[r], by Donski Dikson"
"No Lairds or Island[r], by Lois Rand"
"No Light, Long Hit[r], by Gil Thon"
"No Lower Role Now[r], by Rolo Wen" []
"No Mail, Oilman[r], by Ol['] Mina Molina-Milano"
"No-Mess Mesons[r], by Ms. Enos Sensom"
"No Milk For Minor Folk[r], by Milo Fronk"
"No Mire or Mine in Rome[r], by Morrie Menino & Moe Nir" []
"No Mire or Mine[r], by Normie Remino" []
"No Mo['] Tripe, Minor Poet[r], by Tom Perino"
"No More Romone Moreno[r], by Ron Moe" []
"No-Nest Sent-On Sonnet[r], by Tone N. Stenson"
"No Overt Veto, Ron[r], by Trevono Overton"
"No Party, Any Port[r], by Art Pyon"
"No Pier or Pine, Nor Pie[r], by Ron Pei-Perino"
"No Pierced Do Creep In[r], by [if player is male]Deon Price[else]Dori Pence[end if]"
"No Prep Nor Pep[r], by Pen Pro Ron Epp"
"No Price, Poncier/Porcine CEO in PR. Once: RIP[r], by Pro-Nice Peon Ric"
"No Red Drone[r], by DeRon Endor-Roden"
"No Rest, St. Oren[r], by Nestor Reston" []
"No Rev is So Riven Over Sin[r], by Vin Rose"
"No Riven Environ[r], by [if player is male]Ron Vine[else]Erin Von[end if]"
"No Scale So Clean[r], by Les Cano"
"No Sea: Aeons as One[r], by Asase Noone"
"No Seamy Yeomans[r], by Amos Ney"
"No Secret to Screen[r], by Ernst Coe"
"No Seeds So Dense[r], by Sed Enos"
"No Shade Had Eons as Honed[r], by Deon Ash"
"No-Skore Snooker[r], by Ken Roos"
"No Smiles, Slim Ones: Lesson [']Im[r], by Neil Moss & Leon Sims"
"No Squirt or Squint[r], by Ron Quist"
"No Stag To Snag Tangos[r], by Gaston Gantos" []
"No Stick in Stock[r], by Nik Cost"
"No Stoic's Coin Toss[r], by Scot Ison"
"No Story? Try Soon[r], by Ron Yost"
"No Taunts Unto Stan[r], by Ann Stout"
"No Trace at REcon[r], by Art Cone"
"No Trees or Teens: So, Enter to Sneer[r], by Ernesto O'Sterne" []
"No Trends, Snot-Nerd[r], by Don Ernst"
"No Tricks, Stink-Orc[r], by Nick Rost"
"No Tripe to Ripen[r], by Oren 'Tip' Petrino"
"No Turd Untrod[r], by Rotund Don Urt"
"No Variant to Nirvana[r], by [if player is male]Ravi Anton[else]Nina Tovar[end if]"
"No War: O, Warn[r], by Rowan Wrona" []
"No Warts or Wants, Wan Sort[r], by Art Snow"
"No Water: Woe-Rant[r], by Art Owen" []
"No, Words Drown So[r], by Rod Snow"
"Noble Mt. Belmont[r], by Ben Tolm" []
"Noble Romp: No Problem[r], by Rob Pelmon"
"Noble Savage Gleans Above[r], by Vanesa Bogle & Geneva Sabol"
"Nobler Vow, Overblown[r], by Love Brown"
"Noblest Belton's[r], by Lon Best" []
"A Noblest Pup, Unstoppable[r], by Pablo Supnet"
"Nobody Will Woo Blindly[r], by Loyd Wilbon"
"Noel Hit the Lion[r], by Theo Lin" []
"Noel Sits So Silent[r], by [if player is male]Lon Estis[else]Tess Olin[end if]"
"Noemi's Monies[r], by Moises Menino"
"Noiry Irony[r], by Ron Yi"
"Noiseless Lionesses[r], by Lee Sisson & Sol Sinese"
"Nolette's Notelets[r], by Les Otten"
"Non-Science Innocences[r], by Ceci Sonnen"
"Nondescript Cretin's Pond (Second Print)[r], by Donn St. Price"
"None Cursed Uncensored, Senor Dunce[r], by Ned Crounes" []
"None Had One Hand[r], by Ned Noah"
"None Rib Bro Nine[r], by Ben Niro"
"None Sit in Stone[r], by [tt] Senn"
"Noon and On and... No![r] by Ann Doon"
"Noon Glee Gala: Go Angle Alone[r], by Angelo Alonge" []
"Noose Mogul Monologues[r], by Moose Luong"
"Nope, I Prep Pepperoni[r], by Irene Popp"
"Nope, Try Entropy[r], by Tyrone P. Poynter"
"Nor Last to Snarl[r], by [if player is male]Sol Tran[else]Ros Lant[end if]" []
"Nor Pay Any Pro[r], by Ryan Po & Ron Yap"
"Nor Shunt North, Sun[r], by Rush Tonn"
"A Normal Alarm On[r], by Al Moran"
"North Pole Honor Lept[r], by Lon Thorpe"
"North Wing, Worn Night[r], by Trinh Wong"
"Norway, or YAWN[r], by Wynona Yarrow"
"A Nose for One's Afro[r], by Erna Foos"
"A Nose on Sea[r], by Sean-O Eason" []
"The Nose on These[r], by Seth Eno"
"Nose Pick: Sick? Nope![r] by Skip Cone"
"Nosebag, Be on Gas[r], by Abe Song"
"A Nosey Cue: Can You See[r], by Noe Causey"
"Nosey Days: an Odyssey[r], by Sonya Syed"
"Nosh, Nosh? Shh, No, Son[r], by Shon Sohn"
"A Nosy Assay On Yon[r], by Sonya Ayson" []
"Not a Dive to Invade[r], by Nita Dove"
"Not Awed, New Toad[r], by Tad Owen"
"Not-Clear Ol['] Trance[r], by Carleton Coltrane" []
"Not Close to Clones[r], by Enos Colt"
"Not-Durable Roundtable[r], by [if player is male]Dale Burton[else]Tonda Luber[end if]"
"Not Real to Learn[r], by Leo Tran" []
"Not-Sleek Skeleton[r], by Len Stoke" []
"Not-Sludgy, Godly, Nuts[r], by Dusty Long"
"Not Sore or Stone[r], by Ron Seto"
"Not Under Round Ten[r], by Donn True"
"Not Up To Pun-Put-On[r], by Po['] Nut Punto-Upton"
"Not Used to Dunes[r], by Stu Oden & Ted Onus"
"Not-Wise Townies[r], by Otis Wen"
"Nota Bene: Beaten? No[r], by Bee Anton"
"Notarise, Notaries, in a Store[r], by Senorita Tina-Rose Restaino" []
"Note, Dear Ex: Exonerated[r], by Roxane Deet"
"Note Kibosh in the Books[r], by Keith Osbon"
"Notice a Poor Cooperation[r], by Orion Capote"
"Novelty-Envy Lot[r], by Ty Loven"
"Novice Con, Vie[r], by [if player is male]Evon Vicencio[else]Vivienne Coco[end if]"
"Now Art's Tons Raw[r], by Stan Row" []
"Now I Net One Twin[r], by [toti] Wen"
"Now I See, Wise One[r], by Wes Oien"
"Now I've No View[r], by Vi Owen"
"Nowhere's Sown Here[r], by [if player is male]Wes Horne[else]Wren Shoe[end if]" []
"Nuge is Genius[r], by Su Inge"
"Number a Beam Run[r], by Mae Burn"
"Number Eight Regiment Hub[r], by [if player is male]Hubert Minge[else]Inge Humbert[end if]"
"Number Four Rumor, Be Fun[r], by Murf Bourne"
"A Number-Rube Man[r], by Ben Maur"
"Number Three Ember Hunter[r], by Rene Humbert"
"Number Two, Wrote Numb[r], by Burt Mowen"
"Nuts Ad-Jig Adjusting[r], by Judi Tsang" []
"Nuts, Folk Lost Funk[r], by Flo Knust"
"Nuts, Joe, Just One[r], by June Tso"
"A Nutty Tut? Nay[r], by Ty Tuan"
"O a Noble Boolean[r], by Al Boone"
"O, Bar a Bro[r], by Bob Arora"
"O, Chains in Chaos[r], by Achison Schiano" []
"O Cheri, Heroic Coheir[r], by [if player is male]Eric Ho[else]Rei Cho[end if]"
"O Clashin['] Nicholas[r], by Loni Cash" []
"O Clingy Cloying[r], by Gy Nicol"
"O Coyest Coyotes[r], by Scot Yeo"
"O Curse Course Sour, Coerce Us[r], by Reusser Cuoco"
"O, Curst Courts[r], by Curt So"
"O Deluge: Loud, Gee[r], by Doug Lee"
"O Diva, Avoid[r], by Ava DoVidio"
"O, Do Rely, Ol['] Yoder[r], by [if player is male]Loyd Roe[else]Loo Dyer[end if]"
"O, Dozens Snoozed[r], by Zed Soon"
"O Farms of Mars[r], by Sam Roff-Ramos" []
"O, Feelin['] One Life[r], by Leo Fine"
"O, First Ave. Favorites[r], by Avi Foster" []
"O Flames of Salem[r], by Mel Faso"
"O Fleets of Steel[r], by Stef Leo"
"O, Hustle the Soul, Eh, Louts[r], by [if player is male]Lou Tesh[else]Sue Holt[end if]" []
"O Kyle, Lo-Key Yokel![r] by Koye O'Kelly" []
"O, Liars Rail So[r], by Rosa Li" []
"O Mad Sin Domains[r], by Madison Simando" []
"O, Modest Doom Set[r], by Ted Moos"
"O Mother, Herm Too?[r], by Moe Roth"
"O Palest Apostle: Peals to Stop Ale[r], by Sol Peat & Leo Past" []
"O Pretty Pottery[r], by Trot Pye"
"O Random Doorman[r], by Mod Rona Morando"
"O, Rant on Art[r], by Toran Arnot"
"O Rebel, Rob Lee[r], by Ol['] Bree Loeber" []
"O, Rile Me, Moliere, Lie More[r], by Eli Mero & Milo Ree"
"O, Roary Arroyo[r], by Roy Rao"
"O, Sad Lug, Gas Loud[r], by Douglas Asgould" []
"O, Serpent Peterson[r], by Rene Post" []
"O Shorn Honors[r], by Roshon Shnoor"
"O Sister! So I Rest: Rosiest Stories to Sires[r], by Tess Rio-Ossiter" []
"O Such Hocus[r], by Coco-Su Hush"
"O Travel! A Revolt[r], by Ole Trav & Art Love"
"O Viper, I Prove[r], by Vi Poer"
"O'Cameron's Moonraces[r], by Moe Carson"
"O'Hare, a Hero[r], by Rae Ho" []
"Oak, Crush Our Shack[r], by Rosa Huck"
"OakFest: To Fakes of Steak[r], by Fae Kost"
"Oakley, a Yokel[r], by Leo Kay"
"Oath Found Out of Hand[r], by Donato Huf"
"Obake, Be Oak[r], by [a-b] Ko"
"Obese Wry Eyebrows[r], by Wes Boyer"
"Obeying Biogeny[r], by Gino Bey"
"Obligant Bloating[r], by Inga Bolt & Tobi Lang"
"Observing Riven Bogs[r], by [if player is male]Rob Givens[else]Bev Signor[end if]"
"Obtain Boatin['], Bonita[r], by Nat Obi" []
"Obtrusive Virtue? Sob[r], by Bev Suitor" []
"Oceanus: No Cause[r], by Sue Cano"
"Odd Ben Bonded[r], by Bob Denne-Dodd"
"Odd Fret[r], by Ted Ford"
"Odd Game God Made[r], by Meg Doda"
"Odd Lingo Doodling[r], by Dido Long"
"Odd Lyla, Old Lady[r], by Doll Day & Addy Oll"
"Odd Mice Did Come[r], by Mei Codd"
"Odd Sea So Dead[r], by Ed Daso"
"Odder Snug Underdogs[r], by Ed Grounds"
"Oddness Dens['] Dos[r], by Ned Doss"
"Odes to DeSoto: Sed, Too[r], by Ted Soo" []
"Oeuvres['] Overuse[r], by Sour Eve"
"Of a Red Fedora: Do Fear[r], by Rod Fae"
"Of Crusty Coy Turfs[r], by Cyr Fouts"
"Of Despair Poised Far[r], by Pedro Asif"
"Of Drunk Dork Fun[r], by Rod Funk"
"Of Greasy Gray Foes[r], by Faye Gros"
"Of Liars So Frail[r], by Rolf Sia"
"Of Metal to Flame[r], by Tom Leaf"
"Of Mr. Sad-From-Ads[r], by Sam Ford"
"Of Mules Fulsome[r], by Sue Flom & Flo Muse"
"Of Quality to Qualify[r], by Tuqila Foy"
"Of Rules Fer Soul[r], by [if player is male]Les Rufo[else]Sue Rolf[end if]"
"Of Sales So False[r], by [if player is male]Les Faso[else]Lea Foss[end if]"
"Of Salt So Flat[r], by Alf Tso"
"Of Seas So Safe[r], by Sofea Safosse"
"Of Slain: So Final[r], by Flo Sian"
"Of Slick Cis Folk[r], by Sol Fick"
"Of Snug Fun Gos[r], by Su Fong"
"Of So-Bold Slob Food[r], by Flo Bodos" []
"Of Stale Ol['] Fates[r], by Leo Fast" []
"Of Theory or Thy Foe[r], by Roy Hoeft"
"Of Tides So Fetid[r], by Dot Seif"
"Of Times Some Fit[r], by Mo Feist"
"Of Toast Too Fast[r], by Soo Taft"
"Of Trashy Hay-Forts['] Hot Frays[r], by Roy Shaft"
"Oft Thinner in the Front[r], by Efton Trinh"
"Ogle a TV: Voltage[r], by Lea Vogt"
"Oglin['] V. Loving[r], by Gil Von Long, IV" []
"An Ogre, Gorean[r], by Ag Reno" []
"Oh, Adage, Go Ahead[r], by Ed O'Haag"
"Oh, Attend Not Death[r], by [d-t] Neath" []
"Oh, Baby, a Hobby[r], by Bob Hay"
"Oh, Besty, the Boys, They Sob[r], by Toby Esh"
"Oh, Brat, Hot Bar[r], by Bo Hart & Bart Ho" []
"Oh, Cancer or Chance, Encroach[r], by [if player is male]Ron Chace[else]Cora Chen[end if]-Cochrane"
"Oh, Cap Cop? HA[r], by Papa Chooch"
"Oh, Darby, Hard Yob[r], by Brad Hoy"
"Oh, Drear Hoarder Dr. O'Hare[r], by Ro Heard"
"Oh, Fair of Hair[r], by Ari Hof"
"Oh, Gents Hog Tens: the Song[r], by Seth Ngo" []
"Oh, I Grunt Our Thing[r], by Gino Hurt"
"Oh, Inmates, In to Shame[r], by Thomasine Mathieson" []
"Oh, Man, Ham On[r], by Mahon Homan"
"Oh, Mentor the Moron[r], by Tom Horne & Nemo Roth"
"Oh, Mr. Wit-How-Trim: Trow Him[r], by Mi Worth"
"Oh, Newer Nowhere![r] by Ren Howe"
"Oh, Pander, Orphaned, Harped-On Hard Peon[r], by [if player is male]Pedro Han[else]Hope Rand[end if]"
"Oh, Pliant Tho['] Plain Phat Lion[r], by Philaton Oliphant" []
"Oh, Raven or Haven[r], by Hera Von Hanover"
"Oh, Realms: Sham Lore[r], by [if player is male]Leo Marsh[else]Rosa Helm[end if]"
"Oh, Rec Ochre, Roche[r], by Corree Hoch"
"Oh, Red Horde[r], by Herod Rhode"
"Oh, Scanty Tachyons[r], by Tony Cash" []
"Oh Silken Sinkhole[r], by Lise Kohn"
"Oh, Strut Truth So to Hurts[r], by Rush Ott-Strouth"
"Oh, Super Orpheus: He Pours Her Soup[r], by Rush Poe" []
"Oh, Swear a Shower[r], by Ash Rowe"
"Oh, Tears to Share[r], by [if player is male]Art Shoe[else]Rhea Ost[end if]"
"Oh, Truism Humorist[r], by Tomi Rush"
"Oh, Type On, Honey Pot[r], by Tony Hope"
"Oh, Yen, Honey[r], by Yohny Hoene"
"Ohai Mr. Mohair[r], by Moriah Rohaim"
"Ohman's Hansom[r], by Mo Nash"
"Oho, Gents, the Goons: Gone, Shot[r], by Theo Song"
"Oi, Slam! I'm Also as Milo[r], by Amos Li"
"Oi, Snaps! Sonia P's Passion Pains So[r], by San Piso"
"Oil Baron: I Rob, Loan[r], by Nia Bloor"
"Oil Castle, Coal Islet[r], by [if player is male]Ollie Cast[else]Elli Coats[end if]"
"OK At the Hot Take[r], by [if player is male]Theo Tak[else]Kath Teo[end if]"
"OK Bein['] Ken: Bio[r], by Ben Oki"
"OK, Clan, Lack On[r], by Al Nock" []
"OK Fate to Fake[r], by Fae Kot"
"OK, I Bent: Bike Not[r], by Kit Bone"
"OK, I Scold Cool Kids[r], by Solo Dick Cid Sokol"
"OK, Jones, No Jokes[r], by [if player is male]Ken Joos[else]Jen Sook[end if]"
"An OK Koan[r], by Anna Kook"
"OK, Lame to Look at Me, Ol['] Tomeka[r], by Kam Toole"
"OK, Nerd Wes: Keen Sword[r], by Ken Dowers" []
"Okay, Burn Your Bank[r], by Bryan Kuo"
"Ol['] Ash-Pit Hospital[r], by Tisha Olp"
"Ol['] Bikes Like Bo's Obelisk[r], by [if player is male]Eli Kobs[else]Elsi Bok[end if]"
"Ol['] Bore Bolero[r], by Rob Leo"
"Ol['] Dan Dolan[r], by [if player is male]Aldo Landon[else]Lona Donald[end if]" []
"Ol['] Dr. Lord[r], by Doll Dorr"
"Ol['] Greta Got Real to Glare[r], by Reg Toal" []
"Ol['] Hater Hot Earl[r], by Lea Roth"
"Ol['] Ike's Like So[r], by Eli Kos"
"Ol['] Nat's Talons Last On[r], by Laslo Stanton" []
"Ol['] Rants to Snarl[r], by [if player is male]Lon Rast[else]Ros Lant[end if]" []
"Ol['] Ryan Naylor an['] Lory Raylon[r], by Ron Lay"
"Ol['] Sin Loins[r], by Lois Nilson & Lonni Solis" []
"Ol['] Stash to Slash Hat Loss[r], by Sal Tosh"
"Old Ager Geraldo[r], by Rae Gold" []
"Old Bans So Bland[r], by Don Blas"
"Old Bees Bleed So[r], by Bledsoe Seebold"
"Old Bet Bled to be Told[r], by Deb Olt"
"Old Bones Bled Soon[r], by Leo Bonds"
"Old Chet the Clod[r], by [if player is male]Ted Loch[else]Dot Lech[end if]" []
"Old Cube Could Be Blue, Doc[r], by Bud Cole"
"Old Grey Dr. Goley[r], by Ed Glory"
"Old Guys, Sly Doug[r], by Gus Loyd"
"Old Ian: an Idol Laid On[r], by Don Ali" []
"Old is New, Low Snide Wild Ones[r], by Eli Downs" []
"Old Line Done Ill[r], by Leo Lind"
"Old Magic, Mad Logic[r], by Mica Gold"
"Old Mate Lame [d-t][r], by Tom Dale"
"Old Meager Dear Golem[r], by [if player is male]Mo Arledge[else]Madge Roel[end if]"
"Old Nan Donlan[r], by Donnal Landon" []
"Old Narc, Lorn Cad[r], by Cal Dorn" []
"Old Nick Lock'd In[r], by Dick Lon"
"Old Pain: No Plaid[r], by [if player is male]Dan Poli[else]Ali Pond[end if]"
"Old Perp Doppler[r], by Pop Erdl"
"Old Rae, a Real Doodler[r], by Eldora Laredo" []
"Old Snob So Blond[r], by Sol Bond"
"Old Truism Most Lurid[r], by Slim Tudor"
"Old West Lost Dew[r], by Ted Slow"
"Old-Years-Easy Lord[r], by Lady Rose"
"Olden Hat to Handle Then Load[r], by Dean Holt" []
"An Older Real Don[r], by Neal Ord" []
"Ole Bilk? I'll Be OK[r], by Eli Kolb, Ike Boll & Li'l Kobe"
"Ole Bud's Bold Use Doubles[r], by Sol Dube" []
"Ole Dad Doled a Loaded, Dead Ol['] Ad Lode[r], by Odd Lea" []
"Ole Gun Lounge, No Glue[r], by Leon Ug"
"Ole Site, See Toil So Elite[r], by Otis Lee" []
"Ole Sky Yokels[r], by Kyoko Lessley"
"Ole Vin in Love[r], by [if player is male]Ev Olin[else]Vi Noel[end if]"
"Olga Tseng Gets Along[r], by Noel Stagg"
"Oligarchs['] Rash Logic[r], by Lora Gisch"
"Olympian Palimony[r], by Lamon Yip"
"Omar's Amors['] Roams[r], by Rasmo Ramos"
"Omens or More, Son[r], by Ron Mose"
"On a Grim Roaming Moan-Rig[r], by [if player is male]Mario Ng[else]Ramiro Mignogna[end if]"
"On a Quiet Equation[r], by Teo Quain"
"On a Sober Sane Boor[r], by [if player is male]Bo Reason[else]Reba Soon[end if]" []
"On a Trial, Rational[r], by [if player is male]Ira Alton[else]Iola Tran[end if]"
"On a Warm Man O['] War[r], by [if player is male]Wm. Aaron[else]Nora Maw[end if]"
"On Bets So Bent[r], by Bo Enst" []
"On Boys So Bony[r], by Sy Boon" []
"On Bums So Numb: Snub Mo['][r], by Bo Muns"
"On Bums So Numb: Um, No BS[r], by Bub Musso-Monn" []
"On, Cadet, to Dance[r], by Ned Cato & Tad Cone" []
"On Calicos So Laconic[r], by Laci Coons"
"On Cushiest Touchiness[r], by Seth Cousin"
"On Datives So Deviant[r], by [if player is male]Otis Vaden[else]Vida Stone[end if]"
"On Deep Den, Open-Ended[r], by Ned Pedone"
"On Dreams Ransomed, Ma Drones[r], by [if player is male]Ned Ramos[else]Ros DeMan[end if]" []
"On Fears of Saner Far Eons[r], by [if player is male]Fran Ose[else]Rose Fan[end if]"
"On Fever of Nerve[r], by Vern Foe" []
"On, Glad Old Nag, and Log[r], by Golda Langdon"
"On Gulfs of Lungs[r], by Ulf Song"
"On I Bet To be In[r], by Eboni Bonetti"
"On Juice I Jounce[r], by Joni Cue"
"On Late to Lean at Noel[r], by Ole Nat Leaton"
"On-Message Sage Omens[r], by Gena Moses"
"On, Micro-Moronic Room, Inc[r], by Ric Moon"
"On Nests [']N Stones: Notness Sonnets[r], by Stenson Stesnon"
"On, Rascal, to Root Canals[r], by [if player is male]Oscar Alton[else]Cora Lantos[end if]" []
"On, Regaled Golden Era[r], by [if player is male]Leon Edgar[else]Eden Largo[end if]"
"On Sadder Roads['] End[r], by Rod Danes"
"On, Scary Crayons: Scorn, Ay[r], by Caryn So"
"On Selling Long Lines[r], by Lois Glenn Ellingson"
"On She Shone[r], by Shoe Henson"
"On Swell New LOLs[r], by Wes Noll" []
"On, Swift Twins of Two Fins[r], by Tif Snow"
"On the Ethno-Net, Ho[r], by Theo Henton"
"On-the-Ropes Phone Store[r], by Nestor Hope" []
"On the Wars Worse-Than-Haters Won[r], by [if player is male]Art Hewson[else]Rhea Towns[end if]"
"On This Day a Tidy Nosh[r], by Dinah Yost"
"On to Rev. Overton[r], by Tor Evon" []
"On Us Mark Runs Amok[r], by Nora Musk"
"On Views Sin Wove[r], by Vi Owens"
"On Whets the Snow[r], by Wes Noth" []
"On Worries Now Rosier[r], by Rori Snowe"
"On, Zebras So Brazen[r], by [if player is male]Rob Saenz[else]Zoe Barns[end if]"
"Once is So Nice[r], by Sconie Enciso" []
"One Aid, No Idea[r], by Ian Doe"
"One Art Near To Ornate[r], by Torean Tarone"
"One Bro's Sober? No[r], by Ben Roos" []
"One Byte, Teen Boy[r], by Tony Bee & Ben Toye"
"One Dogma, Good Name[r], by Don Omega"
"One Dram and More Adorn Me[r], by Dan Rome" []
"One Dreamt to Meander[r], by Reed Toman"
"One Drum: Dour Men Mourned Round Me, Demur On[r], by Ed Munro" []
"One Flay a Felony: Yen, Foal[r], by Fay Noel"
"One Girl, Long Ire[r], by Goneril Olinger" []
"One Girl's Long Rise[r], by Lis Rogen-Gorsline, Rose Ling-Solinger & Glen Rios-Ingersol"
"One Glam Mean Log[r], by Algemon Goleman"
"One Glib Ol['] Binge[r], by Gil Bone" []
"One Gray Rage Yon[r], by Rae Yong"
"One Gutsy Youngest Notes-Guy[r], by Gus Toney"
"One Happy Pay Phone[r], by Pope Yahn" []
"One Hill Hellion[r], by Lionel H"
"One Ion Died: Neon Iodide[r], by Dione DeNio"
"One Jury's Journeys[r], by Ryu Jones"
"One King's Skin Gone[r], by Ken Goins"
"One Lardo's (Leonardo's) Lone Roads[r], by Rosa Eldon"
"One Leap on a Peel[r], by Pa Leone"
"One Lug's Lounges[r], by Gus Noel"
"One Mad Daemon[r], by Ned Mao" []
"One Moist Emotion's Time: Soon[r], by Otis Moen" []
"One More Moon Ere[r], by Moe Reno"
"One Moth, the Moon, Not Home[r], by Monte Ho" []
"One Neo-Eon[r], by Noe Eno"
"One of a Kind Faked Onion[r] by Nina De Fook"
"One Rabid Brain Ode[r], by Ida Boren" []
"One Rad Read-On[r], by Ed Roan" []
"One Rest to Sneer or Tense[r], by Ernesto Rosteen" []
"One Runt's Neutrons Rust Neon[r], by Nounster Uno Ernst"
"One Simp, Mo['] Spine: in Poems[r], by Enos Pim"
"One Simp Mopes In[r], by Mei Pons" []
"One Star to Snare[r], by Stan Roe"
"One Throng Gone North[r], by Rog Henton"
"One Tip to Pine[r], by Pepine Totino"
"One Twit I Went To[r], by Tito Wen"
"One Warm Raw Omen More Wan[r], by Nora Mew"
"One World Older Now[r], by Owen Lord"
"One Year or an Eye[r], by Rona Yee"
"One's Bark As Broken[r], by [if player is male]Bo Kearns[else]Rose Bank[end if]"
"One's Nose Soon Seen[r], by [if player is male]Enos Eson[else]Noe Esson[end if]"
"Oneness [']N Nonsense[r], by Enos Senn"
"Onion Miasmas, Samoa Minions[r], by Simona Osmani" []
"Only Curb Nobly, Cur[r], by Luc Byron-Clybourn"
"Only Lyon[r], by [if player is male]Lonny Loy & Olly Nyon[else]Lynny Loo[end if]"
"Only Lyon[r], by Lonny Loy, Olly Nyon & Noly Olyn"
"Only Mind My Old Inn[r], by Lyn Dimon"
"Only Reds Nod Slyer[r], by Nerdy Sol Reynolds"
"Onward, Raw Don[r], by Rowan Downard" []
"Onyx Room Oxymoron[r], by Roxy Moon"
"Oof, Lost to Fools of Tools[r], by Sol Foot"
"Open Dream Promenade[r], by Pam Doeren"
"Open Rife Peer Info: Fine Rope[r], by Opie Fern" []
"Open Soul, Loosen Up[r], by [if player is male]Enos Pulo[else]Lupe Soon[end if]"
"Open This Shot Pine[r], by Seth Pino"
"Openest Pete's on Step One[r], by Pots Nee"
"Ophelia's Hopes Ail[r], by Lois Heap"
"Opinionated Idea, No Point[r], by Antoine Diop"
"An Opting, Poignant[r], by Tona Ping"
"Options? No, I Stop Stoopin['][r], by [tt] Pons" []
"Or a Glum Glamour[r], by Lu Margo"
"Or a Quest to Square, Equator's Quaestor[r], by Reo Quast"
"Or a Self For Sale[r], by Flo Ares" []
"Or Be Bore[r], by Robb Oree"
"Or Be on Borneo[r], by Rob Eno"
"Or Bind No Bird[r], by Di Born-Brodin"
"Or Fast Arts of a Frost[r], by Taras Ostroff"
"Or Fast, Star of Frat, So[r], by Taras Ostroff" []
"Or Feign No Grief[r], by Erin Fog" []
"Or Fifty Fortify[r], by Riff Tyo"
"Or Fleas for Sale[r], by Alf Rose" []
"Or Fry Us So Furry[r], by Rosy Urf"
"Or Gain a Groin[r], by [if player is male]Graig Noorani[else]Irina Gongora[end if]" []
"Or Genes So Green? Go Sneer[r], by Reg Enos"
"Or I Yell O'Reilly[r], by [if player is male]Elroy Li[else]Lily Roe[end if]"
"Or I'm a Maori[r], by Mario Raimo" []
"Or Is Pops Piss Poor[r], by Pip Soros"
"Or Live Off Floor Five[r], by Lovie Roff"
"Or Many Mar Yon Romany[r], by Ron May" []
"Or Merry My Error[r], by Remy Orr"
"Or Mild, Milord[r], by Rod Lim"
"Or Mince No Crime Mo['] Nicer[r], by Mei Corn" []
"Or Old Dr. Loo[r], by Rollo Drood" []
"Or Pablo, Pool-Bar Boor-Pal[r], by Rob Opal"
"Or Paint on a Trip[r], by Pat Rino"
"Or Phone, No-Hoper[r], by Oren Pho" []
"Or Put So Our Stop[r], by Stu Poor"
"Or Sadden Road's End[r], by Dan Erdos" []
"Or Sketch the Rocks: Her Stock[r], by Ros Ketch"
"Or Stake a Stroke[r], by Art Seko"
"Or Still I Stroll[r], by Tris Oll"
"Or Tendin['] to Dinner[r], by Enid Nort"
"Or Thick Rock Hit[r], by Rich Kot"
"Or Tons So Torn[r], by Ron Tso"
"Or Unbiased Boundaries Do Urbanise[r], by Sadie Bruno"
"Or Vials So Viral[r], by Val Rios" []
"Or Vice I Cover[r], by Cicero Vivero"
"Oracles: a Closer So Clear![r] by Carl Ose"
"Oracles: Ten Clear Notes[r], by Alec Reston"
"Oral Mime Memorial[r], by Liam Rome" []
"Orbitals So Tribal[r], by Lois Bart"
"Orchestra Carthorse[r], by Seth Carro"
"The Order Erred, Tho['][r], by Rod Ereth"
"The Order to Re-Herd[r], by Reed Roth" []
"Ordinary Ironyard[r], by [if player is male]Roy Darin[else]Dori Ryan[end if]"
"Organist Roasting[r], by Art Goins" []
"Original Air Lingo[r], by [if player is male]Gino Rial[else]Lori Agin[end if]"
"Oriole: a Revival[r], by Valorie Olivera-LeVario"
"Orkneys, Yonkers[r], by Ron Keys"
"Orphanages, Heap Groans[r], by Porsha Egan & Sharon Page"
"Orzech's Scherzo[r], by Zo Resch"
"Osama or Omarosa?[r], by Ara Moos"
"Other Beaus Hereabouts[r], by Sheba Toure"
"Other Bums['] Metro Hubs[r], by Burt Eshom"
"Other Side, Theorised: Hot Desire[r], by [if player is male]Tree Doshi[else]Edith Rose[end if]"
"Other Side, Theorised[r], by Edie Short"
"Other Sun, Then Ours[r], by Sue North-Southern" []
"Otis Held the Solid Old Heist[r], by Tish Dole"
"Otten's No Test[r], by Soto Stennett" []
"Ottinger's Gritstone[r], by [toti] Gerst" [plural+12549]
"Ouch-Blues Clubhouse[r], by Lou Busche"
"Ouch, Man, Un-Macho[r], by Mo Chuan"
"Ould Ludo[r], by Lulu Dodo" []
"Our Anti-Rainout[r], by Ian Urto"
"Our Art My Mortuary[r], by Ty Armour"
"Our Bard, Out: A Dour Turbo-Troubadour[r], by Arturo Bodu"
"Our Basic Caribous[r], by [if player is male]Rico Suba[else]Suri Coba[end if]"
"Our Basket Breaks Out[r], by [if player is male]Buster Kao[else]Rose Kubat[end if]" []
"Our Best to Rubes Obtuser[r], by [if player is male]Bo Reust[else]Sue Bort[end if]"
"Our Blade, a Boulder[r], by Lou Beard"
"Our Blest Troubles[r], by Uber-Lost Ol['] Buster"
"Our Blood, Loud Boor[r], by Rob O'Doul"
"Our Case: A Source or Cause[r], by Cora Sue" []
"Our Clone's Counselor[r], by Rue Colson"
"Our Dad's Rad Duos[r], by Ros Duda"
"Our Death, Authored, Heard Out[r], by Theo Radu"
"Our Fleshy Fury Holes[r], by Rush Foley"
"Our Game's Mega Sour[r], by Rose Guam"
"Our Ineptest Pretentious Pioneers, Tut[r], by Terise Upton"
"Our Islet: Outliers Loiter, Us[r], by Lou Reist"
"Our Jest, Jouster[r], by Su Trejo"
"Our Lab Labour[r], by Bo & Raul LoBura"
"Our Man: a Mourn[r], by Rouman Namuro"
"Our Meg's Morgues[r], by Gus Rome"
"Our Milt, Trim Lou: Turmoil[r], by Mort Lui"
"Our Nat Turano Ran Out[r], by Art Nou" []
"Our Nine Inure No Reunion[r], by Nino Ure"
"Our Past: a Sprout[r], by Pat Urso"
"Our Poets: Poseur to Too Super[r], by Rupe Soto"
"Our Set So True[r], by Sue Ort"
"Our Side: I Sure Do[r], by Sue Dior"
"Our Stuff: Surf, Tofu[r], by Stu Ruffo"
"Our Sweat Wears Out[r], by Esau Trow"
"Our Times Suit More Moisture[r], by Sue Mitro & Tim Rouse"
"Our Violent Revolution[r], by Lou Trevino"
"Oust-Outs Sous Tout[r], by Stu Souto"
"Out, Crimson Consortium[r], by Curtis Moon" []
"Out-Dirge Us, Tour Guides[r], by Doug Uresti"
"Out, Fan of a Nut[r], by Tona Fu"
"Out-Lever True Love[r], by Lou Evert"
"Out, Resister: True Stories[r], by Rosie Sutter & Ressie Trout"
"Outbid? I Doubt[r], by Bud Ito"
"Outer Ways: a Rusty Woe[r], by Esau Towry"
"Outing Real Regulation: Nil Outrage[r], by [if player is male]Louie Grant[else]Rina Goulet[end if]"
"Outlander Daunt-Lore[r], by Neal Tudor"
"Outlive No Evolution[r], by Louie Vont"
"Outreach, a Retouch[r], by Ute Rocha"
"Outsiders['] Sour Diets[r], by Dusti Rose"
"Outwardly Would Try a Duty or Law[r], by Twyla Rudo"
"The Ovals Have Lost[r], by [if player is male]Sol Vaeth[else]Tosha Lev[end if]"
"Ovations to So Vain[r], by Otis Nova"
"Overbearing Baron, Grieve[r], by Verona Grieb & Iva Bergeron"
"Overbearing Brave Regino[r], by [if player is male]Ringo Beaver[else]Vernia Borge[end if]" []
"Overdoing, Good-Riven Donor, Give[r], by [if player is male]Gino Dover & Evon Girod[else]Dion Grove[end if]"
"Overdoing Goon-Drive[r], by Dino Grove" []
"Overgay Voyager[r], by Eva Groy"
"Overpassed Eavesdrops[r], by [if player is male]Dave Speros[else]Dove Spears[end if]"
"Overseas Rose Vase: So Averse[r], by Eero Vass"
"Overt Id: to Drive, Trod, Vie[r], by Red Voit & Tod Iver"
"Overt Op: Vote Pro to Prove, Poor Vet[r], by Rev. Toop"
"Ow, I Fell: Low-Life Will Foe[r], by Eli Wolf"
"Ow, Years So Weary: Ay, Worse[r], by [if player is male]O. Sawyer[else]Rose Way[end if]"
"An Owl on Law[r], by Nan Woo-Wall"
"Own It to Win[r], by [toti] Witnow"
"Ox Burden Under Box[r], by Bud Rexon"
"Ox's Real Ax Lores[r], by Rex Sola"
"Oxygen is Sexy! Go in[r], by Onyx Geis"
"Oysterman Monastery[r], by [if player is male]Myron East[else]Amy Nestor[end if]"
"Ozone's Snooze[r], by Zoe Nos"
"Pa Burke's Breakups[r], by Kap Suber"
"Pa Frank's Fan Parks[r], by Fran Kaps"
"Pa, Lump a Plump Palm Up[r], by Lu Mapp"
"Pa's Buck Backs Up[r], by Cap Busk"
"A Pacecar Carapace[r], by Ace Capra"
"The Pack Pet Hack[r], by Pat Heck"
"Pagan Hero Orphanage[r], by Hope Ragan"
"Pah, Melt the Lamp, Peltham[r], by [if player is male]Pat Helm[else]Pam Leth[end if]"
"Pain, a Hope: Apophenia[r], by Pip O'Haane"
"Pain, Hold a Dolphin[r], by Opal Hind"
"Painer Napier[r], by [if player is male]Ren Pai[else]Arianne Piper[end if]" []
"Pains Aspin[r], by Papa Inniss"
"Pains or a Prison[r], by Ron Pais"
"Painted Nitepad[r], by Tad Pine"
"Painterly Interplay[r], by [if player is male]Tyler Pina[else]Lyna Petri[end if]" []
"Pal, Nice Pelican[r], by Cap'n Eli"
"Pal, to a Plot[r], by Ol['] Pat Plato"
"Pal to Apt Ol['] Plato[r], by Paolo Platt" []
"Pale Enos, Asleep on Lone Apse[r], by [if player is male]Lee Spano[else]Opal Nees[end if]"
"The Pale Heaplet[r], by Pete Ahl"
"Pale Ink, Elk Pain[r], by Kip Neal"
"Pale Lace: Peace, All[r], by Lea Capel"
"Pale Ms. Plame's[r], by Pam Les" []
"Pale Sedan Esplanade[r], by Adele Snap"
"Palermo's Pleromas[r], by [if player is male]Amos Perl[else]Rose Lamp[end if]"
"Palominos['] Pains Loom[r], by Opal Simon"
"Pals Once, Clean Sop[r], by Len Pasco"
"Pam is a Simp[r], by Masii Mapps"
"Panic at a Tin Cap[r], by Pat Cain" []
"Pantomime, Memo, Paint[r], by [if player is male]Moe Pitman[else]Emma Point[end if]"
"Pantomime, Mint a Poem[r], by [if player is male]Tommie Pan[else]Emma Ponti[end if]"
"Paradigms: a Dim Grasp[r], by Dr. Pam Agis"
"Paradiso Diaspora[r], by [if player is male]Rod Sapia[else]Pia Roads[end if]"
"Paragon or Pagan[r], by Rao Pang"
"Parallel Real Pall: All Paler[r], by Lara Pell"
"Paramedic Drama Epic[r], by [if player is male]Adam Price[else]Demi Capra[end if]"
"Pardon a Pandora[r], by Rand Pao"
"Pardon, Padron[r], by Don Arp & Rod Pan" []
"Pareto: Top Era to Reap[r], by Tera Po"
"Pariahs: a Parish[r], by Pia Sahr"
"Parkville Viral Kelp[r], by Rivka Pell"
"Parliaments['] Paternalism[r], by Pamela Stirn & Trina Sample"
"Parole of Poor Flea[r], by Flora Poe"
"Parsable Parables[r], by Sara Belp"
"Particular Culprit Ara[r], by Lupita Carr & Clara Pruit"
"Party On, Pray Not[r], by Ray Pont" []
"Party, Party, Party[r], by Patty Parry"
"Pascal's AP Class[r], by Al P. Cass"
"Passion Pains So[r], by Nia Poss" []
"Passionate Poet Anissa[r], by Otis Espana"
"Passive Saps Vie[r], by Si Vespa"
"Past, Blithe Battleship[r], by [if player is male]Alph Bettis[else]Shelba Pitt[end if]"
"Past Dorks['] Dark Spots[r], by Dot Sparks"
"Past Some Peat Moss[r], by Pat Moses"
"Pasticheur Curateship[r], by [if player is male]Erich Staup[else]Patrice Suh[end if]"
"Pater's Repast[r], by Petra S. Sprate" []
"Patience, Inept Ace[r], by Pete Cain"
"Patients['] Neat Tips[r], by [if player is male]Stan Piet[else]Pat Stein[end if]"
"Patriarch's Chair-Traps[r], by Traci Sharp"
"Patric's Scar Tip: A Script, Scrap It[r], by Cris Apt"
"Patroness, Transpose Not Spares[r], by [if player is male]Ron Spates[else]Pat Rossen[end if]"
"Patronymic Importancy: Myopic Rant[r], by [if player is male]Cory Pitman[else]Marcy Pinto[end if]"
"Patty is a Typist[r], by Tip Tsay"
"Paulsen's Sun Leaps[r], by Su Naples"
"The Pause Up a Sheet[r], by Pete Haus"
"The Pawn's New Paths[r], by Stew Phan"
"Pay Extra, Taxpayer[r], by Expat Ray"
"Pay Price? Yep, I Carp[r], by Pip Carey"
"Peace's Escape[r], by E. P. Case"
"Pearson's Personas[r], by Ross Pena"
"Pedestrian Pedantries[r], by [if player is male]Peter Dains[else]Trina Speed[end if]"
"Pedro Was So Warped[r], by Wes Pardo"
"Peerson's Response[r], by Ros Espen"
"Peg, Henrietta: Teenager Pith, Part Eighteen[r], by Pattie Hegner"
"Peg Sou Goes Up[r], by Gus Poe"
"Peirson's Ropiness[r], by Si Posner & Ron Spies"
"Pen, Words, Drop News[r], by Drew Pons"
"Penny is Spy Nine[r], by Nips Ney"
"Penobscot Bent Coops[r], by Ponce Bost"
"Penthouse Unto Sheep[r], by Pete Huson"
"Peoples Lose Pep[r], by [if player is male]Les Pope[else]Else Opp[end if]" []
"Pep Rally LP Player[r], by Lyle Rapp"
"Pep Spilt, Pip Slept[r], by Pet Lipps"
"Pepard Parped[r], by Ed Rapp"
"Pereida's Airspeed[r], by [if player is male]Sid Perea[else]Dee Paris[end if]"
"Peril Colt: Epic Troll[r], by Ric Pellot"
"Perkiest Tree, Skip[r], by [if player is male]Kip Ester[else]Kit Peers[end if]"
"Perp at a Parapet[r], by Art Pape"
"Perp Mo['], Mr. Pope[r], by Em Ropp"
"Perreault Prelature[r], by [if player is male]Raul Peter[else]Lupe Terra[end if]"
"A Person As Prone[r], by 'Pa' Soren Pearson"
"Personalistic Pictorialness[r], by Cristina Lopes & Priscila Stone"
"Persons, Press On[r], by Ross Pen"
"Perspire, Spree, RIP[r], by Pip Reser"
"A Pert Pater[r], by Tara Tepper" []
"Pest Increase: a Persistence[r], by Serita Spence"
"A Pestled Deep-Salt Pedestal[r], by Pat Leeds"
"Pet, Bury Puberty[r], by Burt Pye"
"Pet Rants, Pen-Start Patterns[r], by Pat Ernst"
"Pete's Steep Pests Tepee[r], by Sepp Testee"
"Peter Klein's Serpentlike[r], by Lester Kneip"
"Petrie's Pestier Respite[r], by Sir Pete" []
"Pets O['] Poets, Oppose Test[r], by Pete Stoops"
"The Pews: She Wept[r], by Wes Peth"
"PFC Tree, Perfect Prefect[r], by F. T. Creep"
"Phat Spree: the Papers[r], by Pepe Harst"
"Pheasant, Antheaps, Heat Snap[r], by Pat Shane"
"Phoebe's Bee Shop[r], by Bo Sheep-Hospebe"
"Phone Toil in the Loop[r], by Hilton Poe"
"Phonies['] Hopes in One Ship[r], by Shon Pei"
"Pia Strode to Despair or Aid Pets[r], by Astrid Poe & [tt] Presad"
"Piacente's Patiences Patencies[r], by Tisa Pence"
"Pick Art, Patrick[r], by Kip Cart & Art Pick"
"Pictorialised Perioidcalist Tilda Respicio[r], by Cristi DePaoli"
"A Piece of a Foe, Epic[r], by Opie Face"
"A Pig Man's Paganism[r], by [if player is male]Pa Sigman[else]Pam Gains[end if]"
"Pigs and Spading[r], by Pa Dings"
"Pigs Need Speeding[r], by Peg Snide"
"Pilgrims['] Grim Lips[r], by Lis Grimp" []
"The Pill-Hell Pit[r], by Pet Hill"
"Pills for Ill Profs[r], by Flor Lips"
"The Pills Help List[r], by Phil Elst"
"Pimp-Erased Pipe Dreams[r], by Amee Dripps"
"Pine Condo on Ice Pond[r], by Dion Ponce"
"Pine Desk, Skin Deep[r], by Ned Pikes & Kip Sneed"
"Pine Grove Viper: Gone[r], by Neve Pirog"
"Pinhead's Deanship Phased In[r], by Enid Hasp"
"Pinheads Had Spine[r], by Desi Phan" []
"Pink Chum Chipmunk[r], by Kip Munch"
"Pink House: Up, Son, Hike[r], by Sophie Kun"
"Pious, I Cuss, Suspicious[r], by Susi Pocius"
"Pip Chase's Space Ship[r], by Sia Schepp"
"A Pitcher's Trips, Each: This Recap[r], by [if player is male]Chet Paris[else]Trish Pace[end if]"
"The Pity-Hit Type[r], by Hye Pitt"
"Placated Cadet Pal, Tape-Clad[r], by Tad Capel"
"Plain Blade, and Pliable: a Bland Pile[r], by [if player is male]Ben Padilla[else]Belinda Pal[end if]"
"Plain Mature Lame Puritan Manipulater[r], by Ariel Putnam" []
"Plain Shorty Sharply Into Rhinoplasty[r], by [if player is male]Rolph Yantis[else]Paris Hylton & Shirl Payton[end if]"
"A Plainer Airplane[r], by Nia Pearl"	100
"The Planet Lept Neath[r], by Ethan Pelt"
"A Planet's Pleasant[r], by [if player is male]Pat Ansel[else]Stan Leap[end if]"
"The Plank Hank Lept[r], by Ken Plath"
"Plans for Flops Ran[r], by Rolf Span"
"Plateaus Pale at Us[r], by Paul East"
"Play into Pony Tail[r], by Opal Tiny"
"A Played Leap-Day Pay Deal[r], by Ada Pyle"
"The Player's Hyper Tales[r], by Tyler Heaps"
"Pleading Glad Pine[r], by Peg Dalin"
"Pleas Come Someplace[r], by Mel Pascoe"
"Pleasantry: Spar Neatly[r], by [if player is male]Stan Player[else]Tyra Naples[end if]"
"Please No Leap-Eons[r], by Enos Apel" []
"Plenty Semi-Empty Lines[r], by Tiny Semple"
"Pliant Etch: That Pencil Can't Help It[r], by [if player is male]Chet Taplin[else]Chanel Pitt[end if]"
"Plied, Piled[r], by Dillie Depp"
"Plights To Spotlight[r], by Phil Gotts"
"Plot Idea: I, Tadpole, Dial Poet[r], by [if player is male]Pat DeLio[else]Tilda Poe[end if]"
"Plot Line: Lion Pelt[r], by Toni Pell"
"Plot Year to Replay[r], by [if player is male]Roy Patel[else]Tyra Poel[end if]"
"A Plucky Luck-Pay[r], by Kay Culp & Lucy Pak"
"Plug This Up, Slight Pith-Slug[r], by Phil Guts"
"Plus-Age Plagues[r], by Gus Apel" []
"Plus Plot Pulls Top[r], by Pop Stull"
"Ply Ma Amply, My Pal[r], by Al Pym"
"PM Taken, Kept Man[r], by [if player is male]Nat Kemp[else]Pam Kent[end if]"
"A Po['] Dry Parody[r], by Rod Yap"
"Po['] Pale Aleppo[r], by Al Pope"
"Poaching: Go In, Chap[r], by Pia Chong"
"Poem Sty So Empty: Mo['] Types[r], by Tom Espy"
"Poet, Ask to Speak[r], by Pat Seko"
"Poet, Prince, Perception[r], by Eric Toppen"
"Poet, Rudely Type Louder[r], by Pedro Tuley"
"A Poet's Po['] Eats[r], by Pat Ose"
"Poetaster Operettas[r], by [if player is male]Peter Sato[else]Pat Rosete[end if]"
"Poetics, Eco-Tips[r], by Scot Pei"
"Poets, Try So Pretty[r], by Rey Potts" []
"Point Late Leapt Into[r], by Patti Leno" []
"Poke at Topeka[r], by Kat Poe" []
"Pokemons Mo['] Spoken Spook Men[r], by Sem Konop"
"Polished Olde Ship[r], by Dolph Eis & Sid Poehl"
"Politer Ol['] Tripe[r], by Eli Port"
"Polka Boy Playbook[r], by Kyla Boop"
"Pomp, Seem So: Poems[r], by Pop Sommese"
"Pompey, My Pope[r], by Mo Yepp"
"Pool the Help, Too[r], by Holt Poe" []
"The Pool's Lost Hope[r], by Loo Speth"
"Poor Cats Scrap Too[r], by Cora Post"
"Poor Serfs['] Professor[r], by Ross Opfer"
"Poor Spine's Oppression[r], by Pepi Rosson"
"The Poor Troop, Eh[r], by Thor Poe"
"Pop, Rind! Rip, Pond[r], by Pip Dorn"
"Pop Thee The Pope, Hep Poet[r], by [if player is male]Theo Epp[else]Pet Hope[end if]"
"Pop's Oral Proposal: Spar-Pool[r], by Pal Spoor"
"The Pope's Hot Peeps[r], by Theo Epps & Pepe Tosh"
"Populist to Pupils: Up, Spoilt![r] by Otis Pulp"
"Porcelain Pelican or Replica? NO[r], by [if player is male]Leon Capri[else]Clare Pino[end if]" []
"Porcelain[r], by [if player is male]Colin Earp[else]Roni Capel[end if]" []
"Porn? I'd Drop In[r], by Dr. Pion"
"Porn With Winthrop[r], by H. P. Ortwin"
"Portable Pet Labor[r], by Albert Po" []
"Portage: Great Op[r], by [if player is male]Pat Gore[else]Peg Taro[end if]"
"Portrayed Predatory[r], by Perry Toad"
"Portugal's Sugar Plot[r], by Proust Gal Opal Gurst"
"Poseidon is No Dope[r], by Odo Ipsen" []
"Poser Court Prosecutor[r], by Sue Proctor"
"Poseurs['] Pure SOS[r], by Russ Poe-Sprouse"
"Posh Tim's Mosh Pits[r], by Toph Sims"
"Posin['] to Stoop in: Options[r], by Otis Pon" []
"The Posse Ops Sheet[r], by Tess Hope"
"Possible Sob-Spiel[r], by Bliss Poe"
"The Post-Hep Tots[r], by Shep Ott"
"A Post So Apt[r], by Papa Stoots & Pat Sposato" []
"Postured Proudest[r], by Ed Proust" []
"Potemkin Poem Knit, Token Imp[r], by Kip Monet"
"Potential: Inept a Lot[r], by Tia Pelton" []
"Pottery by Pretty Boy Toby Petry[r], by Petty Roby"
"Pottery, Ink, Kryptonite[r], by [if player is male]Tony Petrik[else]Kit Poynter[end if]"
"POTUS Pouts[r], by Su Top" []
"Pound Lies, Unspoiled[r], by Deon Pulis"
"Pow, Li'l Pillow[r], by Will Po"
"Powerless Slow Spree[r], by Les Sperow"
"Praetorian Reparation[r], by [if player is male]Aaron Pitre[else]Tara Perino[end if]"
"Pragmatic Magic-Trap[r], by Gita Cramp" []
"A Pre-Term Tamperer[r], by Pat Ermer"
"Predate, Adepter[r], by Pat Reed"
"Predated, Departed[r], by [if player is male]Ted Parde[else]Peta Redd[end if]" []
"Predators['] Teardrops[r], by [if player is male]Pedro Star[else]Dora Prest[end if]"
"Predictable Credible Pat[r], by Delbert Paci & Bert Placide" []
"Predictions, Description[r], by Cristie Pond & Ted Crispino"
"Prehistorical Retrophiliacs[r], by [if player is male]Ali Cristopher[else]Paris Clothier[end if]"
"Prenatal, Parental, Paternal[r], by Pearl Tan"
"Pressing Prigness[r], by E. Springs"
"Prevent Perv Ten[r], by Vern Tep"
"Previously Evil, Our Spy[r], by Yoel Purvis"
"Price, Bad Epic Bard[r], by Deb Capri"
"The Price-Creep Hit[r], by Peter Chi"
"The Price's Three Pics[r], by Chet Piers"
"A Pricy Piracy: I Cry, Pa![r], by Pia Cyr"
"Pride as a Paradise[r], by Sid Parea" []
"Pride Into Perdition[r], by [d-t] Perini" []
"Pride, Pried: I'd Rep[r], by Deidre Ripp"
"A Pride, Repaid[r], by Dr. Pia Pereida"
"Priestly Sly Tripe[r], by Ty Perlis"
"Prim Days Amid Spry Pyramids[r], by [if player is male]Sid Rampy[else]Sam Pirdy[end if]"
"Prim Eva, Vampire[r], by Ravi Pem, Vera Pim & Pam Evri"
"A Prince I Can Rep[r], by Eric Pan"
"Prince of Fine Crop[r], by Fern Pico"
"Print-Game Tampering[r], by Petra Ming"
"Priority: I Rip Troy[r], by Torri Yip"
"Proactive Covert API[r], by Vito Pacer"
"Probation's Absorption[r], by [if player is male]Pat Robison[else]Iona Probst[end if]"
"A Problem Re: Aplomb[r], by Rob Maple"
"Problemist [if player is male]Mr. Tip Boles[else]Ms. Tobi Perl[end if]: Tomb's Peril[r], by Bo Strimple & Emil Probst"
"The Process: Psst, Cohere[r], by [if player is male]Seth Crespo[else]Rose Specht[end if]"
"Prodigal Gold Pair[r], by Gil Prado"
"Prodigals['] Rapid Slog[r], by Paris Gold"
"Profanity-Payin['] Fort Fray Point[r], by Fay Protin"
"A Profounder, Profane Dour Proof, Unread[r], by [if player is male]Pedro Funaro[else]Prue Foronda[end if]"
"Profoundest Spoofed Runt[r], by Pedro Fuston"
"Progeny Gone? Pry[r], by Rep. Yong"
"Prole Loper[r], by Errol Oppel"
"Prologise, Peligroso[r], by Giles Poor"
"Prologues: Our Gospel[r], by [if player is male]Gus Looper[else]Lu Gorospe[end if]"
"Promise Land Palindromes: Random Piles[r], by [if player is male]Paris LeMond[else]Milda Posner[end if]"
"Propitiousness: Super Positions[r], by Pontius Poressi"
"Propose, Opposer[r], by Pops Roe"
"Proprietary Air Property[r], by Portia Perry"
"Prospero's Oppressor Proposers[r], by Ross Opper"
"Protein: One Trip[r], by Pierpont Ireton" []
"Prototypes Pretty Oops[r], by Petty Spoor"
"Proudest Dust Rope[r], by Super [d-t]" []
"Provide, Viper, Do[r], by Vi Pedro"
"Prude, I Tut Turpitude[r], by Rudie Putt"
"A Prude's Read-Ups[r], by Sad Rupe Persaud" []
"Prudence is Due, Princes, Ripe Dunces[r], by Enid Spruce"
"A Pry, Epic: Pay Price, Icy Paper[r], by Pip Carey" []
"A PSA ASAP [r], by Asa Papas"
"Psychic to Psychotic[r], by Coy Pitsch"
"Psycho Ails So Physical[r], by Phyliss Cao"
"The Public Belch I Put[r], by Butch Pile"
"Pukin['] Up Ink[r], by Niiku Knupp" []
"Punching-Pinch Gnu[r], by Chip Gunn"
"Punctilio: I Pin Clout[r], by Luci Pinto" []
"A Pundit: Paid Nut[r], by Ida Punt"
"A Puniest Petunia's Inapt Use[r], by Una Stipe"
"The Punk: Nth Puke[r], by [if player is male]Kent Phu[else]Pet Kuhn[end if]"
"Punt the Tent, Hup[r], by Pet Hunt"
"Pure Cats Act Super[r], by Curt Pesa"
"Pure Class Plus Cares[r], by Russ Capel"
"Pure Gold Prude Log[r], by Doug Perl"
"Pure, I Tell Ill Repute[r], by Lu Peltier"
"Pure Skit, Strike Up[r], by Kip Suter"
"Purest Alive Superlative[r], by [if player is male]Paul Sievert[else]Lupita Evers[end if]"
"Purest Uprest Erupts[r], by Ruppe Russett"
"A Purist's Upstairs[r], by Pia Truss"
"Puritans['] Rasputin: Rust, Pain[r], by Pia Sturn"
"Puritans['] Rasputin[r], by Stu Arpin"
"A Purplish Rash Pupil[r], by Lura Shipp"
"A Purpose: Pure Soap[r], by Pop Sauer"
"Pushcart Path Curs['] Scrap Hut[r], by Curt Pash"
"Put [']Em On, Poem Nut[r], by Moe Punt"
"A Pygmy May Gyp[r], by Gay Pym"
"Quadrilles['] Dire Squall[r], by Raquel Dils"
"Quail, Me? I'm Equal[r], by Miquela LaMique"
"A Quaint Aqua Tin[r], by Taniqua Quitana"
"Quarterlies: Squarer Tile, Quirt Resale[r], by Raquel Reist"
"Quatloos, Lo, Quotas[r], by Loo Quast"
"Questionable Tequila Bones[r], by Lenita Bosque" []
"Quiet Rob's Sobriquet[r], by Bero Quist"
"Quietly's Quite Sly[r], by Ty Equils"
"Rabbi Ran In[r], by Brian Inbar-Rabin" []
"The Rabbis['] Rehab Bits[r], by [if player is male]Bert Baish[else]Sheri Tabb[end if]"
"Rachel's Larches[r], by Sal Cher" []
"Racicot's Acrostic[r], by Art Cisco"
"Rad Foil, Far Idol: Do Flair[r], by Dr. Fiola Florida" []
"Rad Glib Bad Girl[r], by Gil Bard"
"Rad Hate: a Thread[r], by Ed Haart"
"Rad Slang Garlands[r], by Sal Grand"
"Rad Waste Eastward[r], by [if player is male]Wade Star[else]Dara West[end if]"
"Radio or Aid[r], by Dara DiOrio"
"Radio's So Arid[r], by Sid Ora" []
"Radtke's Darkest Ad Treks[r], by Ed Stark"
"Rag of Fargo[r], by Ara Rog-Goff" []
"Rageless Largesse[r], by Sal Seger"
"Raggeder Doodad[r], by Edgardo Odegard"
"Raggedy Yard Egg[r], by Greg Day"
"Ragin['], I Rang[r], by Ingar Garin" []
"A Ragin['] Niagra[r], by Rai Nga"
"A Ragman's Anagrams[r], by Sam Ragan"
"Ragmen, Manger[r], by German Engram-Magner" []
"Ragtime's Magister Migrates[r], by [if player is male]Art Meigs[else]Geri Mast[end if]"
"Ragweed Edge War Age Drew[r], by [if player is male]Ed Wager[else]Dee Graw[end if]"
"Rah, Dog, Go Hard[r], by Haggard Hodor"
"Rah, Dusty Thursday[r], by Trudy Ash"
"Rah, Lilt: a Thrill[r], by Art Hill"
"Rah, Men[r], by Herman Hamner"
"Rah Rah Toot[r], by Thora Roath"
"The Raid: Ah, Tired, a Dither[r], by Di Harte"
"Raid by a Birdy[r], by Brad Yi"
"Rail Fest Art Files[r], by Rita Self"
"Rail on or Nail no Liar[r], by Lorina Nailor"
"Railbus Burials[r], by [if player is male]Sal Rubi[else]Su Blair[end if]"
"Rain, Go: I Groan or Gain[r], by Irina Gongora" []
"The Rain in Earth Hit Near[r], by Teri Han"
"Rainiest Inertias[r], by Nate Iris"
"Rake Chin, Neck Hair[r], by Hank Rice"
"Rallying Any Grill[r], by [if player is male]Ryan Gill[else]Lyla Ring[end if]"
"Ramble On? Be Normal[r], by Mel Baron"
"The Rams[r], by Mrs. Thea Mathers-Amherst" []
"Ran Due Under a Rune-Ad[r], by Unread Andreu Renaud" []
"The Ranch: Her Chant[r], by Ren Hatch"
"Rancid Ol['] Clorinda[r], by Conrad Li" []
"A Random No-Drama Roadman[r], by Dan Mora"
"Rank Ode, Dark One[r], by [if player is male]Rod Kane[else]Nedra Ko[end if]"
"Ransomed Roadsmen[r], by Ned Ramos-Soderman" []
"Rant? Buy! Try a Bun[r], by Brant Yu"
"Rant Hill: in Thrall[r], by Lin Hartl"
"Rant of No Raft to Fran, For Nat[r], by Fat Ron Anfort" []
"Rant Some, Smear Not a Monster Near Most[r], by Stan More" []
"Rants to Start on[r], by Nat Orst"	100
"Rap, a Pizza, Paparazzi[r], by Ariza Zapp"
"Rap Hits: His Part[r], by Pat Rish"
"Rapid Solo Polaroids[r], by Lois Pardo"
"Rapidest it Spread, Traipsed[r], by [if player is male]Ted Paris[else]Pat Edris[end if]" []
"Rapids Nor Raindrops[r], by Don Parris"
"Rarish, Sirrah![r], by Sharri Harris"
"Rash Diet? Read This[r], by Sid Harte" []
"Rash Met, Hamster[r], by Mathers Amherst" []
"Rash Town Now Trash[r], by Thor Swan"
"Rasp True, Pasturer Raptures[r], by Super Art Perraust" []
"Rat Poop? A Top Pro[r], by Pat Poor"
"Rate No Ornate Neo-Art[r], by Tarone Antero" []
"Ratings Staring[r], by Si Grant"
"Rationing an['] Rioting: I, Ignorant[r], by Gino Tarin"
"Rave on, Verona[r], by Erna Vo"
"Rave, Think: Hark, I Vent[r], by Kevin Hart"
"Ravelling Graven Ill[r], by Glen Rival" []
"The Ravens['] Nest Haver[r], by Trav Sheen"
"Ravines as Riven[r], by Irv Sena" []
"Raw Hot Art: HOW or WHAT[r], by Thora W. Horwat" []
"Raw-Led Dweller Award[r], by Lew Ard-Wardle"
"Raw Lie Wailer[r], by Al Weir"
"Raw Tel, Warlet[r], by Walter Wartle" []
"Ray Knew Wankery[r], by Ken Wray"
"Re-Aim, Marie[r], by [if player is male]Maia Riemer[else]Amari Meier[end if]" []
"Re-Blessing Inselbergs: Green Bliss[r], by Bern Lessig"
"Re-Bowl, Low Reb[r], by Rob Lew"
"Re-Fit, I Fret Fer It[r], by Effi Ritter"
"Re-Hefting the Fringe[r], by Gene Firth"
"Re-Inspect, Prescient[r], by Eric Spent" []
"Re-Live, Eviler[r], by Liv Ree"
"Re-Oiling Religion[r], by [if player is male]Eli Ringo[else]Lori Egin[end if]"
"Re: Opts or Pets So Pert[r], by Roeper Spotts & Pops Troester"
"Re-Read, Reader[r], by Deedra Errera"
"Re-Say, Years-Sayer[r], by Seyra Ayers"
"Re-Scald, Cradles[r], by Les Card" []
"Reach Not, Nor Teach the Acorn[r], by Ace North"
"Reach Out: a Re-Touch[r], by Horace Tu" []
"Reactionary Erotica Yarn[r], by [if player is male]Corey Traina[else]Tonya Carrie[end if]"
"Reactionist Recitations[r], by Cristi Eaton" []
"Read Into No Tirade[r], by Teri Doan"
"Read My Arm Dye[r], by Red Amy" []
"Readily I'd Layer[r], by Ali Dyer"
"Readmit Mad Rite: Dream It![r], by Tad Mier"
"The Real Leather Tarheel[r], by Lee Rath"
"Real Men Leer, Man[r], by Marlene Ermalen" []
"Real Odd Old Dear[r], by Rod Dale" []
"Real POS Paroles[r], by Sol Earp" []
"Real-World Lore-Drawl[r], by Rod Lawler" []
"Realistic Clarities[r], by Lisa Trice" []
"Reality TV: Vile, Tarty[r], by Vita Tyler"
"Really All Rye[r], by Ellray Learly"
"Ream Not a Mentor[r], by Art Moen"
"Reap Sad Parades: a Spread, Dear Sap[r], by Des Paar" []
"Reared Dearer[r], by Deedra Errera" []
"Rearing a Ringer, Angrier[r], by Gerrina Garnier" []
"Reasons Snare So[r], by Ren Sosa" []
"Reaving Vinegar[r], by Vi Regan-Avinger"
"Reba's BS Era[r], by Sabra Beers"
"Rebel and a Blender[r], by Len Beard"
"Rebel-Mass Assembler[r], by [if player is male]Elmer Bass[else]Sam Belser[end if]"
"Rebuilt it Bluer[r], by Bret Lui & Lu Trieb" []
"Recalling: All Cringe[r], by [if player is male]Carl Ingle[else]Nell Craig[end if]"
"Recension, Ninescore[r], by Corie Senn"
"Recharge Her Grace[r], by Cher Ager"
"Reclaim One Ceremonial Anemic Role[r], by [if player is male]Eric Malone[else]Erma Nicole[end if]"
"Reconsign Censoring[r], by Signe Corn" []
"Record it, Director[r], by Rod Trice"
"A Record or Raced[r], by Ed Corra"
"Recount No Truce, Curt One[r], by True Con Cureton" []
"Rectoress Crosstree[r], by Ross Crete"
"Red Bag Garbed[r], by Dr. Gabe Gadber"
"Red Bank Ark-Bend[r], by Ken Bard"
"Red-Barn Bernard Brander[r], by Ned Barr" []
"Red Beans and Beers[r], by Ed Barnes"
"Red Button: Rotten Bud[r], by Don Butter"
"Red Fuel, Rude Elf[r], by Fred Lue"
"A Red Glow, Low-Grade[r], by Olga Drew"
"Red Hen: Her End[r], by Ed Hern"
"Red Hotel: The Older Doth Leer Here, Dolt[r], by Ted Roehl"
"Red Law, War-Led[r], by Al Drew-Wardle" []
"Red Line El Diner[r], by [if player is male]Len Reid[else]Erin Eld[end if]" []
"Red Mike, Mere Kid[r], by Kim Erde"
"Red Snow Wonders[r], by Wes Dorn" []
"Red Tex Dexter[r], by Ted Rex"
"Red Toys Destroy Oyster D[r], by Ty Erdos"	40 []
"Red Zone Den Zero[r], by [if player is male]Dee Zorn[else]Zoe Dern[end if]"
"Red's Love, Resolved[r], by [if player is male]Sol Dever & Les Dover[else]Eve Lords[end if]"
"Redneck Dr. Encke[r], by Ed Renck"
"Redo Nowt: Door Went to Wonder[r], by [d-t] Rowen, Drew Toon & Don Tower" []
"Redo Pains: No Despair[r], by [if player is male]Deon Paris[else]Ines Prado[end if]"
"Redo Thy Try, Eh, Do[r], by Dorthey Doherty" []
"Redwood Word Ode[r], by Reo Dowd"
"Refund a Fun Read? Rude Fan[r], by [if player is male]Fred Una[else]Fran Edu[end if]"
"Refund a Rude Fan[r], by [if player is male]Andre Fu[else]Fae Rund[end if]-Dufrane" []
"Regal Knots: Long Streak[r], by [if player is male]Grant Kelso[else]Karol Tseng[end if]"
"Regal Thin Earthling[r], by [if player is male]Neil Garth[else]Letha Ring[end if]"
"Regarding Regrading[r], by [if player is male]Greg Darin[else]Ginger Ard[end if]"
"Regents Got Rotten Eggs[r], by Greg Teston"
"Reggio's Gorge is Soggier[r], by Og Gries"
"Reggio's Sore Gig[r], by Og Greis" []
"Regisseur Surgeries[r], by [if player is male]Russ Eiger[else]Su Greiser[end if]"
"A Regret Greater[r], by Art Gere-Traeger"
"Rehab Not the Baron[r], by [if player is male]Bart Hoen[else]Bea North[end if]" []
"Reheat the Ear Hereat[r], by Arethe Ethera"
"Rei Riddell, Riled Idler[r], by Deril Riedl"
"Reignship Perishing[r], by Sheri Ping"
"Rein Inner Ire[r], by Erin Neri" []
"A Relent Eternal[r], by Art Neel"
"Relic-Laden Cinderella[r], by [if player is male]Eric Leland[else]Nell Darcie[end if]"
"Relisted, Let's Ride[r], by [if player is male]Ted Riles[else]Lis Deter[end if]"
"Relit by Liberty![r] by Teri Bly"
"Rely on Ol['] Ryne[r], by Ron Ley & Lon Rey" []
"Remain a Miner[r], by Marnie Manier" []
"Remains of Famines or Fair Omens[r], by [if player is male]Simon Fear[else]Mona Fries[end if]"
"Remanded [d-word-u]eder[r], by Ned Mader" [p]
"Remit an Art Mine[r], by Martine Tremain" []
"Remit Merit[r], by Terri Immet"
"Remorse So Merer[r], by Esme Orr" []
"Remorseless Mere Lessors[r], by Mose Ressler"
"Remote Emoter Tore Me[r], by Tom Ree"
"Rena's Snare[r], by Erna Nasser"
"Rend, Nerd[r], by Renn Redd"
"A Reneged Renegade[r], by Dee Regan"
"Renewable, Leaner Web[r], by [if player is male]Ewan Elber[else]Elena Werb & Wren Albee[end if]"
"Renovate, Over-Neat[r], by [if player is male]Von Teare[else]Eve Arnot[end if]"
"A Rent I Retain[r], by Terian Reitan" []
"Repast on a Pronest Post Near[r], by Ernst Pao"
"A Replay-Ply Area[r], by [if player is male]Pa Leary[else]Lara Pye[end if]"
"Repo-Co Core-Op[r], by Eco-Pro Roc Poe-Cooper" []
"Repulsed Preludes[r], by Les Drupe" []
"Resented Tree Dens[r], by [if player is male]Ed Ernest[else]Dee Stern[end if]"
"Resenting a Tangerine's Inner Stage[r], by [if player is male]Gene Strain[else]Irene Stang[end if]"
"Resigned Sneer, Dig[r], by Sid Green"
"Resist, Sister[r], by Tess Ri"
"Respond, Holy Polyhedrons[r], by Loyd Pherson & Dyson Proehl"
"A Response Pre-Season[r], by Rose Aspen"
"Rest, Bind, Bird Nest[r], by Sid Brent"
"Rest, Empire Perimeters[r], by Peter Miers"
"Rest Home Theorems[r], by Tom Sheer"
"Rest Ill, Lilters[r] by Lilster Stiller"
"Rest, Maid, Die Smart[r], by Tim Sader"
"Rest, Pained Pedestrian[r], by [if player is male]Denis Pater[else]Dina Streep[end if]" []
"Rest, Sour or Surest Trousers[r], by [if player is male]Ross True[else]Rose Rust[end if]" []
"Resting Worm Mister Wrong: Smit, Regrown[r], by [if player is male]Storm Winger[else]Ming Worster[end if]"
"Resuming a Measuring[r], by [if player is male]Sam Guerin[else]Gia Sumner[end if]"
"Retain the Inert Hate[r], by Teri Ethan" []
"Retallying Integrally[r], by Gina Tyrell"
"Retention, Not Entire[r], by [if player is male]Teo Tinner[else]Ione Trent[end if]"
"Retitling Littering[r], by [if player is male]Gil Ittner[else]Lin Tigert[end if]"
"A Retold Roadlet Rot-Deal[r], by [if player is male]Art Dole[else]Lea Dort[end if]"
"Retooling My Inert Gloomy Terminology[r], by [if player is male]Tony Gilmore[else]Miley Gorton[end if]"
"Rev of Sly Flyovers[r], by Yves Rolf"
"A Revel in Near Evil[r], by [if player is male]Lee Arvin[else]Erin Vale[end if]"
"Revival: La Vivre[r], by Irv Vale"
"Revive Staid Derivatives[r], by Davie Stiver" []
"Rewind, Lorn Inner World[r], by Drew Norlin"
"Rewind, Tank: Dank Winter[r], by [if player is male]Kent Darwin[else]Dawn Tinker[end if]"
"Rhea's Share[r], by Sarah Esher" []
"Rhodes Hordes, Reshod[r], by Sherrod Dohse"
"Rhodesia: Her Adios[r], by [if player is male]Dre Hsiao[else]Rio Shade[end if]"
"Ribald Dr. Albi[r], by Brad Li" []
"Ribs Gone? Big Snore[r], by Bo Singer" []
"Ric's End: Dr. Nice's Cinders[r], by Ned Cris"
"Ric's Quiet Critiques[r], by Eric Quist"
"Rich Man, G: Charming Mr. Ganich[r], by Nic Grahm" []
"Rich Saint Christi[if player is male]an[else]na[end if][r], by [if player is male]Artis Chin[else]Traci Shin[end if]" [x]
"Rico Knew Nice Work[r], by Ike Crown" []
"Rid Fools So Florid[r], by Lois Ford"
"A Riddle, Dire Lad[r], by Ed Laird & Del Radi"
"Ride Slow, Wild Rose[r], by [if player is male]Rod Lewis[else]Doris Lew[end if]"
"Ride West, Weirdest Sir Tweed[r], by Ted Swire" []
"The Ridge: Dig There[r], by Ted Gehri"
"Riding a Raft: Fair Trading[r], by Frida Gartin"
"Rife Snob Bonfires: Be For Sin[r], by Bo Fenris"
"Rifts Rage: First Gear[r], by Gert Faris"
"A Rig of Fair Go for Gia[r], by Giorgio Raffa"
"Rig Then the Ring[r], by Thin Reg Enright"
"Right Field Filth Dirge[r], by Fredi Light"
"Right Mean Nightmare Tamer Nigh[r], by [if player is male]Art Heming[else]Mira Ghent[end if]" []
"Right Now's This Wrong[r], by [if player is male]Wing Horst[else]Trish Wong[end if]"
"Rights of This Frog[r], by Thor Figs" []
"Rigor Knew Reworking[r], by Roger Wink"
"Rigor Man Morrigan[r], by Moni Garr" []
"The Rim Hermit[r], by Mimi Therreth"
"Ring Al, the Real Thing[r], by [if player is male]Nigel Hart[else]Leah Grint[end if]" []
"Ring His Hirings Nigh, Sir[r], by Irish Ng"
"Ringside Desiring[r], by Sid Inger-DeNigris"
"Rio's Soir[r], by Siri Roos" []
"A Riot Ratio[r], by Taria Torio"
"The Riot's Hot Rites[r], by Sheri Ott"
"A Rip: I Rap[r], by Pria Ripa"
"Rip Oaths, Aphorist[r], by Otis Harp"
"RIP Seth, Pert-Ish Hipster[r], by H. Priest"
"Ripe Air Prairie[r], by Ira Peri"
"Ripe Epochs['] Prophecies[r], by Porsche Pei"
"Ripen, Keen Innkeeper[r], by Keren Pine & Renee Pink"
"Ripen, Piner[r], by Erin P. Prine"
"Riposted, Topsider![r] by Rod Stipe"
"Rise Bad: a Bride's Sidebar[r], by Ed Brais"
"Rise, Top Spite or Sore Pit[r], by Pieper Rossitto" []
"Rise, Tots, to Resist[r], by Otte Riss"
"Risen Cons['] Corniness[r], by [if player is male]Nino Cress[else]Cris Sonne[end if]" []
"The Risen Sin There[r], by [if player is male]Tre Hines[else]Erin Tesh[end if]" []
"Risks to Skirt So[r], by Kristos & Kit Ross"
"Rivals Too Savor Toil[r], by [if player is male]Art Olivos[else]Lois Tovar[end if]"
"Riven-Bark Riverbank[r], by [if player is male]Kevin Barr[else]Vera Brink[end if]"
"A River: Arrive, Varier![r] by Irv Rea"
"Road Rage: a Drear Go[r], by Edgar Roa"
"Road-Units['] Durations[r], by Rod Austin" []
"Roadies, Do Arise[r], by [if player is male]Ed Soria[else]Ida Rose[end if]" []
"Roads Went, Set Onward[r], by Drew Aston" []
"Roadside So Raided: Arid Odes[r], by Doris Ade"
"Roam, Cuss: Our Scams Soar, Scum[r], by Mac Russo"
"Roam Moar[r], by Mara Romo" []
"A Roast to Sara[r], by Ra Sato"
"Roast Vs. TVs: Soar[r], by Art Voss-Stavros"
"Roasted to Dares[r], by Rod East"
"Rob, Bro, Rob[r], by Bob Orr"
"A Robot Barterer[r], by Roberta Barreto"
"Robustly or Subtly, Lusty Bro[r], by Burl Yost" []
"Rochester Hectorers[r], by Cher Roets"
"Rod, Muck, Mud, Rock[r], by Mr. Ducko Murdock"
"Rod Ruby's Sorry Bud[r], by Rudy Bors"
"Rod Sent Nerds to Dr. Stone[r], by Ted Sorn" []
"A Rodent Not Dear[r], by Nate Ord"
"Rogue, Fit to Figure: I Get Four[r], by Geri Tufo"
"Roiled, or Idle? Id-Lore[r], by Dollie Roider"
"Roll Back, Cork Ball[r], by [if player is male]Carl Blok[else]Lor Black[end if]"
"Roll Back, Rock Ball[r], by Carl Kolb" []
"Roll Back, Rock Ball[r], by Clark Bol"
"Romp, Fate: Part of Me[r], by Pam Forte"
"Romp, Idle Imploder[r], by [if player is male]Pedro Lim[else]Dori Lemp[end if]"
"Ron's Poem: Some Porn[r], by [if player is male]Mo Posner[else]Ro Empson[end if]"
"Roofless Solo Serf[r], by Flo Rosse"
"The Room? Eh, Motor to Homer[r], by Thor Moe" []
"The Room: Moot Her[r], by Tom Oher" []
"Root Canal: a Cool Rant[r], by [if player is male]Aaron Colt[else]Cora Alton[end if]" []
"Rope This Tire Shop[r], by Si Thorpe" []
"Roped, Pedro Pored[r], by Red Rod Pope" []
"The Ropes Stop Here[r], by Hope Rest"
"The Rose She Tore[r], by Ester Ho" []
"Rose's Zone: Ones, Zeros[r], by Zoro Essen"
"Rosie's Osiers Rise So[r], by Rossie O'Reiss"
"Rot Chalet Tot Rachel[r], by Charlotte Lorch-Tate" []
"Rot on or Not[r], by Toronto Ron" []
"Rotations Strain Too[r], by Otto Nasir"
"Rote Mood: More To Do[r], by [d-t] Moore"
"Rotten Hack Tank Hector on the Track: Reckon That[r], by [if player is male]Chet Kantor[else]Retta Knoch[end if]"
"A Rotten Tot Near[r], by Ron Tate"
"Rottenly-Entry Lot: Try, Let On[r], by Trent Loy"
"Round Bay Boundary[r], by Dan Rubyo"
"Round by a Boundary[r], by [if player is male]Bruno Day[else]Una Brody[end if]"
"Round Malta's Laundromats[r], by [if player is male]Amos Rutland[else]Maud Ralston[end if]"
"Round Topic Production[r], by [if player is male]Tudor Picon[else]Cori DuPont[end if]"
"Rounded Odd Rune: Dour End[r], by Nerd Duo Ed Duron & Noe Rudd"
"Roundtree's Unrestored Ruts, Redone[r], by [if player is male]Rene Stroud[else]Ester Duron[end if]" []
"Rouse My Muse, Roy Seymour[r], by Sue Mory" []
"Roust Them Some Truth[r], by Theo Sturm"
"Row East To Swear or Waste[r], by Tre Sowa"
"The Rows So Threw[r], by Wes Roth"
"The Rows Who Rest[r], by Wes Roth"
"Roy Hits History[r], by Sy Orith" []
"Roy, Mom, My Room[r], by Mo Mory"
"Roy's Hit: Shy Tiro Sir Hoyt[r], by Troy Shi" []
"Royals Got Astrology[r], by [if player is male]Troy Lagos[else]Olga Story[end if]" []
"Rub a Dodgy Bodyguard[r], by Doug Brady"
"Rub Head: Hear, Bud[r], by Abe Hurd"
"Rubbish, His Burb[r], by Bri Bush"
"Rube and a Burden[r], by Ben Radu" []
"Rube Ben's Beer Snub[r], by Bee Burns"
"Rubes Get Beer Guts[r], by Gus Ebert"
"Rude Ole Dour Lee[r], by Lou Reed"
"The Rude Reed Hut[r], by Ruth Dee"
"Rude Times Demerit Us[r], by [if player is male]Tim Deuser[else]Edie Sturm[end if]"
"Rude Yawn Underway[r], by Andrew Yu"
"Rue Isle Leisure[r], by Si Euler & Luis Ree"
"Rue Slurs Less[r], by Russel Sulser-Surles"
"Rue This Ire Thus[r], by Hirsute Stu Hier"
"Ruin-Kept Turnpike[r], by Ken Pruit"
"Ruin Month: Turn on Him[r], by Ruth Minno"
"Ruing by Burying[r], by Bri Yung"
"The Rule Hurt Lee[r], by Hue Ertl" []
"The Rules Sleuther[r], by [if player is male]Lee Hurst[else]Hester Lu[end if]"
"Ruling a Gun Lair[r], by [if player is male]Gil Ruan[else]Lauri Ng[end if]"
"Rumble, Mr. Blue[r], by Rube Brummell"
"Ruminate, Aunt Meri: Main, True[r], by [if player is male]Tim Urena[else]Euna Trim[end if]"
"Run a Gig: Arguing[r], by Ian Rugg"
"Run a Tally Naturally[r], by Lula Ryant"
"Run Amok on a Murk[r], by Ramon Ku"
"Run Below Now Bluer[r], by Burl Owen-Welbourn"
"Run, Bots So Burnt[r], by Stu Born"
"Run, Dodge, Grounded Underdog[r], by Doug Dern" []
"Run-Down Dunn Row Word Nun[r], by Dru Wonn"
"Run One Neuron[r], by Ren Uno"
"Run, Tag a Grunt, Tru-Nag[r], by 'Gut' Arn Ungart"
"Run To Be No Brute[r], by Burt Eno"
"Run To No Rut[r], by Ron Tu"
"Rune-Day: Unready[r], by [if player is male]Andre Yu[else]Dyan Ure[end if]" []
"Rune, Mass, Surnames[r], by Sam Nurse"
"Runes for Our Ferns[r], by Su Renfro"
"Runic Sty, Icy Runts: Scrutiny[r], by Sy Curtin" []
"Runt by a Bay, Turn[r], by [if player is male]Brant Yu[else]Ruby Tan[end if]" []
"Rurales Surreal[r], by Lu Raser"
"Rush at Ruts: Ah, As Hurt[r], by Su Hart"
"Rush On or Shun[r], by Ron Shu" []
"Rustiest Trusties[r], by [if player is male]Si Sutter[else]Tess Turi[end if]"
"A Rut on to a Run[r], by Una Ort" []
"Ruts Etch the Crust[r], by Curt Tesh"
"Ruttan's Truants[r], by Stu Tran"
"Ryan's Yarns[r], by Nyna Sarrys"
"Rye O['] Yore[r], by Rorey Yeo"
"Sable Bales[r], by Bebe Sallas"
"Sabotage Boastage[r], by Gaea Bost" []
"A Sacred Arcade's Sad Care[r], by Ced Saar"
"Sad Beau Aubades[r], by Bud Aase"
"Sad Ben's Badness[r], by Ned Bass & Dan Bess"
"Sad Boy Bo's Day[r], by Sy Doba" []
"The Sad Deaths At Ed H.[']s[r], by Ted Ash & Tad Esh" [] [p]
"Sad Fool Adolfo's Old Sofa[r], by Alf Sood"
"Sad Forge: Grades of God's Fear[r], by Sage Ford"
"Sad Kin Danski is Dank[r], by Kandiss Dakin" []
"Sad Life? Fie, Lads[r], by Sid Leaf"
"Sad Men Amends[r], by Em Sand"
"Sad Mo, So Mad[r], by Moss D'Adamo"
"Sad Nerd Dr. Dean's Danders[r], by Sed Rand"
"Sad Rote Art Odes So Rated[r], by Rod East" []
"Sad Rune Asunder[r], by Dan Reus" []
"Sad Story, Artsy Sod[r], by Ross Aydt"
"Sad Tim Admits It's Mad[r], by Sid Tam"
"Sad to Be Boasted[r], by [if player is male]Ted Sabo[else]Deb Sato[end if]"
"Sad Winner Niswander[r], by [if player is male]Drew Annis[else]Sandi Wren[end if]"
"Sad Wren Wanders[r], by Rad Swen Andrews" []
"Sadder Dreads[r], by Dr. Sade Adders"
"Sadly Sly Ad[r], by Dallys Days"
"Safer Fears[r], by Fefe Sarras"
"Sage Dr. Segard Grades[r], by Sad Reg Gerdas"
"Sagest Stages[r], by Teessa Staggs"
"Sail Among Magnolias[r], by [if player is male]Simon Gaal[else]Lois Magan[end if]"
"Sail, Dork: Silk Road[r], by [if player is male]Kris Aldo[else]Lois Dark[end if]"
"Sail On, Alison![r] by Nils Ao" []
"Sail Thru Hail, Rust Lair Thus[r], by Lisa Hurt"
"Sailmaker Malarkies[r], by Mark Elias"
"Saintly Ty Nails a Stylin['][r], by Nita Sly"
"Sal Ewing's Wineglass[r], by Giles Swan"
"Salad of Fad Also[r], by [if player is male]Asa Fold[else]Flo Asad[end if]"
"Sales 'Zen' is Sleaziness[r], by Lessie Sanz"
"Saliva Avails[r], by Al Avis"
"Sallying Slangily[r], by Lila Syng"
"The Salon Heals Not[r], by Elton Ash" []
"Salt-Mine Sent Mail[r], by [if player is male]Nat Miles[else]Nita Elms[end if]"
"Salt Up a Spatula[r], by Pat Saul"
"Salts Go to Glass[r], by Sol Gast & Tal Goss"
"Sam Is Amiss[r], by Ms. Isis Maas"
"Sam's Den: Sad Men's Madness[r], by Em Sands" []
"Same Damp Psammead[r], by Pam Meads"
"Same Death, Meatheads[r], by Ahmed East"
"Same Louts? Soul Mates[r], by [if player is male]Moses Ault[else]Sue Tolsma[end if]"
"Sammi Maims Imams[r], by Ammia Simms"
"Samoa Remorse[r], by Erasmo Moraes-Semora"
"The Sand Handset[r], by Dan Tesh" []
"Sandstone Dens So Tan[r], by [if player is male]Stan Edson[else]Donna Tess[end if]"
"Saner-Side Readiness[r], by Essie Rand"
"Sap Artie, a Pastier Parasite[r], by Tia Asper"
"Sapient Pa Stein[r], by Pat Enis"
"Sapphire: I, Perhaps, a Shipper[r], by Piper Ash"
"Sarge Leon Regales on So, General[r] by [if player is male]Enos Agler[else]Ros Neagle[end if]"
"Sargon Groans or Sang[r], by Rosa Ng"
"Sat Before Roast Beef[r], by Abe Forest"
"Satellites Test Allies[r], by Elissa Lett"
"Sating Giants[r], by Santini Stagg" []
"Satires as Rites[r], by Teri Sas"
"Satires I Assert[r], by Tess Rai" []
"Saucers Scare Us[r], by Russ & Ace"
"Save Him Via Mesh[r], by Avi Shem"
"Save Rich: Carve His Archives![r] by Irv Chase"
"Savvier Diet Derivatives[r], by [if player is male]Vertie Davis[else]Vida Sievert[end if]" []
"Sawmill: All Swim[r], by Slim Law" []
"Sawn Bed, Bad News[r], by Wes Band" []
"Say, Dad, Sad Day[r], by Ada Syd"
"Say, Get Stagey[r], by Ty Sage"
"Say, Rot or Stay: a Story[r], by Roy Ast"
"Say That: Eh, Yes[r], by Tyesha Hastey"
"Scald, Ire, Rile Cads[r], by Ric Dales"
"Scale, Sour Carousels[r], by [if player is male]Lucas Rose[else]Eula Cross[end if]" []
"The Scaly Sly Cheat, Chastely[r], by Seth Clay" []
"Scan Yon Canyons So Canny[r], by Coy Sann" []
"Scant Dice Accidents[r], by Cid Casten" []
"Scar-Beat Bearcats[r], by [if player is male]Bart Case[else]Cara Best[end if]"
"A Scare, Caesar[r], by Ace Ars"
"Scared of Rod's Face[r], by Case Ford"
"Scares to Socrates[r], by Cora Tess" []
"A Scarf Fracas[r], by F. Scara"
"Scarfin['] Infracs[r], by Cris Fan"
"Scarlett Clatters[r], by Carl Test"
"Schemin['] Mensch, I[r], by Sim Chen"
"Schemins, Miss Chen: Nim, Chess[r], by Si Mensch"
"Scholars['] Arch Loss[r], by Hal Cross"
"A School: Lo, Chaos[r], by [if player is male]Sal Choo[else]Loo Cash[end if]"
"Schooled Old Echos[r], by Leo Dosch"
"Scolded Close, Cede Cold Loss[r], by Doc Les"
"Scoop the Echo Spot[r], by Scot Hope"
"Scoot, Ye Coyotes[r], by Coe Stoy" []
"Scorn a Portrait, Procrastinator[r], by Tristan Porcaro"
"Scranton Con Rants, Narcs Not[r], by Stan Corn-Cranston" []
"Screamin['] Man Cries[r], by Ric Means"
"Screams: a Massacre[r], by Mac Sears"
"Screamy [if player is male]Ms. Carey[else]Mr. Casey[end if][r], by [if player is male]Mr. Casey[else]Ms. Carey[end if] Caymers" [x]
"A Screen Careens[r], by Ren Case"
"Screw It, Crew. Sit[r], by Ric West"
"A Scried Sidecar[r], by Eric Das"
"Scrutinise, Sinecurist[r], by [if player is male]Enis Curtis[else]Cristi Suen[end if]"
"Scry Out Our Cyst[r], by Coy Rust"
"The Scum Chum Set[r], by Schuette Schumm"
"Sea-Belly Eyeballs[r], by Sally Bee"
"The Sea: East, Eh?[r] by Teesha Sathee" []
"Sea-Sigh, Geishas[r], by Gia Hess"
"Seabird Sidebar[r], by [if player is male]Sid Baer[else]Deb Aris[end if]" []
"Seabirds['] Sidebars[r], by Bess Radi"
"Seamy Con Came Nosy on My Case[r], by Sam Coyne"
"Sean Culp Cleans Up[r], by Luc Snape" []
"Seasick Ski Aces[r], by Ike Cass"
"Seat Two: We Toast Taste, OW[r], by [if player is male]Wes Tato[else]Ewa Otts[end if]"
"Seawater-Waste Era[r], by Ara Sweet"
"A Secret Tree Sac[r], by Ace Rest" []
"Secretive Vice Trees[r], by Tic Reeves"
"Sed Lang's Sad Glens[r], by Ned Glass"
"Sedated Deadest[r], by Tad Dees"
"Seduction Noticed Us[r], by Dustin Coe & Ted Cousin"
"See, a Plot to Please[r], by Pete Also"
"See, Chap, a Speech[r], by Peaches Paesche"
"See-Gigs Inn: Genie Sings[r], by Signe Gines"
"See Grim Emigres[r], by Meg Reis"
"See Math the Same[r], by Ema Tesh" []
"See, Mine Enemies[r], by Enis Mee"
"See Papa's Apse[r], by Asa Eppes" []
"Seed-Tent Detentes[r], by Ted Steen"
"Seeding Edges In[r], by Ned Egis"
"A Seedy Sad Eye[r], by Ed Seay"
"Seek a Man, Namesake[r], by Sam Keane"
"Seek Any Yankees[r], by Easy Ken Keansey"
"Seek Micro-Mockeries[r], by Cori Meeks"
"Seek On So Keen[r], by [if player is male]Ken Ose[else]Senese Kooken[end if]"
"Seen at A Tense Senate[r], by [if player is male]Estean[else]Tenesa[end if] Santee"
"Seen With the Wines[r], by Stew Hein"
"Seibel Belies[r], by Leslie Bisbee"
"Seidner's Direness[r], by [if player is male]Ned Reiss-Driessen[else]Enid Ress-Resendis[end if]"
"A Self, False[r], by Elsa Saffle"
"Self Talk: Let's Laf, K?[r], by Kat Fells"
"Self-Will Ills Flew[r], by Wilf Ells"
"Sell Lilies[r], by Ellis Lisle" []
"Sell Ma a Smell[r], by Les Lam"
"Semantic Man Cites[r], by Mac Stein"
"Semantics['] Main Sects[r], by Mac Stines"
"Semi-Urban Submarine[r], by [if player is male]Ruben Amis[else]Ines Burma[end if]"
"Semilunar Unrealism[r], by [if player is male]Luis Erman[else]Rina Lemus[end if]"
"Seminal Man Lies[r], by Selmina Milanes-Anselmi" []
"Seminomadic Demoniacism[r], by [if player is male]Dominic Ames[else]Cindie Somma[end if]"
"Semitonic Emictions[r], by Otis Mince"
"Send Out No Duets[r], by Ed Uston"
"Sendejo Jonesed[r], by Ned Jose"
"A Senior Airs One[r], by Ian Rose"
"Senor Cid Cinderos[r], by Cris Oden" []
"A Sensor Reasons[r], by Ena Ross"
"Sent Away? Stay Anew[r], by [if player is male]Wayne Ast[else]Anya West[end if]"
"Sent to Tetons to Nest[r], by Tosten Ettson" []
"A Serf Fears[r], by Raffa Seres & Ares Saffer" []
"Serge, I'm Grim, See[r], by Sig Mere" []
"Serge's Egress[r], by S. Seger"
"Sermonise Emersions[r], by [if player is male]Simon Rees[else]Erin Moses[end if]"
"Serviceable Receivables[r], by [if player is male]Elvis Bearce & Caleb Rieves[else]Alice Bevers[end if]"
"Servitude Riveted Us[r], by Evie Durst"
"Set a Seat East[r], by Essa Tate"
"Set-Dice Deceits[r], by Cid Tees" []
"Set, Haul: a Hustle[r], by Al Theus"
"Set Onward, Stare Down No Steward[r], by [if player is male]Art Downes[else]Ronda West[end if]" []
"Set Plead Pedestal[r], by Del Pates"
"Setback at Beck's[r], by Eb Stack & KC Bates"
"Seven Art Veterans[r], by Nat Veres"
"Seven Gin Evenings[r], by Sven Egin"
"Seven Pink Penknives[r], by Neve Spink"
"Severer, I Re-Revise Reveries[r], by Eve Riser"
"Severing Thy Everythings[r], by Yves Enright"
"Sew [']Em, Wee Ms.[r] by Weems Mewes" [p]
"Sex Tires Existers[r], by Tex Reiss"
"Sexist Set Six Exists[r], by Tess Ix"
"Seymour Mousery[r], by Somer Yu" []
"Shackleton's Chalkstones[r], by [if player is male]Chas Skelton[else]Chantel Koss[end if]"
"Shafter Fathers[r], by Art Shef" []
"A Shah in Sin[r], by Nisha Hains & Shani Sahin" []
"A Shaky Tot: That's Okay[r], by Kathy Sato"
"Shallower Wars, Hello[r], by [if player is male]Les Warhol[else]Lora Welsh[end if]"
"The Sham Has Them[r], by Sam Heth"
"Shaman Ma Nash[r], by Sam Han"
"The Shame Meets, Hah[r], by Heath Ems" []
"Shame Not the Moans[r], by Tom Hanes-Matheson" []
"Shame on Hose-Man[r], by Hans Moe"
"Shameful Leaf-Mush Half-Muse[r], by Huma Self"
"Shameless Mel's Ashes[r], by Selma Hess"
"Shapiro's Posh Airs[r], by Hoss Ripa"
"Shared Red Ash[r], by Sherard Shade" []
"Sharer Hansen[r], by Sharen Hearns-Ahrens"
"Sharpe's Phrases[r], by Rap Hess"
"Shaven, I'd Vanished[r], by Dave Shin"
"She, Fool of Holes[r], by Flo Shoe"
"She is at His Seat[r], by Tia Hess"
"She May Mesh, Ay[r], by Myesha Haymes"
"She-Wolf, Elf Show[r], by [if player is male]Wes Fohl[else]Flo Hews[end if]"
"She'd Act, He'd Cast the Cads[r], by Ted Cash" []
"She's a Horrid Horseradish[r], by [if player is male]Harris Dohse[else]Shari Rhodes[end if]"
"She's Quit His Quest[r], by Suqi Tesh"
"Shed Not the Dons[r], by Ted Sohn"
"Sheesh, Re-Prep, Sphere[r], by Herr Shep Espe"
"Shen Clan Channels[r], by Nan Lesch"
"Shieks and Skinheads[r], by [if player is male]Ed Haskins[else]Karin Hess[end if]"
"Shield Four Flourished[r], by Rudolf Heis"
"Shiest Heists Thesis[r], by Si Tesh"
"Shift Around, Faint Shroud: Author Finds[r], by [if player is male]Stanford Hui[else]Frida Huston[end if]"
"A Shift? No, Faith, Son[r], by Tona Fish"
"Shingle, English[r], by Gil Shen"
"A Shiny Sin, Yah[r], by Hans Yi"
"A Shiny Sin, Yah[r], by Nishya Yashin" []
"Shireton: One Shirt[r], by Ines Roth"
"Shockwave, Skew Havoc[r], by Wes Kovach"
"Shogunate: Enough Sat[r], by [if player is male]Noah Guest[else]Gena South[end if]"
"Shoot Mr. Storm, Oh[r], by Mo Short"
"Shooting This Goon[r], by Otis Hong" []
"Shoppiest Poetships[r], by Pop Theiss"
"Short Jump? Just Morph[r], by Josh Trump"
"Shoulda Had Soul[r], by Lou Dash"
"Show Decency: Concede Whys[r], by Dyche Cowens"
"Show Me a Sham, Woe[r], by Sam Howe"
"Showman? Sham, Now[r], by W. H. Mason"
"Showtime With Some Woesmith[r], by Tim Howes" []
"Shred Not Hot Nerds[r], by Ned Short"
"Shrew, to the Rows[r], by Wes Hort" []
"A Shrewd War Shed[r], by Dre Shaw"
"Shrimpiest Hipsterism[r], by Piers Smith"
"Shrouded Odd Usher[r], by Edd Roush"
"Shrouds, Sod, Rush[r], by Rod Huss"
"A Shtick-Hit Sack[r], by Kit Cash"
"Shun a Bum Subhuman[r], by Manu Bush"
"Shun Ego? [']S Enough[r], by Geno Hsu"
"Shunt or Rush Not, oh Runts[r], by Stu Horn"
"Shunted Hut-Dens End Thus[r], by Ned T. Hsu"
"Shy [sim] in My Shoes[r], by [if player is male]Yohn Simes[else]Missy Hoen[end if]"
"Shy Ere Heresy[r], by Hersey Sheyer"
"Shy Poem: Spy Home, My Hopes[r], by Shep Moy"
"Shyer Tot: the Story[r], by Troy Tesh"
"Shylocking Shockingly[r], by [if player is male]Hyson Glick[else]Glynis Koch[end if]"
"Si Lever Reviles Servile Leviers[r], by Irv Sele"
"Sick Abdul: a Kids['] Club is Bad Luck[r], by Buck Dials"
"The Sicker, Sketchier Hick's Tree[r], by Chet Riske"
"Sid Won't Sit Down[r], by Don Wist"
"The Side It Heeds, Heisted[r], by Dee Tish" []
"Side-Row Rowdies So Weird I'd Swore[r], by Rod Wise"
"A Side to Toadies[r], by [if player is male]Otis Ade[else]Tisa Doe[end if]"
"Side Wood Woos Died[r], by Dodo Wise"
"Siegman's Gaminess[r], by [if player is male]Sage Nims[else]Gena Sims[end if]"
"Sierra Raiser[r], by Siarra Reiser"
"Sign Out in Gusto[r], by [tt] Sung" []
"Signior Rigoni's Origins[r], by [if player is male]Si Gorin[else]Iris Ngo[end if]"
"Signore's Goriness[r], by [if player is male]Ross Egin & Ron Geiss[else]Erin Goss[end if]"
"Silage Isle: Gaga Lies[r], by Gisela Siegal"
"Silent Ploys, Pointlessly[r], by [if player is male]Peyton Sills[else]Polly Stines[end if]"
"A Silenter Slain Tree Re-Entails Lean Rites[r], by [if player is male]Al Steiner[else]Lia Sterne[end if]"
"Silk Fervor, River Folks, Silver Fork[r], by Ferris Volk"
"The Silky Lithe Sky[r], by Keith Sly & Hy Kleist"
"Silky New Yew Kilns[r], by Lyn Siwek"
"Similar Mail, Sir[r], by Iris Alm"
"Simmer, Mimers[r], by [if player is male]Mr. Mise[else]Ms. Remi[end if]"
"Simp Cleo Complies[r], by Mel Scipo"
"Simple Fun Fine Slump[r], by Ulf Pimsen"
"Sin, Agony: Saying No[r], by Gino Snay" []
"Sin, Blonde Blind Ones[r], by Elin Bonds"
"Sin Eve Envies[r], by Svenie Nieves"
"Sin Gave in Vegas[r], by Gia Sven"
"Sin Hurt This Run[r], by Su Trinh"
"Sin So Vain Invasions[r], by [if player is male]Si Savinon[else]Annii Voss[end if]"
"Sinarchist Christians[r], by [if player is male]Rich Stains[else]Cristin Ash[end if]"
"Since Led, Licensed Declines[r], by Ned Celis"
"Sincere, I Screen[r], by Nic Rees" []
"A Sincere Increase[r], by Sean Rice"
"Sing, Leet Gentiles[r], by Gil Steen"
"Sing, Mousy Young Miss[r], by Guy Simons"
"Sing, Smile, Miss Elgin[r], by Sigi Nelms"
"Singapore Prisonage[r], by Gia Posner & Gino Serpa"
"Singular Gun Lairs[r], by [if player is male]Luis Rang[else]Lin Sugar[end if]" []
"A Sink or Rain's OK[r], by Arin Kos"
"Sip Malts, Psalmist[r], by Slim Past"
"Sir, Accept Practices[r], by Pat Cresci"
"Sir Ahmed: His Dream, Semi-Hard, Misheard[r], by Si Dahmer"
"Sir Beef Frisbee, Fib-Seer[r], by Bri Fees"
"Sir Blest-Blisters[r], by [if player is male]Bret Liss[else]Lis Erbst[end if]"
"Sir Cade's Sidecars[r], by Ida Cress"
"Sir, Feel Reliefs[r], by Les Frei"
"Sir Glen Lingers Singler[r], by Les Grin"
"Sir Jake is a Jerk: Ask Jeri[r], by Jae Risk"
"Sir John Hjornis[r], by Josh Nir"
"Sir Kate's Asterisk[r], by Art Sikes" []
"Sir Kent Treks In[r], by Kirsten Snitker" []
"Sir, My Foe of Misery[r], by Mei Forys"
"Sir, Pack Kip's Car[r], by Cris Pak"
"Sir Ron Norris[r], by Snorri Orrins"
"Sir, Take a Strike: Eat Risk[r], by [if player is male]Ike Rast[else]Kat Reis[end if]"
"Sir's Aria Airs[r], by Risa Aris"
"Sirens End Nerdiness[r], by Sid Rennes"
"Sit Apart: It's a Trap[r], by Sara Pitt"
"Sit, Clerk-Stickler[r], by Rick Elst"
"Sit Cold, Clot Sid[r], by Doc List"
"Sit, My Hog So Mighty[r], by Gio Smyth"
"Sit, My Misty[r], by Timmy Tissy"
"Sit, Sneer, Sentries[r], by Enis Rest"
"Sit, Speak, Piss-Take[r], by Peta Sisk"
"Sit Thereon in the Store[r], by Theo Estrin"
"Sit, Ye Yetis[r], by Ty Eis"
"Sits-Mum Summits[r], by Stu Mims"
"Six Algae Galaxies[r], by Alix Sage"
"Six Clone Lexicons[r], by Niles Cox"
"Six Neat Tin Axes: It's Xena[r], by Anti-Sex Ex-Saint Esta Nix"
"Six Rope Proxies[r], by Ox Pires" []
"Sixpence to Exceptions[r], by Tex Pisceno"
"Sixteen Nexties[r], by Tex Enis"
"Skate On, So Taken to Sneak[r], by Ken Sato"
"Skee-Ball: Lee Balks[r], by [if player is male]Les Blake[else]Bella Sek[end if]"
"Skeptical Epic Talks: Late Picks[r], by [if player is male]Kip Castle[else]Pat Eslick[end if]"
"Ski, Daft Fat Kids[r], by Tad Fisk"
"Skimpy Spy Kim[r], by Kyp Sim"
"Skin Welt Twinkles[r], by Lew Kinst & Link West" []
"Skinhead I Shanked[r], by Dean Kish"
"Skip Drama Amid Parks[r], by Kim Prasad"
"Skip on So Pink[r], by Pipkin Snooks"
"Skip, Skip[r], by Kipp Sisk"
"Skit Row: It's Work[r], by Ros Wikt" []
"Skiving Vikings[r], by Sig Vink"
"A Skull: Sulk, Al[r], by Lu Klas"
"Skullcap Luck-Pals[r], by Luc Klasp"
"The Sky is Shy, Tikes[r], by Tish Keys"
"Sky Rim: Smirky, My Kris[r], by Kim Rys"
"Slack Trot? Lost Track[r], by Clark Otts"
"Slade Leads a Sled[r], by Edell Assad" []
"Slam it, St. Liam[r], by Sim Alt"
"The Slav Halvest[r], by Val Tesh"
"Slayin['] Snaily Inlays[r], by Alisyn Yilsan"
"Sleds, Be Blessed[r], by [if player is male]Del Bess[else]Bess Eld[end if]"
"Sleep: Cook Keeps Cool[r], by Leo Kopecs"
"Slender Lenders[r], by Les Dern"
"Slick Con Clocks In[r], by Nick Clos"
"Slick Tot Stock-Lit[r], by Colt Kist"
"Sliding, Idlings[r], by Sid Ling"
"Slighted Delights[r], by Stig Held"
"Slily Silly[r], by Lissy Lilly"
"Slimed, Misled[r], by Dim Les Imseld"
"Slip [']Em, Ms. Pile[r], by Miles P. Plemis"
"Slipshod Old Ships: Sold? Pish[r], by Phil Doss"
"Slo-Mo Looms[r], by Ms. Loo Olmos"
"Slob Ned's Bondless Boldness[r], by [if player is male]Don Bless[else]Bess Lond[end if]"
"Slop Cay Calypso Cosplay[r], by Sly Paco"
"Slop Rise, Ripe Loss[r], by Leo Priss" []
"The Slop Shoplet Slept, Oh[r], by Seth Olp" []
"Slop Up Pulp So, Ol['] Pups[r], by Pops Lu"
"Sloth Dealt Death Tolls[r], by Shella Dott"
"Slow Bleed Bodes Well[r], by [if player is male]Del Bowles[else]Deb Sowell[end if]"
"Slow Burn Blurs Now[r], by Lu Browns"
"Slow Ebb Below BS[r], by Wes Lobb" []
"Slow Elf of Wells[r], by Les Wolf" []
"Slow Pace Cope Laws[r], by Lew Pasco" []
"Slow Tea to Wales[r], by Al Stowe"
"The Slow Wet Hols[r], by Wes Holt" []
"Slug, Seal, Seagulls[r], by [if player is male]Les Glaus[else]Su Slagle[end if]"
"Slugger Gurgles[r], by Les Rugg"
"The Slum Elm Huts[r], by Les Muth"
"Slumbering Muslinberg Sub-Gremlin[r], by Gil Numbers"
"Slur Them, Mr. Hustle[r], by [if player is male]Mel Hurst[else]Ruth Elms[end if]"
"Slur Them, Ms. Luther[r], by Rush Melt-Elmhurst" []
"Sly Bore Beryl, So Soberly[r], by Les Roby, Bo Syler & Rose Bly"
"Sly, I Sob, Bossily[r], by Lis Osby"
"Sly Mood So Moldy[r], by Dy Olmos"
"A Sly Nerd Sanely, Dr. Lysander[r], by Sal Ryden" []
"Sly Ribald Dilly Bars[r], by Sally Bird"
"Slyer Ole Eyerolls[r], by Lyle Rose"
"A Slyer Slayer[r], by Sal Rey" []
"Slyvale Valleys[r], by Sal Levy"
"Small Boy Lomas Bly[r], by Sly Albom"
"The Small Helm Last[r], by Mel Stahl"
"Small Nice Cane Mills[r], by Slim Lance"
"Small Pause: a Slum's Plea[r], by [if player is male]Saul Maples[else]Pamula Less[end if]"
"Small Time Steam Mill[r], by Emma Tills"
"Small Weight Might as Well: a Slight Mewl[r], by Mathew Gills"
"Smart Boy, Artsy Mob[r], by Tom Byars"
"Smart Ode to Dreams Most Dear[r], by [d-t] Mears"
"Smart Ol['] Mortals[r], by Al Strom"
"Smartened Tradesmen[r], by Ned Martes & Art Mendes"
"Smarty Marty's My Star. Stay, Mr.![r] by Ty Mars"
"A Smelly Mall, Yes[r], by [if player is male]Al Myles[else]Sam Lyle[end if]"
"Smelly Ms. Lyle[r], by Les Lym"
"A Smith Smit, Ha[r], by Tim Ash-Mathis" []
"Smither Hermits[r], by Tim Sher"
"Smitten on Ointments[r], by Ennis Mott"
"Smoke, Fire: I Seek Form[r], by [if player is male]Moe Friske[else]Kim Froese[end if]"
"Smoking on King's Moon[r], by Simon Kong"
"Smolenski Isle Monks[r], by Moses Link" []
"A Smugly Gay Slum[r], by Gus Maly"
"Smut Lair Muralist Altruism[r], by Lars Muti" []
"Snag Evil Leavings[r], by Gil Evans-Vangelis" []
"Snakebit Beatniks[r], by Kent Bias" []
"Snap East, Peasants[r], by Tessa Pan"
"Snapple Pen Pals[r], by Len Sapp"
"Sneak, New Keen Swan[r], by Wes Kenna"
"Sneer, Panic, Screen Pain, Inner Space[r], by Sean Prince"
"A Sneer-Snaree[r], by Serena Ranese"
"Snide Ropy Pony Rides[r], by Dione Spry"
"Snide Soul Delusions[r], by Ossie Lund"
"Snider Eras['] Dreariness[r], by Nasir Reeds"
"Snipe Hunt: Shun, Inept[r], by Penni Hust"
"A Sniper, Persian[r], by Ines Arp-Spanier"
"Sniveler Vern Lies in Revels[r], by [if player is male]Les Ervin[else]Lin Evers[end if]"
"Snob Jed's Jobs Dens[r], by [if player is male]Benj Doss[else]Jess Bond[end if]"
"Snob Lad So Bland[r], by Al Bonds"
"A Snooty NO to Say[r], by [if player is male]Tonya So[else]Stan Yoo[end if]"
"Snore Forth, Shorefront[r], by Foster Horn"
"Snoring Rings On[r], by Ros Ginn"
"Snortiest Tenorists[r], by [if player is male]Otis Stern[else]Ines Trost[end if]"
"Snot-Red Rodents[r], by Donster St. Endor" []
"A Snot Sat On So Tan: Son to Satan?[r] by Anton Tasso" []
"Snotbag Nagbots[r], by Bo Tsang"
"Snotty St. Tony[r], by Ty Nost"
"Snow Castle Towns, Scale Low Ascents[r], by Stan Cowels"
"Snow, Ice: We Icons['] Wise Con[r], by Wes Cino"
"Snowbird, Wind-Orbs[r], by Sid Brown & Bri Downs"
"Snowglobe Bones, Glow[r], by Gwen Sobol"
"Snub Theo on the Bus[r], by Ben South" []
"Snug Ol['] Son, Lug Guns, Lo[r], by Su Long"
"So a Hex Hoaxes[r], by Axe Sho"
"So Al's a Loss[r], by Sal LoSasso" []
"So Angry Sang Roy Grayson[r], by Roy Gans"
"So Atlas Also Sat at a Loss[r], by Sal Sato"
"So, Audit a Studio? Aid Us To[r], by Ida Tsou"
"So Ban a Snob[r], by Bo San-Banos"
"So Blank Ol['] Banks[r], by Sal Bonk"
"So-Boring Sir Bongo[r], by Rob Goins"
"So Brawn Bars Now[r], by Rob Swan"
"So Breed Do Beers[r], by Red Bose"
"So Buggy Guys Bog[r], by Gus Bogy"
"So Busy Boys, Us[r], by Susy Bo"
"So Came SeaCom[r], by Mo Case"
"So-Careful Frau Cole's Foul Scare[r], by [if player is male]Lucas Fore[else]Flo Surace[end if]"
"So Chug Coughs[r], by Gus Cho"
"So Cranky? Coy Snark[r], by Caryn Kos"
"So, Dance a Second?[r] by Don Case"
"So, Dictator, Too Drastic?[r] by Otto Sicard"
"So-Dry Sorry Soddy[r], by Roddy Rossy & Yordy Dross"
"So Enter on Trees to Sneer[r], by Ernesto Toresen" []
"So, Enter: Steer on to Sneer[r], by Ron Tees" []
"So-False Seals of Ol['] Safes[r], by Leo Fass" []
"So-Fit Ifs to Foist[r], by Tiffi Soots"
"So, Flags of Glass[r], by Alf Goss"
"So, Flair of Liars[r], by Lis Roaf"
"So Handy? No, Shady[r], by Sandy Oh"
"So Hear a Horse[r], by Ash Roe"
"So Holy? Ooh, Sly[r], by Sol Hoy"
"So I Date Aides to Toadies[r], by [if player is male]Otis Ade[else]Ida Seto[end if]" []
"So I Next Exit, Son[r], by Ox Stein"
"So It Is To Otis[r], by Tiso Tsoi" []
"So Kindly, Dolinsky[r], by Loyd Sink"
"So Leap a Slope[r], by Sal Poe" []
"So, Learn: a Loner's Real Son[r], by Al Rosen-Ornelas" []
"So Leash Seals, Ho![r] by Leo Hass"
"So, Levi, is Love So Vile?[r] by Ilse Vo" []
"So, Like, Lies, OK?[r] by Elie Kosloski" []
"So Manic, I Scan Mo['][r], by Nic Amos"
"So May We Say Meow Some Way[r], by Wes Mayo"
"So Melt Me Lots[r], by Mel Tso" []
"So Mice is Come[r], by Sim Coe"
"So, Mother, the Room's Smoother[r], by Moe Short" []
"So Neal's a Lesson[r], by Lea Noss"
"So-Nerdy Dry Ones[r], by Ron Syed"
"So Often to Footnotes[r], by Toto Sefon"
"So-Perfect Coper Fest[r], by Pet Fresco"
"So Perps Oppress[r], by Ross Epp"
"So Pinch No Chips[r], by Nichois Schnopp"
"So Quaver, Vaqueros[r], by Vas Roque"
"So Quit Quoits[r], by Otis Qu" []
"So Rain Airs On[r], by Rosina Sanrio"
"So Random Rad Moons or Nomads[r], by Sam Doorn"
"So, Rant: No Star as Torn[r], by Tarron Santos" []
"So Rant on, Star[r], by [if player is male]Astor Arnston[else]Rosanna Trost[end if]"
"A So-Rapid Diaspora[r], by [if player is male]Sid Opara[else]Pia Roads[end if]" []
"So Reach Roaches or Chase Cares, Oh[r], by Ash Coer"
"So Recant, Ancestor, Care Tons[r], by [if player is male]Star Cone[else]Ernst Cao[end if]"
"So, Recruit Courtiers[r], by [if player is male]Curtis Roe[else]Su Cerrito[end if]"
"So Romp Promos[r], by Mr. Oops & Ms. Poor" []
"So Sourly, Your Loss[r], by Loy Russo" []
"So Steer On, Stone Rose[r], by Enos Estor"
"So Talk Last, OK[r], by Kat Klos-Solta"
"So Time is to Me[r], by Mo Eist" []
"So, Tinker on Strike[r], by [if player is male]Kent Rios[else]Rose Kint[end if]"
"So-Tired Red Otis[r], by Ted Rios"
"So Treat or Taste[r], by Ros Tate"
"So Trend Rodents[r], by DT Rosen & DO Stern" []
"So, Try: Tory's Story[r], by Sy Ort"
"So, Tut Stout Touts[r], by Su Ott"
"So: Tutor or Touts[r], by Otto Sur"
"So Untidy Tiny Duos[r], by Sid Yount"
"So-Urgent Runt Egos[r], by Stu Groen" []
"So Venom Moves On[r], by Mo Ovens"
"So Went St. Owen[r], by Weston Townes"
"So, Winter: Now I Rest[r], by Teri Snow"
"So, Wretch: The Crows[r], by Wes Rotch"
"Soap on a Spoon: an Oops[r], by Soon-Pa O'Spano"
"Soar, Rosa, Soar[r], by Sara Roos"
"Sob, Gaze, Gazebos[r], by Boz Sage"
"Sob, Icky Sick Boy[r], by Ki Cosby"
"Sob on All Balloons[r], by Lola Snob"
"A SOB's ASBOs[r], by Bosso Sabas"
"Sober Kin is Broken[r], by [if player is male]Ken Boris[else]Kris Bone[end if]"
"Social Men, Coal Mines[r], by Amos Cline"
"Social Men? Malice, Son[r], by Lois Mance" []
"The Social So-Ethical Coal Heist[r], by Theo Scali"
"Socially, Ails Cloy[r], by Lois Clay"
"Society, Long Close Toying: Scientology[r], by Clint Goosey"
"A Society Stoic, Aye[r], by [if player is male]Casey Ito[else]Staci Yeo[end if]"
"Sociopath, I Opt Chaos[r], by Pooch Tsai"
"Sock-Lab So Black[r], by Sal Bock"
"Soda Ados[r], by Odo Assad"
"Soft Ones['] Festoons of Stones[r], by Teno Foss"
"Soft Side of Deists[r], by Odis Stef"
"Soften Up, Poets: FUN[r], by Stef Puno"
"Sog-Oil Igloos[r], by Gil Soo"
"Soggy Elk Egg Yolks[r], by Sky Gogel"
"Sol Slept Plotless[r], by Les Stolp"
"Solarising Sailorings[r], by [if player is male]Silas Giron[else]Lissa Gorin[end if]"
"Soldier is Older[r], by [if player is male]Rod Isle[else]Lois Erd[end if]"
"Soldiers['] Dire Loss[r], by [if player is male]Sid Soler[else]Doris Les[end if]" []
"Solemn Lit Millstone[r], by Les Milton"
"Solemnity Met Nosily[r], by Tony Miles"
"Solid Dis, Lo[r], by Lissi O'Dold"
"A Solid Sad Oil Laid So[r], by Odalis Salido" []
"Solitary Royalist[r], by Lisa Troy"
"Solitary Sailor Ty: Ail-Story[r], by Lyra Otis" []
"Solo Knife Looks Fine[r], by Leif Koons"
"Solon of No Fools[r], by Olfonso Olofson"
"A Somber Mobs Era[r], by Ambrose Boersma"
"Somber Mr Bose[r], by Bess O'Brommer"
"Some Bait a Mob Site[r], by Tobie Sam"
"Some Drip Promised[r], by Pedro Sim"
"Some Envy a Money Save[r], by Evan Moyes"
"Some Faint Manifesto[r], by Fiona Stem" []
"Some Fan of Names[r], by E. F. Mason"
"Some Fire: I'm So Free[r], by Moe Feris"
"Some Gang's Mega-Songs[r], by Megan Goss"
"Some Grunt More Stung[r], by Gus Merton"
"Some Guy You Gems[r], by Gus Moye" []
"Some Kids Smoke Dis[r], by Mike Doss"
"Some Lip Impels O, Spoil Me[r], by Slim Poe" []
"Some Rain: Moan, Sire[r], by [if player is male]Ian Morse[else]Erin Amos[end if]" []
"Some Rays Says More[r], by Ross Maye"
"Son, Abet no Beast at Bones[r], by Ben Sato" []
"Son I Met No Times[r], by Mo Stein"
"Son to Satan[r], by Antos Stano" []
"Son, Ye On, Yes?[r] by Osney Noyes"
"Son's Quiet Questions[r], by [if player is male]Enos Quist[else]Tess Quoin[end if]"
"Songlike Ego-Links[r], by [if player is male]Les Konig[else]Inge Klos[end if]"
"Sonneted Endnotes[r], by Don Steen"
"Soon a Trial So Rational[r], by Tari Alonso"
"Soon in Asia[r], by Sonia Siano"
"SOP for Pros of Proofs[r], by Prof. O. S. Froosp"
"Sophister Storeship[r], by [if player is male]Seth Spiro[else]Sheri Post[end if]"
"Sore-Nose Mermen Sneer: More Omens[r], by Emerson Sermeno"
"Sorry Hike Shirker, Yo[r], by Kris Hoyer" []
"SOS, Man, No Mass[r], by Samson Masson" []
"Soul Mate: Also-Mute Same Lout[r], by Sue LaMot"
"Soul-Screen Enclosures: Lo, Censures[r], by [if player is male]Russel Cone[else]Coleen Russ[end if]"
"Soul-Slain Allusions[r], by [if player is male]Luis Sloan[else]Su Allison[end if]"
"The Sound Den South So Hunted[r], by Donte Hsu"
"Sour Beg-Brogues[r], by Sue Borg"
"Sour Edict, Courtside Custodier[r], by [if player is male]Curtis Doe[else]Trudi Esco[end if]"
"Sour Milk or, Um, Silk[r], by Luis Krom" []
"Soured on Underoos, Soon Rude[r], by Don Rouse"
"South Pole: Louts['] Hope[r], by Lupe Shoot"
"South Side Heist Duos: Eh, Studios[r], by Odis Shute"
"Southbound Sound: But Oh[r], by Bud Houston"
"Souvenir: I, Nervous[r], by Vin Rouse" []
"Sovereign Son, Grieve[r], by [if player is male]Gino Evers[else]Ines Grove[end if]" []
"Sow Fears of Swears[r], by Ross Efaw"
"Space-Time Spite Mace: See Impact[r], by Pete Simac"
"Spade the Head Pest[r], by Pete Dash"
"Spain or Paris? No, a Prison[r], by Soprina Sarpino" []
"Spam Not, Postman. Stamp On[r], by Pam Nost" []
"Spare Me, Mr. Pease[r], by Sam Peer"
"Speak, Peaks![r] by Papa Kesske"
"Speak to Topeka's Oak-Pest[r], by Kat Peso" []
"Speak to Topeka's Oak Pest[r], by Pat Seko" []
"Speaking Pink Sage: Ape, Kings[r], by Kip Agnes"
"Speedily I Ply Seed[r], by Syed Pile"
"Sphere and Sharpened[r], by Reed Spahn"
"Spice Epics[r], by Ceci Pepiss"
"Spice-Oil Policies[r], by Clio Sipe"
"Spin a Web: Nab, Swipe[r], by Pew Bains"
"A Spin? I Snap[r], by Pansi Aspin" []
"A Spirit is a Trip[r], by Pat Iris"
"Spite Row: It's Power[r], by Stew Ropi"
"Spiters Persist[r], by P. T. Reiss"
"Spoiled Old Pies[r], by Sid Poel" []
"The Spook Spoke Hot[r], by [if player is male]Seth Koop[else]Hope Kost[end if]" []
"Spooled Poodles['] Old Pose[r], by Loo Deps"
"Spoonerisms: No-Miss Prose[r], by [sim] Pross"
"Spottable Tabletops[r], by Opal Betts"
"Spout Rich Courtship[r], by Cris Houpt"
"Sprawl of Law Profs[r], by Flor Paws"
"Sprier Song In Progress[r], by Nips Rogers"
"Spry Ole Leprosy Ployers[r], by Ly Poser"
"Spur to Sort Up Po['] Ruts[r], by Proust Pro Stu Stroup"
"Spy Beams, Pass Me By[r], by Mab Sypes"
"Spy Had Pay: Happy Days[r], by Shady Yapp"
"The Squads Had Quests[r], by Ted Squash"
"The Square Queer Hats[r], by Rhea Quest" []
"A Squirm Marquis[r], by Ariq Mus"
"St. Amber, Mr. Beast, Be Smart: Best Arm![r] by Bert Sam" [p]
"St. Claire Recitals[r], by Eric Alst" []
"St. Dade's Dad Sets Saddest[r], by Ted Dass"
"St. Dee's Steeds[r], by Ed Tess"
"St. Eliza, Laziest Zealist[r], by Al Seitz" []
"St. Erika's Asterisk[r], by Teri Kass" []
"St. Fleur's Turfless Flusters[r], by Russ Felt"
"St. Germain Emigrants['] Rematings[r], by [if player is male]Grant Imes[else]Tresa Ming[end if]" []
"St. Ignaco, A Costing Agnostic[r], by I. C. Gantos"
"St. Jeb Co-Objects[r], by TJ Besco & BJ Coste" []
"St. Laurent's Resultants[r], by Trent Sauls"
"St. Lee Steel[r], by Estelle Tse"
"St. Marvin Varmints[r], by Mars Vint" []
"St. Michael, Alchemist[r], by [if player is male]Alec Smith[else]Staci Helm[end if]"
"St. Rene Enters[r], by Ernest Sterne"
"St. Sexi Exists, is Tex's[r], by Tess IX" []
"St. Sinata's Assistant[r], by Tina Stass" []
"Stack of OK Facts[r], by Kat Focs"
"The Stage Gets Heat[r], by [if player is male]Sage Hett[else]Thea Gest[end if]" []
"Stager Greats[r], by Terresa Stagg & Gretta Gasser"
"Stain-Safe Fantasies[r], by Tessa Fina"
"Stale-Air Alestair[r], by Lea Raist"
"Stale Riot, Aristotle[r], by [if player is male]Leo Strait[else]Lisa Otter[end if]"
"A Stale Sale at Aleta's[r], by Al East"
"Staler Alters[r], by Earl St. Slater" []
"Stalin: I Slant[r], by Stan Li" []
"Stand by a Bad Nasty[r], by Dyan Abst"
"Stand it Distant[r], by Sid Tant"
"Standard Dad Rants[r], by Tad Rands"
"Standifer's Draftiness[r], by [if player is male]Anders Fist[else]Astrid Senf[end if]"
"Star of a Frost[r], by Taras Ostroff"
"Star of Frat, So[r], by Taras Ostroff"
"Star-Shine Tarnishes[r], by [if player is male]Seth Rains[else]Tresa Shin[end if]"
"Starfish: His Farts[r], by Ash Frist"
"Stargate Age, Start[r], by Tara Gest"
"Staring at Grins[r], by Art Sing"
"Starside Disaster[r], by Tad Reiss" []
"Starve Vaster[r], by Vesta Travers"
"State-Run Stunt Era[r], by [if player is male]Nat Suter[else]Sue Trant[end if]"
"Statelier Literates[r], by [if player is male]Artist Lee[else]Tia Lester[end if]"
"Stauncher, Unchaster[r], by [if player is male]Ernst Chau[else]Una Tresch[end if]"
"Stay Around on Saturday[r], by [if player is male]Dusty Aaron[else]Tyra Sudano[end if]"
"Stay Back by a Stack[r], by Stacy Bak"
"Stay, Bot So Batty[r], by Sy Batto"
"Stay Cool, Sooty Cal[r], by Stacy Loo" []
"Stay Due, Tuesday[r], by Tay Deus"
"Stay Gold to Gladys, Salty God[r], by Ty Glados & Stodgy Al"
"Stay Hid This Day[r], by Ash Tidy"
"Stay, Men: Amnesty May Nest[r], by Ty Means"
"Staying Stygian[r], by Ty Gains"
"Stealing Gelatins[r], by Ines Galt-Eastling"
"Stealthy, They Last[r], by [if player is male]Les Hyatt[else]Letty Ash[end if]"
"Steam On, Mean Sot[r], by Stan Moe"
"Steel Bars Be Artless[r], by [if player is male]Bret Sales[else]Bess Alter[end if]"
"Steel, Paper, Apple Trees[r], by Pepe Slater"
"Steer a Re-Seat: See Art[r], by Ree Ast" []
"Steering Greetins['][r], by Reg Stein"
"Steichen's Techiness[r], by Tess Chien"
"Stepan's Aptness, Pass Ten[r], by Tess Pan"
"Steph at the Past: Set Path[r], by Pat Tesh" []
"Stephani's Thespians[r], by Seth Spain"
"Sterile Seer-Lit: Rest, Lie[r], by Teri Les" []
"Stern Sage Estranges Greatness[r], by S. Sergeant"
"Stew, Oaf: Fate, Sow Fast Woe of Waste[r], by Fae Stow"
"A Still at Ills is Tall[r], by Lila St. Tallis"
"Still-Hoof Foothills[r], by Flo Holtis"
"Stink Out, Stout Kin[r], by Kit Suton"
"Stink-Stone Token Snits[r], by InesKnotts"
"The Stink Think Set[r], by Kent Tish"
"Stipender President[r], by Trip Edens" []
"Stir, Cool Cortisol Colorist[r], by Loo Crist"
"A Stir: I Star[r], by Trista Aris" []
"Stogy Odor, Good Story[r], by Gordy Soto"
"Stoic From Microsoft[r], by Tom Frisco"
"Stoic June on Justice: Joust Nice[r], by [if player is male]Justin Coe[else]Jeni Couts[end if]" []
"A Stoker of Oak Forest[r], by Rea Stofko"
"Stoking Mr. Storm King[r], by Kim Strong"
"A Stolen Tale, Son[r], by Al Stone" []
"Stolid, I'd Lost[r], by Sid Dills-Otto" []
"Stomach Mo['] Chats[r], by Tom Cash"
"Stomp My Symptom[r], by Tom S. Pym"
"Stonable Notables: Blast One[r], by Lona Best"
"A Stone So Neat to Sean[r], by Easton Seaton"
"Stonier Orients[r], by Ron Eist" []
"Stop, Drear Predators[r], by Rod Spater" []
"Stop Naked, Dank Poets, Don't Speak[r], by [if player is male]Dante Skop[else]Kenda Post[end if]"
"Stopper Toy Prototypes: Tops Poetry[r], by Petty Spoor" []
"A Stork's So Stark[r], by [if player is male]Art Koss[else]Kat Ross[end if]"
"The Storm: Rest, Moth[r], by Sherm Ott"
"A Storm to Mars[r], by Rossa Mottram"
"A Story So Arty[r], by Ty Raso" []
"Stout Liar Tutorials[r], by Stu Rialto"
"Strange Angster St. Regan[r], by Reg Nast" []
"Strange True Great Unrest[r], by [if player is male]Stuart Green[else]Tresa Gunter[end if]"
"Stranger Granters[r], by Ren Garst"
"Straw Men's Stern Maws[r], by Swen Smart"
"Streak'd Darkest[r], by Ed Stark" []
"Streetscape Pacesetters[r], by Peter Casset"
"Stress No Stern SOS[r], by Tess Sorn"
"Strewin['], Winters Went, Sir[r], by Ren Wist"
"Strict-ID District[r], by Cid Ritts"
"A Strife, Fairest[r], by Art Seif"
"Strife of Effort is Its Offer[r], by Tiff Rose" []
"Strife of FireSoft: Forfeits[r], by Riff Seto" []
"StriveCo Covers It[r], by Vic Oster"
"Strober Orb, Rest[r], by Roberts Berrost"
"Strum, Strum[r], by Mr. Stu Sturm"
"Stuck Echo Checks Out[r], by Kutch Esco"
"Studies it's Used[r], by Ted Susi"
"Studio M Dims Out[r], by Mo Dusti & Sid Muto"
"Studying Tidy Guns[r], by Dingy Stu"
"Stumbler Blurts? Me?[r] by Mel Brust"
"A Stunt Taunts[r], by Stan Tu"
"The Stupid Tepid Huts: Thud, Spite[r], by Shedu Pitt"
"Style It Testily[r], by Ty Leist"
"Suave? Go, a Vogue's So Vague[r], by Su Govea" []
"Suaver Vera-Su[r], by Ev Raus"
"Suavery: a Survey Very USA[r], by Eva Usry"
"Sub-Folk of Bulks[r], by Flo Busk"
"Sub-Nerd Burdens[r], by Ed Burns"
"Sub-Nerd Burdens[r], by Su Bernd & Ed Burns"
"Subtle Bustle Sublet[r], by Lu Best"
"A Subtle Late Bus at Blues[r], by Lu Bates" []
"A Subtler Blue Star[r], by [if player is male]Saul Bert[else]Lea Brust[end if]" []
"Such a Guy: Saucy, Ugh[r], by Gus Yauch"
"Such Game Ages Much[r], by Gus Mecha"
"Such Noise, Eh, Cousins[r], by Susie Cohn" []
"Such Other Chore Huts[r], by Chet Roush" []
"The Sucker Creek Huts Stuck Here[r], by [if player is male]Chet Kruse[else]Ruth Eckes[end if]"
"Suderman Maunders, Surnamed[r], by Ned Ramus"
"Sugariest Gust, Arise[r], by Tari Guess"
"A Suit of Fast IOU[r], by Sofia Tu"
"Suitors Sit Sour[r], by [if player is male]Russ Ito[else]Suri Tso[end if]"
"Sulk, Wrath, Straw Hulk[r], by Kurt Walsh" []
"Sultan Hope's South Naples Houseplants[r], by [if player is male]Seth Paulson & Lou Stephans[else]Nessa Plouth[end if]"
"A Sultan's Assault'n[r], by Susan Alt"
"A Sultry Lust-Ray[r], by Ty Rasul"
"Sum-Bla Albums[r], by Su Lamb" []
"Sum This Isthmus[r], by Tim Huss"
"Sumatra Traumas[r], by [if player is male]Art Maus[else]Mara Tsu[end if]"
"Summon Bad, Ombudsman[r], by Bud Sammon"
"Sun, There: the Nurse Seen Hurt[r], by Rees Hunt"
"Sun's Ego? No Guess[r], by [if player is male]Gus Enos[else]Sue Song[end if]"
"[']Sup, Hero? Oh, Rep Us[r], by Rush Poe" []
"Superego Goes Pure[r], by Peg Rouse"
"A Supple Seal Pup Leaps Up[r], by Su Apple"
"Sure Bond So Burned[r], by [if player is male]Bud Rosen[else]Su Borden[end if]"
"Sure Did, Dude-Sir[r], by Ed Druis"
"Sure, Fate Features After Use[r], by Fae Suter"
"Sure, if Furies Fire Us[r], by Eris Fu"
"Sure, Nomads Mess Around[r], by [if player is male]Moses Duran[else]Sondra Muse[end if]"
"Sure, Sin Insures Sunrise[r], by Russ Nei"
"The Sure Three: Us[r], by Stu Ehre"
"Sure-Tied Erudites[r], by Edie Rust"
"Surf-Gone Sun Forge[r], by Rose Fung-Ferguson"
"Surmise, Misuser[r], by Si Remus"
"Surprise Spurs Ire[r], by [if player is male]Russ Pier[else]Su Perris[end if]" []
"A Suspect: Cute Saps['] Past Cues[r], by Stu Capes"
"Swamis Mis-Saw[r], by Wm Issa"
"Swanbane Wannabes[r], by Nana Bews"
"Swank Ol['] Sank Owl Walks On[r], by Al Knows"
"Swat-Hopes Sweatshop[r], by [if player is male]Wes Potash[else]Pet Sowash[end if]"
"Swat Lax Tax Laws[r], by Walt Sax"
"Swear Not, Straw One, to Answer[r], by [if player is male]Art Owens[else]Rona West[end if]" []
"Swear Words Sow Rewards[r], by Wes Darrows"
"Sweat There, Sweetheart[r], by [if player is male]Stewart Hee[else]Sheree Watt[end if]"
"A Swede, Wee, Sad[r], by Wes Ade"
"Sweeping Weepings[r], by Gwen Sipe"
"A Sweet Wet Sea[r], by Ewa Tse"
"Swim Nut Must Win[r], by Wm. Tunis"
"Swim Race Crew Aims[r], by Marc Wise"
"Switcheroo: Two Heroics[r], by [if player is male]Cristo Howe[else]Torie Schow[end if]"
"A Swollen Nose Wall[r], by Leon Laws"
"A Swollen Slow Lane[r], by Noe Walls"
"The Sword She'd Trow[r], by Des Worth"
"A Symmetric Creamy Mist[r], by [if player is male]Timmy Cesar[else]Mamie Cryst[end if]" []
"Synthetic Ethnic Sty[r], by Ty Nitsche" []
"T. Osozaki, a Zitso, OK Kazooist[r], by Tisa Zook"
"Tacit Snipe Antiseptic[r], by Cain Pettis"
"Tacky Bro's Back Story[r], by [if player is male]Rocky Bast[else]Stacy Bork[end if]"
"Tacky Slur: Ask Curtly, Lay Struck[r], by Lucy Trask"
"Tactics of Stoic Fact[r], by Cisco Taft"
"Tacy Was a Castaway[r], by Wyat Casa"
"Tag-Along-a-Lot Gang[r], by Olga Gant"
"Tainted Aid Tent[r], by Ned Tait"
"Tainted, I Attend[r], by Ted Tian" []
"Taipan Pinata[r], by Pia Tan" []
"Take Four: Freak Out![r] by Tor Kaufe"
"Take Home Meek Oath[r], by [if player is male]Moe Keath[else]Temeka Ho[end if]"
"Take No Token: A KO, Neat[r], by Keaton Katone"
"Take, Own, Know, Eat[r], by Owen Tak" []
"Take Rib, Break It[r], by Kit Baer"
"Takey Katey, a Tyke[r], by Katt Yeakey"
"Taking So, Stoking a Goatskin[r], by [if player is male]Otis Kang[else]Kati Song[end if]"
"Talc Oils to Lilacs[r], by Callisto Castillo" []
"Talk Pricy: Trick Play[r], by Kip Cyr-Alt"
"Talkative Ava Kittle[r], by Alva Keitt" []
"Tall Grew a Great Wall[r], by Walt Agler"
"Tall Poem, Lame Plot[r], by [if player is male]Pat Mello[else]Pam Tolle[end if]"
"Tall Silos Also Still: All is Lost[r], by Lisa Stoll"
"A Taller Lateral Rate-All[r], by Tara Ell"
"Taller's Stellar[r], by Lars T. Le"
"Talons, Last On[r], by Alston Lantos" []
"Tammie's Team-Sim Mis-Mate[r], by [if player is male]Tim Ames[else]Mei Mast[end if]"
"Tap Hatred, Da Phatter Deathtrap[r], by Tad Tharpe"
"Tap Into Pain, Tot[r], by [i-n] Pott"
"Taper? Prate, Prate[r], by [if player is male]Peter Prata[else]Tara Tepper[end if]" []
"Tar the He-Tart[r], by Art the Hatter"
"Tardis: It's Rad[r], by Astrid St. Radi" []
"Targeting Agent Grit[r], by Geri Gantt"
"Tarnish, Trashin[']: His Rant[r], by Tristan Harnish"
"Tarnoff's Affronts[r], by Ron Staff"
"Tarot: a Trot[r], by Otto Tartar"
"Tartans['] Tantras[r], by Art Nast"
"Task-Lout, Talk to Us[r], by Saul Kott"
"Tatamis Mills[r], by Mallis Mattis" []
"Taut Lula[r], by Atul Ault"
"Tax Code: Do Exact[r], by Tex Coda"
"Taxi Info Fixation[r], by Nitia Fox"
"Tch, Done Then, Doc?[r] by Notched [d-t] Chen"
"Tea, My Matey[r], by Yetta Mayme" []
"Tea Now to Wean Not Awe[r], by Waneta Wooten" []
"Tea Party, Yet Apart[r], by Patty Rea"
"Tea Til a Title[r], by Etta Li" []
"Tea Time: Meet Tia[r], by Emi Tate"
"Tea Try Treaty[r], by Art Tye"
"Tea With Thwaite[r], by Ewa Hitt"
"Tea Worth Hot Water[r], by Theo Traw"
"Teach, Pastor Catastrophe[r], by Sacha Potter"
"Teachership Heptarchies[r], by [if player is male]Heath Crespi[else]Pat Cheshire[end if]"
"Team Road to a Dream: More Data[r], by Dre Amato"
"Teammates So Odd at Domes[r], by Modesta DeMatos"
"Tear, Rate a Retreat[r], by Tara Tree"
"Tearing Up Rage Input[r], by [if player is male]Pat Guerin[else]Pia Gunter[end if]"
"Tech [']Do: the Doc CODETH[r], by Ted Cho"
"Tech Hub, Eh, Butch?[r], by Beth Chu"
"Tech is ETHICS[r], by Si Echt" []
"Tech Sham: the Chasm[r], by Sam Hecht"
"Technical-Chance Lit[r], by [if player is male]Cecil Nath[else]Cleta Chin[end if]" []
"Techno: the Con[r], by T. Cohen & H. Conte"
"Techs of Chefs: to Fetch So[r], by Stef Cho"
"Ted Hurd, a Turd Head[r], by [if player is male]Thad Duer[else]Ruth Dade[end if]"
"Teen Moms['] Mementos[r], by Tone Emms"
"Teen Sans Neatness[r], by Anne Tess"
"Teen Wolf Won't Feel[r], by Lew Fonte"
"Teeny Town Twenty One[r], by Newt Toney"
"Television: Novelise It[r], by Olive Stein"
"Tell a Spy Let's Play[r], by [if player is male]Sal Pytel[else]Pat Lyles[end if]" []
"Tellurians['] Real Insult: Unreal List. Turn, Allies[r], by Lani Luster"
"Telly, No Tylenol[r], by [if player is male]Ly Elton[else]Nell Toy[end if]"
"Temika's Mistake[r], by [if player is male]Ike Mast[else]Kit Ames[end if]" []
"Temporarily Politer Army[r], by [if player is male]Troy Palmeri[else]Melita Pryor[end if]"
"Ten Bars['] Banters[r], by Stan Erb & Ben Rast" []
"Ten-Fad Aft-Den[r], by Def Nat, Fat Ned & Ted Fan"
"Ten Harpies['] Hen Parties[r], by Pat Heisner"
"Ten Hush the Huns[r], by Thu Shen"
"Ten Kilo Lie Knot[r], by Kit Leon" []
"Ten Lay Neatly[r], by Ely Tan"
"Ten Moms['] Moments[r], by Ms. Monte St. Memon"
"Ten Years Yet Saner[r], by Trey Sean & Nat Reyes"
"Tend Slow Let-Downs[r], by Sol Wendt"
"Terminus: Inert Sum[r], by [if player is male]Tim Nurse[else]Mei Sturn[end if]" []
"Test Archly the Crystal[r], by Tyler Tasch"
"Test it: Bah, That Bites[r], by Tish Batte"
"Testham, That's Me[r], by Matt Esh" []
"A Testy Tea Sty[r], by Sy Tate"
"Tex's Mere Extremes[r], by Rex Smeet"
"Thad, Ben and Beth: the Band, Bad, Then[r], by Ted Bahn"
"Thad's Sad H/T[r], by Dash T. D'Hast"
"Thane Ethan Neath[r], by Netta Hahne"
"Thanks Be the Banks[r], by Kent Bash & Hank Best"
"Thanks to Tank Shot[r], by Hans Kott"
"That Feral Flat Earth[r], by Farah Lett"
"That Good Toad Goth[r], by Dott Hoag" []
"That's Too Hot Toast[r], by Toto Tash"
"Thawed Dew-Hat[r], by Ted Hwa"
"Their Sage Grease-Hit Heritages[r], by Trisha Gee"
"Theism: Me, This[r], by Smithee Smith" []
"Theist Tithes[r], by E. Stith"
"Thelma's Halts Me[r], by Mel Tash" []
"Then Am I the Main[r], by Mei Than" []
"Then Boss the Snobs[r], by Bess Noth"
"Then Gag the Gang[r], by Nat Hegg" []
"Then Gear the Anger[r], by Garth Nee" []
"Then Gob the Bong, Bent Hog[r], by Goth Ben"
"Then Mix the Minx-Hex Mint[r], by Tex Minh"
"Then Park the Prank[r], by Ken Tharp"
"Then Rub the Burn[r], by Brent Hu"
"Then Was the Swan[r], by Wes Nath" []
"A Theory's Hot Years[r], by Troy Shea"
"There Don's Shortened[r], by Seth Nored"
"There I'm the Emir[r], by Tim Rhee" []
"There Was Weathers[r], by [if player is male]Wes Rathe[else]Rhea West[end if]" []
"Thespian Stephani[r], by Shep Tian" []
"They, a Town: Not the Way[r], by Tony Wheat"
"They Bred the Derby[r], by Herb Dyte"
"They Do. Doth Ye?[r] by Ted Hoy"
"They Gas the Gays[r], by Hy Gates"
"They Kiss This: Keys[r], by Ty Sheski" []
"They Mar My Heart[r], by Trey Ham" []
"They Sink in the Sky[r], by Kit Hynes"
"They Use Eye-Shut[r], by Huey Tse"
"Thief, Monk, Think of Me[r], by Thom Finke"
"Thin Air: Hi, I Rant[r], by [i-n] Hirt"
"Thin Rube Bein['] Hurt[r], by [if player is male]Burt Hein[else]Beth Ruin[end if] The Bruin"
"A Thin Shell in the Halls[r], by Ellis Thanh"
"A Think Net in the Tank[r], by Keith Tann"
"This Borg So Bright[r], by Brit Shog"
"This Bum, Bismuth[r], by Tim Bush & Si Thumb"
"This Bum Bit Mush[r], by Tim Bush" []
"This Cool Coil's Hot[r], by Otis Loch"
"This Crew's Wish Crest[r], by Chris West"
"This False Faithless Thief-Lass Fails Seth[r], by Elsa Shift" []
"This Flake Hates Filk[r], by Kathi Self"
"This Gnome Mine Ghost Got His Men[r], by Og Nesmith" []
"This Golem Might Lose[r], by Mose Light"
"This Grove: the Vigors Sigh Overt[r], by Regis Voth" []
"This-Head: His Death[r], by Edith Ash" []
"This Man Thin Sam[r], by Tim Nash" []
"This Manic Machinist[r], by [if player is male]Cain Smith[else]Nita Chism[end if]"
"This Map Past Him[r], by Sim Ptah"
"This Mass Has Mists[r], by Ash Smits"
"This More-Smit Hero[r], by Tom Hires"
"This Pale Late Ship[r], by Phil East"
"This Part: Hip Start[r], by Pat Hirst"
"This Place's Sales Pitch[r], by [if player is male]Phil Scates[else]Lisa Specht[end if]"
"This Rev Thrives[r], by [if player is male]Ev Hirst[else]Vi Stehr[end if]"
"This Rub, Brutish[r], by Brit Hsu" []
"This Suit: Thus, I Sit[r], by Isis Hutt"
"Tho['] Dale Loathed Ol['] Death[r], by [d-t] Hale"
"Tho['] Dan Had Not[r], by Hon. Tad Haddon-Hatton" []
"Tho['] Gank'd, Thank God, Dank Goth[r], by Kath Dong"
"Tho['] if Kin I Think Of[r], by Niki Foth"
"Thorniest Rothstein[r], by Sheri Nott"
"Those Dine on the Side[r], by Ines Thode" []
"Though Ace, a Thug Echo[r], by Hugh Coate the Gaucho"
"Thralls of Shortfall[r], by [if player is male]Rolf Stahl[else]Flo Strahl[end if]"
"A Threat at Heart[r], by Art Athe" []
"Threw a Hit With Heart[r], by Rhea Whitt"
"A Thrifty Try: Faith[r], by Hiatt Fry"
"Throw Me the Worm[r], by Mo Werth"
"Thud, Sir: Rid Thus[r], by Sid Hurt"
"Thug Mo's Ughmost Mugshot[r], by Tom Gush" []
"Thugs['] Hot Thoughts[r], by Gus Thoth"
"Thus a Cool Holocaust[r], by Loo Tausch"
"Thus War Was Hurt, Ruth Saw[r], by A. H. Wurst"
"Thy Dame, My Death[r], by Mat Hyde" []
"Thy Darn Hydrant[r], by Hy Arndt"
"Thy Erased Three Days: Shared, Yet?[r], by [if player is male]Thad Seyer[else]Tresa Hyde[end if]" []
"Thy Gear: Grey Hat[r], by Ty Hager"
"Thy Meal, Mathley-Yeltham[r], by Ty Hamel"
"Thy Soul, Lush Toy, Shy Lout[r], by Lou Thys & Ty Hulso"
"Tibet, Tibet[r], by Betti Ebitt"
"A Tic: I Act[r], by Cici Tata"
"Tidy Room, I'm Too Dry: Yo, Dim Rot[r], by Troy Modi"
"Tidy Three: They Tried[r], by [if player is male]Trey Heidt[else]Hettie Dry[end if]"
"Tie Six, Site IX[r], by Tex-Is-I"
"Ties More Tiresome[r], by Tori Mees"
"Tiger Dad Did Great[r], by Tad Ridge"
"Tigris Rigs It[r], by Si Girt"
"Tiki Now I Know It[r], by [tt] Wink & Kit Wion"
"Til Gus Lugs It[r], by Lu Gist"
"Tillie's Lie List[r], by Lili Tse"
"Tim and Dim Nat[r], by Dimmitt Anand"
"Tim, Top Imp Tot[r], by Mo Pitt"
"Time Paradox: a Dope Matrix[r], by Dax Imperato"
"Time's Arrow, Most Warier[r], by [if player is male]Ramiro West[else]Rosa Witmer[end if]"
"Tin Cans Can't Sin[r], by Nic Nast-St. Nanci"
"Tin Lake Atinkle[r], by Eli Kant"
"Tin Rail Trailin['][r], by Rita Lin"
"Tin Roof for [toti][r], by Rio Font"
"Tin Trevor, Introvert[r], by Rev. Triton"
"Tina Ain't an It[r], by Nina Tait" []
"Tinder: Rend It[r], by Erinn Redditt"
"A Tingly, Tiny Gal[r], by [if player is male]Ty Laing[else]Gita Lyn[end if]"
"Tinkering: Inert King[r], by Kit Negrin"
"A Tiny Boor Too Brainy[r], by Roy Bonita"
"Tiny Dog Got Dyin['][r], by Tod Ying"
"Tiny Gourd: Yon Turgid Drying Out[r], by Tori Dungy"
"Tipsy Man in My Past[r], by Misty Pan"
"Tire-Punk Turnpike[r], by Kip Unter"
"Tired New Ride Went[r], by Ed Winter" []
"Tired Yet, Tidy Tree[r], by Ty Dieter"
"[']Tis Awe I Waste[r], by T. A. Wise"
"Tithe, Tithe, Tithe[r], by Hetti Hiett"
"A Title [']Til Tea[r], by Etta Li"
"To a Dog: Go, Toad[r], by [d-t] Goa"
"To a Full Fallout[r], by Flo Tula"
"To a Git: Go at It![r] by Og Tait"
"To a Lass at a Loss[r], by Sal Sato" []
"To a Tao-Oat[r], by O. O. Tata & A. A. Otto" [x]
"To Acquire Ace or Quit[r], by [ta] Rocque"
"To Admit a Dim Tot[r], by [if player is male]Dom Tait[else]Ida Mott[end if]"
"To Air a Riot[r], by Tori Aratio" []
"To an Interim Termination[r], by [if player is male]Martin Nieto[else]Tori Tiemann[end if]"
"To Annex No Texan[r], by Ax Tonne"
"To Argue Outrage[r], by Geo Ruta" []
"To Ask the Hot Takes[r], by [if player is male]Theo Kast[else]Kesha Ott[end if]"
"To Ban No Bat[r], by [if player is male]Bobo Attann[else]Nona Abbott[end if]"
"To Bathe The Boat, Both Ate[r], by [a-b] Toth"
"To be a PC Beat Cop[r], by Pat Boce"
"To Behold the Blood: Bolted, Oh[r], by Theo Bold"
"To Blabs at Blobs[r], by Bob Salt & Sol Tabb"
"To Blast At Blots, Lost Bat[r], by Al Botts"
"To Bleat: a Bottle[r], by [a-b] Lott"
"To Breach a Botcher[r], by [if player is male]Herb Cato[else]Echo Bart[end if]"
"To Brush Thus, Bro[r], by Bo Hurst"
"To Burst Tut's Orb[r], by Burt Ost"
"To Cal, a Clot[r], by Tat Allocco" []
"To Care at Core[r], by [if player is male]Art Coe[else]Coretta Corea[end if]"
"To Cares, Act Sore[r], by Rosette Carasco"
"To Carry Racy Rot[r], by Art Cory"
"To Charm or Match[r], by Mart Cho & Mac Hort"
"To Chase at Echos[r], by [if player is male]Teo Cash[else]Esta Cho[end if]"
"To Cheat Each Tot[r], by Etta Cho"
"To Chew the Cow[r], by Chet Wo"
"To Claim I'm a Clot[r], by Tom Clia"
"To Cleaner Tolerance: No Treacle[r], by Art Conlee"
"To Crack TrackCo[r], by Cat Rock"
"To Crash or Chats[r], by Ash Cort"
"To Crush Hot Curs[r], by Scot Ruh"
"To Deal Old Tea[r], by Tadeo Tellado"
"To Decay Yet: Coda[r], by Ty Acedo"
"To Dilemma Immolated[r], by Tammi Dole"
"To Dine on Diet: Done It[r], by [d-t] Nei"
"To Drama, Matador[r], by [if player is male]Tad Roma[else]Dora Tam[end if]"
"To Drastic Dictators[r], by [if player is male]Scott Aird[else]Doris Catt[end if]"
"To Drip: Drop It[r], by Dr. Poit"
"To Drive Voter ID[r], by Vito Red"
"To Dust? Tut, Sod[r], by Su Todt"
"To Dying, Tiny God[r], by Ty Godin" []
"To Enamor Tan Romeo[r], by [if player is male]Nat Moore[else]Mae Orton[end if]"
"To Enter RoteNet[r], by Rene Ott"
"To Fails: a List of Ol['] Fiats[r], by Flo Tsai" []
"To Fame of Team[r], by Matteo Maffeo & Fat Moe"
"To Fans of Stan[r], by Stanton Saffo"
"To Farms of Smart Formats[r], by [if player is male]Sam Fort[else]Ma Frost[end if]"
"To Farts at Forts, Far Tots, Fo['] Start[r], by Ros Taft"
"To Fear A Forte or Fate For Tea[r], by Frere Afotota" []
"To Fearing No Frigate[r], by [if player is male]Gino Tafer[else]Inga Forte[end if]"
"To Feels of Steel[r], by Leo Fest"
"To Feels So Fleet[r], by Leo Fest" []
"To Fine One Fit[r], by Toni Fife-Neto"
"To Finish This Info[r], by [toti] Fish" []
"To Flag at Golf[r], by Gala Lott-Goff" []
"To Flank Not Flak[r], by Flo Kant" []
"To Force a Footrace[r], by Cate Roof"
"To Frack Fat Rock[r], by Ka Croft"
"To Frames for Mates[r], by [if player is male]Sam Forte[else]Mae Frost[end if]"
"To Fray Fat Roy[r], by Art Foy"
"To Freeze Zero Feet[r], by Zoe Efret"
"To Get a Toe Tag[r], by Og Tate"
"To Groan or Tango[r], by [if player is male]Art Goon[else]Tora Ong[end if]" []
"To Hack OKChat[r], by Kat Cho"
"To Halt Tha Lot[r], by Hal Ott & Al Toth"
"To Hammer Math More[r], by [if player is male]Tom Maher[else]Emma Roth[end if]"
"To Hamper Metaphor[r], by Mart Hope" []
"To Handle Old Ethan[r], by Dale Thon" []
"To Hans: No Hats[r], by [if player is male]Stan Ho[else]Shonta Haston[end if]"
"To Harm Math or Mr. Oath[r], by Mo Hart"
"To Harvest: That's Over[r], by Seth Tovar"
"To Heal a Hotel[r], by Theola Olathe"
"To Herd the Rod[r], by Ed Roth" []
"To Hex the Ox[r], by Tex Ho"
"To Hustle the Louts[r], by Leo Shutt"
"To Icemen: Notice Me[r], by [tt] McNee"
"To Jabs at Jobs[r], by Jo Bast"
"To Jail, I: a Jolt[r], by Lita-Jo & Tia Jol"
"To Jon, not Jo[r], by Jonjo Otton"
"To Kibosh This Book[r], by Tib Hooks & Tobi Okhs"
"To Kidnap Dat Pinko[r], by [if player is male]Tank Diop[else]Kit Pando[end if]"
"To Land, Old Nat![r] by Tonald Dalton" []
"To Lands and Lots[r], by Old Stan Dalston" []
"To Lash a Sloth[r], by LaTosha Holst" []
"To Leach the Coal: Lo, Cheat[r], by Chet Ola & Ace Holt"
"To Lean on Late[r], by Leanna Tootle" []
"To Leave: Eat, Love[r], by Tova Lee" []
"To Levying Yet-Loving Longevity[r], by [if player is male]Tiny Vogel[else]Elyn Voigt[end if]"
"To Lies I Stole[r], by Eli Tso" []
"To Live? Love It[r], by Olive Levitto"
"To Lives I've Lost[r], by Les Voit" []
"To Madden Mean Todd[r], by Ted Damon"
"To Manage Tea Among a Montage[r], by Gena Mota"
"To Mash a Moth's Most AH[r], by Thomas Thomas"
"To Match Mac Toth[r], by Matt Cho, Mo Tatch & Cat Thom"
"To Mean No Meat[r], by [if player is male]Mateo Montane[else]Naoma Monette[end if]"
"To Mean No Meat[r], by Nat Moe" []
"To Mean No Meta[r], by Neoma Otteman"
"To Meg: Got Me[r], by Toto Eggemm"
"To Melt Tot Mel[r], by Em Lott"
"To Men? Not Me![r], by Monte Moten" []
"To Milk Mt. Kilo[r], by Kim Olt"
"To Moans at Moons[r], by Sam Toon"
"To Mr. Weak Teamwork: Take, Worm[r], by Tom Waker"
"To Mush-Mouths: Um, Tosh[r], by Tom Hsu"
"To Name a Monet[r], by Mateo Montane"
"To Neomi: Emotion Too Mine[r], by Nemo Ito"
"To Nerf No Fret[r], by Fenton Ferrot" []
"To No Email Emotional[r], by [if player is male]Milo Eaton[else]Iola Monet[end if]"
"To Obey Ye Boot[r], by Ty Oboe & Bo Toye"
"To Pains So Inapt[r], by [if player is male]Otis Pan[else]Nia Post[end if]" []
"To Paint, Tap Into Pain, Tot[r], by Tia Pont"
"To Pals Postal[r], by Sal 'Pops' Latto" []
"To Park at Pork[r], by Art Pok" []
"To Parry or Party[r], by [if player is male]Troy Arp[else]Tyra Orp[end if]" []
"To Parse or Paste a Poster[r], by Seaport [if player is male]Pat Rose[else]Tresa Po[end if]"
"To Pass by Bay Spots[r], by Pat Bossy"
"To Paste Teapots[r], by Pat Seto"
"To Paths Past Hot[r], by Pat Tosh" []
"To Pay for Yo['] Fop Art: Oft Par, Oy[r], by Fay Troop"
"To Pickles, Ol['] Skeptic: Slick Poet Stockpile[r], by Kelci Post"
"To Plan an['] Plot[r], by Al Pont & Patton Pollan" []
"To Press Posters or Pests[r], by Tess Pro"
"To Prise Pietro's Ropiest Riposte So Tripe[r], by Tip Rose" []
"To Proms, Mrs. Toop[r], by Mo Strop"
"To Raffle Fleafort[r], by Leta Roff"
"To Rage at Gore[r], by Georgetta Rao"
"To Rages So Great[r], by Reg Sato" []
"To Rally a Trolly[r], by Ray Toll"
"To Rave Over at a Voter[r], by Eva Ort"
"To Reach or Cheat[r], by Art Cheo"
"To Read a Trode[r], by Deedra Totaro" []
"To Read or Date[r], by Taddeo Traore" []
"To Reap a Trope[r], by Art Poe"
"To Reefs of Trees, or Fetes, Foester[r], by Foreste Seefort"
"To Relish Her Toils So Lither[r], by Leo Hirst" []
"To Repent Potenter? Not Peter[r], by Trent Poe"
"To Resign or Get Sin[r], by [if player is male]Ron Geist[else]Teri Song[end if]"
"To Rest a Toaster[r], by Art Seto" []
"To Reveal Ever a Lot[r], by Vera Leto"
"To Revels, Ever-Lost Lovester Rosevelt[r], by Steve Lor"
"To Ride or Diet[r], by Ed Troi" []
"To Rip a Riot, Pa[r], by Portia Priato"
"To Rip or Tip[r], by Pio Porritt"
"To Risks or Skits[r], by Kit Ross" []
"To Ron, or Not: No Rot[r], by Norton Root" []
"To Rouse Our Toes[r], by Sue Root"
"To Roust Our Tots[r], by Tut Roos"
"To Rudy: Dry Out, Turd, Yo![r], by Dour Ty"
"To Sail is a Lot[r], by Al Tsoi" []
"To Sales So Stale[r], by Les Tsao"
"To Sand Not Sad[r], by Don-Tad Santos"
"To Satan: a No, STAT[r], by Nat Sato"
"To Saul: Soul at a Lotus[r], by Lu Sato"
"To Save a Stove[r], by Eva Tso"
"To Say No to Sonya: Anys, Too[r], by [if player is male]Stan Yoo[else]Tonya So[end if]" []
"To Scale a Closet[r], by Les Cato" []
"To Scar or Scat[r], by Cora St. Castro"
"To Scorn Not Orcs[r], by Ron Scot"
"To Scorn Not Orcs[r], by Ros Cont"
"To Scrap at Crops[r], by Pat Cros"
"To Scrap at Crops[r], by Scot Arp" []
"To Scream at Comers[r], by Tom Cesar" []
"To Screen No Secret So Recent[r], by [if player is male]Ernst Coe[else]Rene Cost[end if]"
"To Search: At Chores[r], by [if player is male]Thor Case[else]Rosa Echt[end if]"
"To Secure Rote Cues[r], by Sue Ector"
"To Shame Some Hat[r], by Tom Ashe"
"To Share Hates or a Hoster[r], by Art Shoe" []
"To Share Her Oats[r], by Art Shoe" []
"To Sheep or Hero Poets[r], by Seth Poore" []
"To Sir: Riots Roist[r], by Siri Troost" []
"To Slave at Loves[r], by [if player is male]Tal Vose[else]Lost Eva[end if]"
"To Slime I Molest[r], by Eli Most"
"To Slur or Lust? Rust, Lo[r], by Lu Rost"
"To Smack at Mocks[r], by Tom Sack"
"To Smash Hot Mass[r], by Sam Tosh"
"To Smear Meats or Some Art: Roast [']Em, Mr. Oates[r], by Mart Seo" []
"To Smile Til Some Lie Most[r], by Mel Otis" []
"To Snap on Past[r], by Patton Spanos" []
"To Snare No Tears[r], by Nat Rose" []
"To Snark Rants, OK[r], by Ron Kast"
"To Sneak One Task[r], by Ken Sato" []
"To Sniff Off Nits[r], by Toffins Tiffson" []
"To Sob, Sot Bo Boots[r], by Bobo Stoots"
"To Some Me-Toos[r], by Moe Tso"
"To Spin No Tips[r], by Postin['] Piston Si Pont" []
"To Spoil Its Pool[r], by Otis Olp"
"To Spray Party So[r], by Roy Past"
"To Stake OK Taste[r], by Etta Kos"
"To Stall All Tots[r], by Sal Lott"
"To Stand Tots and Nod, Stat[r], by [d-t] Nast"
"To Start at Trots[r], by Ra Stott"
"To Steal Lost Tea[r], by Sol Tate" []
"To Stink As Tato Skins[r], by [if player is male]Kit Santos[else]Isa Knotts[end if]"
"To Stories: Tortoises Resist Too[r], by [if player is male]Toto Reiss[else]Rossie Ott[end if]"
"To Such a Scout: Ah, Cash Out![r] by Scot Hua"
"To Surf for Stu[r], by Russ-Otto Ruff"
"To Surlier Or Lustier[r], by Tori Luers"
"To Survey Your Vest[r], by Rus Tovey"
"To Swing on Twigs[r], by [if player is male]Tig Snow[else]Gwin Tso[end if]" []
"To Swipe Two Pies[r], by Otis Pew"
"To Syphon Typhoons So, Python[r], by Hy Poston"
"To Tackle Cott Lake[r], by Katt Cole & Kate Colt"
"To Thresh the Short[r], by Seth Roth"
"To Train or Taint[r], by Ron Tait" []
"To Trap Top Art[r], by Pat Ort"
"To Tries So Trite[r], by Teri Tso"
"To Trim Mr. Tito[r], by Mo Ritt"
"To Twin: It Won't Win, Tot[r], by No-Twit Witton"
"To Types So Petty[r], by Ty Pesto"
"To Unravel a Novel Rut[r], by Raul Vento"
"To Urbs Robust[r], by Brutus Botros"	100
"To Weary Year Two[r], by Ewa Troy"
"To Weigh With Ego[r], by Og White"
"To Whine One Whit on White[r], by [tt] Wehn"
"To Wring it Wrong[r], by Rog Wint"
"To Write Rote Wit: Ow, Trite[r], by [if player is male]Trot Wei[else]Teri Two[end if]"
"To Yank on Katy[r], by Tony Ka"
"To Ye Music: Use Comity, City Mouse[r], by Coy Mitsue"
"To Zap a Potz[r], by Topaz Pat Oz"
"Toast [']Em to Steam[r], by Tom East"
"Toast to Tattoos[r], by Toto Ast"
"Tobago, Bogota[r], by Ag Boot"
"A Toddler's Old Trades[r], by Del Rostad"
"Toenail Elation[r], by [if player is male]Leo Tian[else]Ali Eton[end if]"
"A Toil to Ail[r], by Tolia Alito"
"Token Sign, Stone King[r], by Kent Goins"
"Token-Yes Keynotes[r], by Tyson Kee" []
"Tolbert's Blotters[r], by Sol Brett"
"Told [']Em to Meld: Dolt, Me[r], by Ed Motl"
"Told Now, Old Town[r], by Don Wolt"
"A Toll to All[r], by Lola Allott"
"Tom Cly: My Colt[r], by Ty Colm"
"Tom's Puns Most Spun[r], by Puntmoss Stumpson"
"Tomatos to Atoms[r], by Matt Soo" []
"Tons-Durable Roundtables[r], by [if player is male]Alberto Sund[else]Delta Osburn[end if]"
"Tony's Son Ty[r], by Totsy Nyson"
"Too Corny or Not Coy[r], by Troy Coon"
"Too Far for Tao[r], by Art Foo" []
"Too Fried to Die For[r], by [d-t] Fiore"
"Too Hard to Hoard[r], by Art Hood" []
"Too Many May Not, O[r], by Mat Yoon-Montoya"
"Too Sly? Yo, Lost[r], by Ty Loos"
"Too-Smart Stat Room[r], by Matt Roos"
"Too Young, You Go Not[r], by Tony Ogou"
"Toot Loads, Toadstool[r], by Aldo Sotto"
"Top-Class Caps Lost to Scalps[r], by Pat Closs"
"Top Denial Planetoid[r], by Del Patino"
"Top Hex: the Pox[r], by Tex Pho"
"Top Itch, Po['] Titch[r], by Chip Ott"
"Top Poetry Prototype[r], by Toto Pyper"
"A Top Scum Camps Out[r], by Pat Musco"
"Top Secret Pet Sector[r], by Scott Peer"
"Top-Shore Hoopster Hopes Rot[r], by [if player is male]Seth Roop[else]Sher Toop[end if]"
"Top Slang Long Past[r], by Stan Glop"
"Topically? Lo, Typical[r], by [if player is male]Ty Cipolla[else]Lacy Pilot[end if]"
"A Torch to Char[r], by Art Cho"
"Torchin['] Corinth[r], by Nic Roth-Richton"
"Torn Hut, Not Hurt[r], by Tut Horn"
"Torn Map? Tramp On[r], by Pam Nort"
"A Torn Tartar Noon: No Art[r], by [if player is male]Ron Taranto[else]Tara Norton[end if]" []
"Torn Wing: Grin Nowt[r], by Wirt Nong"
"Tornado Donator[r], by Dan Root"
"Torrent is Rotten, Sir[r], by [if player is male]Ron Strite[else]Ros Ittner[end if]"
"Tory Chen, the Corny[r], by Trey Cohn" []
"Toshiko Hooks It[r], by [if player is male]Kit Soho[else]Tish Koo[end if]" []
"Tot, Bug a Tugboat[r], by Gab Tout"
"Tot Gabe Got Beat[r], by Bo Tatge"
"Tot, Sneer to Resent[r], by Oren Sett"
"Total Held Death Toll[r], by Odell Hatt" []
"Totally Tall Toy[r], by Lyla Ott"
"Tote Bag Got Beat[r], by Gabe Ott" []
"Tots Held the Dolts[r], by Ted Holst"
"Tots['] Brief Frostbite[r], by Boris Fett"
"Tough Ones Not So Huge Gone South[r], by Hugo Osten"
"Tough Shire, Our Heights: The Roguish Eight Hours[r], by [if player is male]Sergio Huth[else]Tori Hughes[end if]"
"Tough to Laugh, Al[r], by Hugo Alt" []
"Tough Wins, South Wing Wino Thugs[r], by Stu Wingoh"
"Toughest: Ghetto, Us[r], by Theo Gust & Hugo Test"
"Towable Teabowl[r], by Bo Ewalt"
"Toy Cars at Cory's[r], by [if player is male]Ty Oscar[else]Cary Tso[end if]"
"Toy Guns: Gutsy? No[r], by Gus Tony"
"Toyless Ty Loses[r], by [if player is male]Les Yost[else]Tess Loy[end if]"
"Trade Me Red Meat[r], by Tam Reed"
"Trail of Oft-Liar: Rot, Fail[r], by [if player is male]Art Foil[else]Tia Rolf[end if]"
"Train in Art[r], by Rini Rattan" []
"Traitors['] Rat-Riots[r], by [tt] Starr"
"Traits I Start[r], by Artist Trista"
"Tramp On, Torn Pam[r], by Po['] Mart'n Portman" []
"Transaction: a Constraint[r], by [if player is male]Tristan Cano[else]Ria Constant[end if]"
"Transcending Nascent Grind[r], by Cats Drenning"
"TransitCo Con Artist Nat Cristo[r], by Tori Scant"
"Transmit, St. Martin[r], by Tim Starn"
"Transpire, a Sprinter, Earn Trips[r], by [if player is male]Stan Perri[else]Pat Risner[end if]" []
"Trap Hotel: the Portal, Earth Plot[r], by [if player is male]Hal Potter[else]Opal Rhett[end if]"
"Treacliness Centralises[r], by [if player is male]Case Nistler[else]Selena Crist[end if]"
"Tread, Dead Ratter[r], by Detra Detar" []
"Tread Now at Wonder to Wander[r], by [if player is male]Ted Rowan[else]Dawn Rote[end if]"
"Treasury: Say Truer, Arty User[r], by Rusty Rea"
"Treatment Matter Ten[r], by Natt Emert"
"Treble Belter[r], by Elbert LeBret"
"Tree Now Woe-Rent[r], by Noe Wert"
"Trek Be Won, Went Broke[r], by Kent Bower"
"A Trek, Men: Make Rent[r], by Kent Mera"
"A Trellis is Taller[r], by Lila Rest"
"Tremont's Torments[r], by Tom Stern"
"A Trench Chanter[r], by [if player is male]Art Chen[else]Cher Tan[end if]"
"Trench-Wise Winchester[r], by [if player is male]Erwin Tesch[else]Cristen Hew[end if]" []
"Trey Had the Yard[r], by Thad Rey"
"A Trial or Toil: Oratorial Lit[r], by Lorita Tailor"
"Trials, Trails[r], by Larissa Trilt"
"A Tribe: Bear It[r], by Bettie Ibarra" []
"Tribesmen's Tenebrisms[r], by [if player is male]Brent Simes[else]Bess Minter[end if]"
"Tribunals Rub Salt In[r], by [if player is male]Luis Brant[else]Lita Burns[end if]"
"Tried God, Got Re-Did[r], by Todd Iger, Ted Gordi & Goodridge Redditt"
"Tried to Do Trite[r], by Detroit Di Otter"
"A Trim Mr. Tai[r], by Marti Mitra" []
"Trip Tons to Sprint[r], by Ron Pitts"
"Trips to Stir Pot[r], by Ros Pitt"
"Trod Hikes Other Kids Risked, Tho['][r], by [if player is male]Theo Dirks[else]Kit Rhodes[end if]"
"Trojan Rat Jon[r], by Jan Ort"
"A Troll, All Rot[r], by Art Oll"
"Trollin['] Til Lorn[r], by Ron Till"
"Trophies to Reship[r], by Trish Poe" []
"Troubled Old Brute, Loud Bert, But Older[r], by Bud Toler" []
"Truancy as Sanctuary[r], by [if player is male]Tyrus Caan[else]Stacy Ruan[end if]"
"Truce Re-Cut[r], by Cuc Reutter"
"True Story, Yore Trust: Oyster Rut[r], by Roy Sutter"
"Truest Utters[r], by Stuert Sutter"
"Trusty Try, Stu[r], by Ty Rust"
"Try a Leg Greatly[r], by Ty Alger"
"Try a Vice: Evita, Cry,[r] by Ray Civet"
"Try Again, Giant Ray[r], by Tina Gary"
"Try Any Rant: Tar Tyranny[r], by Taryn Ryant"
"A Try As Astray[r], by Ty Saar"
"Try Bein['] Tiny Reb Britney[r], by Brent Yi"
"Try Caring, Crying Rat[r], by Caryn Trig & Tracy Ring"
"Try Nodes So Trendy[r], by [if player is male]Ned Story[else]Rosy Dent[end if]"
"Try On, Ron, Ty[r], by Toryn Yornt"
"Try? Oy, Rot[r], by Tyro Tory Troy"
"Try Smut, My Trust[r], by Ty Sturm"
"Tube So Obtuse[r], by Su Tebo" []
"Tubes, Cans, Substance[r], by Bess Cantu" []
"Tuesday Sea Duty: Aye, Dust[r], by Stu Eady" []
"Tuliver Rivulet[r], by [if player is male]Lui Vert[else]Vi Rutle[end if]"
"Tumble Down, Dumb New Lot[r], by Bowle Mundt"
"Tumbled Mud-Belt[r], by Ted Blum"
"Tundras and Ruts Turn Sad[r], by [if player is male]Dan Rust[else]Su Arndt[end if]"
"Tune Out One Tutu[r], by Tut Ueno"
"Tupelo: a Leap Out[r], by [if player is male]Lou Pate[else][end if]"
"Turbinal Tribunal[r], by Brant Lui" []
"Turbo-Snobs So Stubborn[r], by Boss Burton"
"Turgid Tea, Gut Tirade, Gratitude[r], by Ida Gutter"
"Turing's Grunt is Rusting[r], by Stu Ring"
"Turn, Heal, Lutheran[r], by [if player is male]Neal Hurt[else]Ruth Lane[end if]"
"The Turn Hurt Ten[r], by Tre Hunt"
"Turn There: the Return[r], by Trent Ruhe"
"A Turtle's Late Rust[r], by [if player is male]Al Sutter[else]Lu Streat[end if]"
"Tut, Air My Maturity?[r], by Yuri Matt"
"Tut, Snob: Bust Not, Buttons[r], by Bo Stunt"
"Tut's Den: Dust Net[r], by Stu Dent" []
"Tutors Buy Your Butts[r], by Ruby Stout"
"Twas When Shaw Went What's New[r], by Stew Hawn" []
"Tweedy Yet Wed[r], by Ty Weed"
"Tweet as We Taste[r], by Wes Tate"
"Twilight's Light-Wits[r], by Gil Wishtt"
"Twilights With St. Gil[r], by Stig Wilth" []
"Twin Lakes: Like, Wants[r], by [if player is male]Nat Wilkes[else]Lin Swatek[end if]" []
"Twin Lakes: Wink's Tale[r], by [if player is male]Lew Atkins[else]Tena Wilks[end if]" []
"Twins Have White Vans[r], by Shawn Veit"
"A Twist: [']Twas It[r], by Si Watt" []
"Two Doors: Words, Too[r], by Tor Woods"
"Two Fears of Waters[r], by Ewa Frost" []
"Two Hands Won't Dash[r], by [d-t] Shawn"
"Two Males['] Last Meow[r], by Les Mowat"
"Two Mayors['] Motorways[r], by Amos Towry"
"Two Million Will Motion: No Low Limit[r], by Milo Wilton"
"Two Years['] Artsy Woe: Yea, Worst[r], by Ray Toews"
"Ty, Adam, My Data[r], by Tad May"
"T/Y Tons, Snotty St. Tony[r], by Sy Tont" []
"Ty's Claim: Mystical Slimy Cat[r], by Stacy Lim"
"Type More Poetry, Me[r], by Peter Moy" []
"Type Words, Rowdy Pest[r], by Spot Dwyer" []
"A Typhoon: Any Photo[r], by Tonya Hop"
"Typical Alp City[r], by Ty Calip"
"Ubaldo's Busload[r], by [if player is male]Sol Daub[else]Su Baldo[end if]"
"Uber-Rich Rubric, Eh[r], by Herb Cuir"
"UCLA, ACLU[r], by Luca Caul"
"Udder Users[r], by Dr. Sue Redus"
"UFO Nuts: Fun to Us[r], by Su Fount"
"Ug, Leap, Plague[r], by Lu Page"
"Ug, Near An Urge[r], by Reagun Augner"
"Ug, Ye Ol['] Eulogy[r], by Gy Loue"
"Ugh, Left the Gulf[r], by Tug Fehl"
"Ugh, Reckon, Gunk-Chore Roughneck[r], by Enoch Krug"
"Uglier, Gluier[r], by Geri Lu"
"Uglies['] Guiles[r], by Eli Gus"
"Ugly Hack, Cagy Hulk[r], by Guy Chalk"
"Ugly Manor, Normal Guy[r], by Maury Long" []
"Ugly Old Doll Guy[r], by Goldy Lu"
"Uh, Gents, the Guns Stung, Eh?[r] by Gus Neth"
"Uh, Goodby, Doughboy[r], by Hugo Boyd"
"Uh, Greet the Urge[r], by [if player is male]Treehug Guthree[else]Ruth Gee[end if]"
"Uh, Mo['] Drab Bad Humor[r], by Bo Durham"
"Uh, Parable[r], by Paul Baehr, Alpha Rube"
"Uh, Slate a Hustle[r], by Stu Hale"
"Ulcers, Eh, Hercules? He's Cruel[r], by Lee Schur" []
"Um, Rot: Out, Mr. Tumor![r] by Mort Umurto"
"Um, Star, a Strum[r], by Rustam Martus"
"Um, Try to, My Tutor[r], by Roy Mutt"
"Un-Blame Albumen, Blue Man[r], by Ben Maul"
"Un-Fad: Fund a Fun Ad[r], by Dan Fu"
"Un-Last Sultan[r], by Stan Lu" []
"Un-Phallic Lunchpail[r], by Paul Linch"
"Un-Reap a Prune[r], by Ren Pau"
"Un-Sadden, Sand Dune[r], by [if player is male]Dan Sunde[else]Sade Dunn[end if]"
"Un-Shriek, Shuriken[r], by Hsiu Kern"
"Un-Tired Dire Nut[r], by Derin Tu" []
"Un-Tragic Curating[r], by Ric Gaunt" []
"Unable Nebula[r], by Ben Lau"	60
"Unbias Abusin['], Anubis[r], by Su Bain"
"Unbid, He's Behind Us[r], by [if player is male]Bud Hines[else]Enid Bush[end if]"
"Unbreathable Burnable Hate[r], by [if player is male]Beale Rathbun[else]Anabel Hubert[end if]"
"Unchained, Chide a Nun[r], by [if player is male]Duane Chin[else]Nina Hudec[end if]"
"Uncle Sam: Lean Scum[r], by Len Camus"
"Uncover No Curve[r], by Coren Vu"
"Underrated, Unretarded[r], by [if player is male]Reed Durant[else]Edda Turner[end if]"
"Undre My, Um, Nerdy Dry Menu[r], by Rudy Men"
"Undress-Sunders[r], by Ned Russ"
"Uneasy Sun, Aye[r], by Sean Yu"
"Unfair Ruin, Fa![r] by Rufina Funari"
"Unfavorable Flu Ran Above[r], by Bruno LaFave & Evan Balfour"
"Unfettered Deft Tenure Turned Fete[r], by Deren Tufte"
"United in Duet[r], by Ed Tuin & Edi Tun"
"Universal Evil Ran Us[r], by Vera Linus" []
"Univores['] Souvenir[r], by [if player is male]Evon Suri[else]Venus Rio[end if]" []
"Unlent Tunnel[r], by Lenn Tu"
"Unliked Kin Duel[r], by Eli Knud"
"Unlikely Yule Link[r], by Kelli Yun"
"Unlist Sunlit Untils[r], by Stu Lin" []
"Unmasking Unmakings[r], by [if player is male]Angus Mink[else]Su Kingman[end if]"
"Unmerited Time Under[r], by [if player is male]Tim Rudeen[else]Trudie Men[end if]"
"Unoriginal? Lo, Gain Ruin[r], by Luigi Ronan"
"Unprepared Rude Napper[r], by Randee Rupp" []
"Unreadable? Blaa, Endure[r], by Renae Abdul"
"The Unripe Up in There[r], by Ruthie Pen"
"Unsanitary Aunty Rains[r], by Tisa Runyan"
"Unskilled Slunk Idle[r], by [if player is male]Del Luskin[else]Kelsi Lund[end if]"
"Unslumped Pendulums[r], by Lupe Munds"
"Unsoiled Delusion[r], by Leo I. Sund"
"Unsung Saga[r], by Angus Sagun" []
"Untamed Mad Tune, Daunt Me[r], by Mute Dan"
"Unthrilled, Thin, Duller, I'll Thunder[r], by Hunter Dill"
"Unto a BFF: Not a Buff Bouffant[r], by Nat Buffo"
"Unto Far Fortuna[r], by Taron Fu" []
"Unto Folds Lost, Found[r], by Don Loftus"
"Unto Silage Gelatinous: Sealing Out[r], by [if player is male]Leo Agustin[else]Louise Gant[end if]"
"Untoiling Outlining[r], by Lin Guiton"
"Unworkable Labour Knew One Bulwark[r], by [if player is male]Ruben Wolak[else]Luna Bowker[end if]"
"Up at a Put[r], by Tuta Paup"
"Up, Doors: Our Pods So Proud[r], by Su Droop"
"Up, Elder Prelude[r], by Del Peru"
"Up, Hotel, Help Out[r], by Lou Peth" []
"Up Into a Utopian Pain-Out[r], by Pati Uno"
"Up, Libel as Plausible[r], by Lupe Basil"
"Up Mist I Stump[r], by Stu Pim"
"Up, Pa, a Pup[r], by Papu Paup"
"Up, Sages! Pegasus Pages Us[r], by Gus Pesa"
"Up, Sorest True Sops['] Postures[r], by Poet Russ"
"Upham's Mashup[r], by Pam Hsu"
"Uplands and Plus[r], by Pal Sund"
"Uppity Oral Popularity[r], by Tippy Lauro"
"Ur-Yawn Runway[r], by Ryan Wu" []
"The Urban Hate-Burn: Bane, Hurt[r], by [if player is male]Herb Tuan[else]Reba Hunt[end if]"
"Urge It, Wry Writer Guy[r], by Gerrity Wu"
"Urgent Mist Mutterings[r], by Ming Sutter" []
"Urging as Arguings[r], by Gus Garin"
"Urn, Idols, Old Ruins[r], by Lori Sund"
"Ursinus Ruins Us[r], by SuSu Nir & Susi Nur"
"Us Again, Iguanas[r], by [if player is male]Gus Aina[else]Isa Aung[end if]"
"Us Dames Assumed a Mussed Medusa's Sued Sam[r], by Ed Asmus"
"US Eagle Leagues[r], by Gus Elea & Saul Gee"
"Us: Funny Funyuns[r], by Sunny Fu"
"Us Godly Old Guys[r], by Sy Gould"
"Us Got Ye Gout, Yes?[r] by Guy Esto"
"Us, Half a Flush[r], by Alf Hsu"
"Us, Late, St. Eula?[r] by Stu Lea" []
"Us, Local, Callous[r], by Lucas Lo"
"Us, New Jig: June Swig Wine Jugs[r], by Jung Weis"
"Us, Storied Outsiders[r], by Susie Dort & Stu DeRosi"
"Us, Them, Thus Me: the Sum[r], by Mushett Humes"
"USA-Made: Amadeus[r], by Sue Adam"
"Uselyss Ulysses[r], by Ly Seuss"
"Usher Not, Hurt Ones[r], by Rose Hunt" []
"Ushers['] Rushes[r], by Su Sher"
"Utterances Sent Acuter[r], by [if player is male]Curt Santee[else]Reena Cutts[end if]" []
"Vacation Use: Evacuations[r], by [if player is male]Isaac Venuto[else]Onita Cuevas[end if]"
"The Vagrant That Graven[r], by Garth Avent"
"Vague PI: I Gave Up[r], by Eva Puig"
"A Vaguer Veg Aura[r], by Ava Ruge-Guevara"
"Vain Dance Can Invade[r], by [if player is male]Vince Dana[else]Diann Cave[end if]"
"Vain Odds and Voids[r], by Sadid Von Davidson"
"Valencia's Valiances[r], by [if player is male]Alvin Case[else]Eva Caslin[end if]"
"Valid ID, Alv[r], by Vladi Vidal"
"Valid Rune Unrivaled[r], by [if player is male]Levi Duran[else]Erin Duval[end if]"
"Valter's LaserTV Travels[r], by Al Verst" []
"Van Alstine's Valiantness[r], by Ivan Stansel"
"Variety: I've a Try[r], by Ty Viera"
"Varityped Depravity[r], by [if player is male]Davy Petri[else]Vita Pryde[end if]"
"Vast Oil So Vital[r], by Sal Vito"
"Veal Vale, Valve Ale[r], by Eva Valle"
"A Vector to Carve Cave-Rot[r], by [if player is male]Trav Coe[else]Eva Cort[end if]"
"Velour Louvre[r], by Lu Rove"
"Venial to Not Alive[r], by [if player is male]Vito Lane[else]Iva Elton[end if]"
"Verbally by All, Rev[r], by Beryl Val" []
"The Verge: I Give, There[r], by Evie Gerth"
"Verily Yr. Vile[r], by Irv Ely"
"Vernacular Arc, Unravel[r], by Luna Carver"
"Vernie Dent Intervened, Reinvented[r], by Deren Venti"
"Veronica's Vice: ARSON[r], by Oscar Vine"
"Versatile Relatives[r], by Avi Lester" []
"Version So Riven[r], by Vin Rose"
"Very Like Ye Ilk, Rev[r], by Keri Levy" []
"Very Nice: Even I Cry[r], by Vince Rey"
"Very OK Li'l Yorkville[r], by Kelly Ivor"
"Very Old Dry Love[r], by Rod Levy"
"Very Safe Fay Verse[r], by Eve Fryas"
"Very Select Secret Levy[r], by [if player is male]Everest Cly[else]Eve Crystle[end if]"
"Vestal Valets[r], by Lev Ast"
"Vexation to a Vixen[r], by [if player is male]Nate Viox[else]Vita Exon[end if]"
"A Victim's Activism[r], by [if player is male]Tim Savic[else]Vi Stimac[end if]"
"Vidal? Advil![r] by Lida V. & Vida L" []
"Video Games, Movies, Egad[r], by Omega Vides"
"Vie-Ville[r], by Evil Levi" []
"Vigor Sprees: Prigs Ever So Progressive[r], by Virgo Speers"
"Vile [crap-u], Viper Cal![r] by Percival Cravelip" [x]
"Vile Con Clive, No[r], by Nic Love & Vin Cole"
"Viler Bums['] Bulverism[r], by Ervis Blum"
"Viler-Fork River Folk[r], by Rif Volker"
"Vin Has His Van[r], by Vi Nash"
"Vine Vein[r], by Ivie Venn"
"Vines-Gate: It Avenges Negatives[r], by Evan Geist"
"A Violent Naive Lot[r], by Toni Vale" []
"Virgos['] Vigors[r], by Viv Roos-Riggs"
"Virtual Art I Luv[r], by Val Turi" []
"Virtue Leaps, Superlative[r], by [if player is male]Paul Sievert[else]Lupita Evers[end if]" []
"Vita's Vista[r], by Avis Savitt" []
"Vito, Cry Victory[r], by Ivy Cort"
"Viva Addi[r], by Iva David"
"A Vixen, Ex-Vain[r], by Eva Nix"
"Vlog in Nil-Gov[r], by Gil Von Ingvol" []
"The Voices Echoise TV[r], by Steve Choi"
"Voila, Ol['] Iva[r], by Oliva Lavio" []
"Voltaire's a Live Sort[r], by [if player is male]Leo Travis[else]Valeri Tso[end if]"
"Voracity: A Victory[r], by Cat Ivory"
"Vote Loser Roosevelt[r], by Loo Everts"
"Voter ID Drove It[r], by Vito Erd"
"Voters['] Corny Controversy[r], by Ros Coventry"
"Vs. Mean Mavens[r], by Nev Sam"
"Vulnerable Lunar Bevel[r], by LaVern Blue" []
"Wage-Mopers['] Power Games[r], by Marge Swope" []
"The Wagon Gone: WHAT[r], by [if player is male]Theo Wang[else]Thea Wong[end if]"
"Waldner's Nerd Laws[r], by Ned Rawls & Len Sward"
"Waldo's Old Saw[r], by Sal Dow" []
"Walk Not, Talk Now[r], by Tank Low"
"A Walk on Oak Lawn[r], by Lon Kawa"
"Walk Over Workvale[r], by Kev Orlaw"
"Wallabies['] Able Wails[r], by Blaise Law"
"Walled Lad Lew[r], by Del Law"
"The Walls Shall Wet[r], by Stew Hall"
"Wan, Led, We Land[r], by Ned Law"
"Wan Times, Same Twin[r], by Stew Main"
"Wanders to a Worst Den[r], by Don Waters" []
"Want to Do Toad Town[r], by [if player is male]Natt Wood[else]Dawn Otto[end if]"
"War Bodes Bad, Worse[r], by [if player is male]Drew Sabo[else]Bea Sword[end if]"
"War Cash Car Wash[r], by Ash Craw" []
"War Nine: a Winner, New, I Ran[r], by Nan Weir"
"War-Owned, Onward, We Wear Down [r], by Owen Ward"
"The War Wreath Thawer[r], by Art Hew" []
"War Yet? Try Awe, Ye Wart[r], by Ty Ware"
"War's Echo: Who Cares?[r], by Chas Rowe"
"The Ward: Wet, Hard[r], by Tad Rhew"
"Wardle's War Sled[r], by Sal Drew"
"Wariest, Swear It[r], by Ira West" []
"Wariest Waiters[r], by Ari West" []
"Warlocks['] Laws Rock[r], by Cal Skrow"
"Warm Boy Mowbray[r], by Mary Bow"
"Warp Drive Viper, Draw[r], by Pew Rivard"
"A Warp Over Vaporware[r], by Eva Parrow"
"Warren: New Add[r], by Andrew Darwen"
"Warthogs, Grow Hats[r], by Garth Sow"
"Wary Ole Royal We: Yow, Real[r], by Ray Lowe"
"Was I Not in as Two[r], by Tia Snow"
"Washed Up Dupes, Haw[r], by Ed Upshaw"
"Waste There, Sweetheart[r], by Stewart Hee" []
"Wasted Health: What's the Deal?[r] by Halsted Wheat"
"A Waster, Awarest[r], by Wes Tara"
"Waster of Wafers: to Swear, Oft[r], by Ewa Frost"
"Wastrel Walters[r], by Lew Star" []
"Water, I Write: a Waiter[r], by Art Wei" []
"Waterfall Flaw Alert[r], by Walt Faler"
"Watershed Draws Thee[r], by [if player is male]Wes DeHart[else]Hesta Drew[end if]"
"Watkins Winks at Kit Swan[r], by K. T. Swain"
"The Way Up: We Put Hay[r], by Apu Wyeth"
"The Way: Why Eat?[r] by Ty Ahew" []
"Wayfarer, Home, Away From Here[r], by Mayhew Ferrao"
"Wayne's New Say[r], by Wes Yan"
"The Ways They Was[r], by Ty Hawes & Stew Hay"
"We Admit Wit, Dame[r], by Tim Wade"
"We Avoid Avid Woe[r], by Evia Dow"
"We Avoid Diva Woe[r], by Evia Dow"
"We Bores Be Worse[r], by Bo Ewers"
"We Both Bow: the Hot Web[r], by Thoth Bewebow"
"We Bother the Bower[r], by Bee Worth"
"We Bruised Budweiser[r], by Sudie Werb"
"We Can Go Once, Wag[r], by Ace Wong"
"We Don't Wend to Den Two[r], by Wende Ott-Down"
"We Don't Wend to Town, Ed[r], by Dot Wen" []
"We Drank New Dark[r], by Ken Ward"
"We Drop Powder[r], by Rod Pew"
"We Hail a While[r], by Hal Wei" []
"We Heal a Wheel[r], by Lee Hwa"
"We Hit White[r], by Whitt Weihe"
"We Rack a Wreck[r], by KC Ware-Wacker" []
"We Ran to No Water[r], by Nat Rowe" []
"We Rang Wagner[r], by Gwen Ra"
"We Refill Free Will[r], by Lew Friel"
"We, Sad as Dew[r], by Dawes Sweda"
"We Seek Skew[r], by Eskew Weeks"
"We Share Her Awes[r], by Ash Ewer & Wash Ree" []
"We Snore Now, Seer[r], by Rose Wen"
"We-So-Mad Meadows[r], by Mo Dawes"
"We Soak So Weak[r], by [if player is male]Wes Kao[else]Ewa Kos[end if]" []
"We Sold Old Wes[r], by Les Dow"
"We Stand and Stew[r], by Ted Swan" []
"We Trash Wreaths[r], by Wes Hart & Ash Wert"
"We Try Any Entryway[r], by Rey Wyant"
"We'd Fear Raw Feed[r], by Fae Drew"
"We'd Rule Rue Lewd[r], by Drew Lue & Derel Wu"
"We've Hit the View[r], by Ev White" []
"Weakly, Kyle? Aw[r], by Kay Lew"
"Weakside Idea-Skew[r], by Ike Dawes"
"Weary Cads['] Sacred Way[r], by Cary Dawes & Casey Ward"
"WebIDTech: Bewitched?[r], by Deb Weicht"
"Webs and Bad News[r], by Ben Daws" []
"Webs to Bestow[r], by Bo West"
"Wee Stop to Sweep[r], by Stew Poe"
"Weep, Nag, New Page[r], by Ewa Peng"
"Weirdos So Wired[r], by Rod Wise" []
"Well, I Think He Will Knit[r], by Wilt Hinkle"
"Welles-Sewell: We Sell[r], by Les Lew"
"Welsh Moor Wormholes[r], by Sherm Wool"
"A Wench Can Hew[r], by A. W. Chen"
"Went Zoo: Tow Zone[r], by Zoe Nowt"
"Were Thou Out Where[r], by Hue Tower"
"West Wing: New Twigs[r], by Gwen Wist"
"Westerly Wry Steel[r], by Ty Lewers"
"Wet Malt, Mel Watt[r], by Matt Lew"
"Wet Pious Wipeouts[r], by St. Opie Wu"
"Wet Skin Stink, Ew[r], by Ken Wist"
"What a Story: Worth a Stay[r], by [if player is male]Wyatt Haros[else]Tosha Tawry[end if]"
"What Ed Had Wet[r], by D. Wheat" []
"What I Love: a Lithe Vow[r], by Evita Wohl"
"What I Need: a Newt Hide[r], by [if player is male]Dean White[else]Enid Wheat[end if]"
"What Mice Came With[r], by Mac White"
"What Rep Pa Threw: Ha, Twerp, The Wrap[r], by Pat Wreh"
"What Side She'd Wait[r], by Thad Weis"
"What, Sire, Wear THIS?[r], by [if player is male]Stew Hari[else]Teri Shaw[end if]" []
"What to Say? Why, a Toast[r], by [if player is male]Wyatt Shao[else]Tosha Wayt[end if]"
"Whatever, Rev. Wheat[r], by T. H. Weaver"
"Whatever the Waver[r], by Eva Werth" []
"Whee, Skit This Week[r], by Wes Keith"
"When I Got to Whinge: Gone, With no Weight[r], by [if player is male]Theo Wing[else]Gwen Hoit[end if]"
"When I Vet With Even View, Then[r], by Wen Veith"
"When Its News Hit[r], by Swenith Weshtin"
"When to Ink: in the Know[r], by Ken Howtin"
"Where Top Hero Wept[r], by Hope Wert" []
"Whereas, Ere Shaw Was Here[r], by Wes Hare"
"Whereat We Heart Ere-Thaw Weather[r], by Tre Ahew"
"Whereto Is Otherwise[r], by Rose White"
"Whimsical Claim-Wish[r], by Wilma Isch"
"A Whine Anew: Hi[r], by Wei Han"
"Whiner, Get Green With Wing Three[r], by [if player is male]Gene Wirth[else]Gwen Reith[end if]"
"The Whiny in the Why[r], by H. Whitney"
"Whistler, He Twirls[r], by Trish Lew"
"Whistler's Shrew List[r], by Shirl West"
"White Mr. Whitmer[r], by Tim Rhew"
"Who Left the Wolf[r], by Lew Hoft" []
"Who Rated Death Row[r], by Wade Roth & Theo Ward" []
"Who Ties This Woe So White[r], by Wes Hoit"
"Who Traced the Coward[r], by [if player is male]Chad Tower[else]Ewa Dortch[end if]"
"Who Treks the Works[r], by Wes Korth" []
"Who Won't Dig With God Now[r], by Dwight Woon"
"Who's Great: Ego's Wrath[r], by [if player is male]Seth Wargo[else]Sage Worth[end if]" []
"Who's Local: Law School[r], by Laslo Chow"
"Wholesome Meow-Holes[r], by Moshe Lowe"
"Whose Hew So[r], by Wes Ho"
"Why East? They Saw the Ways[r], by Stew Hay" []
"Why I Can't Act Whiny[r], by Tawny Chi"
"Why I Get Weighty[r], by Hy Wiget"
"Why I Net Thy Wine[r], by Whitney Thinyew" []
"Why I Sat This Way[r], by Hy Waits & Tay Wish"
"Wild Bo's Low Bids[r], by Sid Blow"
"Wild Glen Dwelling[r], by Gwen Dill"
"A Wild ID Law[r], by Walid Lidwa"
"Wild Logo Idol, Glow[r], by Will Good & Gill Wood"
"Wild Ted's Twiddles[r], by Wilt Edds"
"A Wilder, Idle War[r], by Eli Ward" []
"Wilfredo, Dire Wolf of Wilder Row Field[r], by Ford Weil"
"A Win? I? Naw[r], by Iwan Wain"
"The Winds Hint Dews[r], by Stew Dinh & Ned Whist" []
"Wine or Ire Now[r], by Ron Wei"
"A Wing I Gnaw[r], by Gwain Wigan"
"A Wingless Wineglass[r], by Giles Swan"
"Wink To Know It[r], by Twinko Wotkin" []
"A Winner, Erin? Naw[r], by [if player is male]Ren Wain[else]Ann Weir[end if]"
"Winner Wire[r], by Erwin Winer"
"A Winter in Water[r], by [if player is male]Art Wien & Tai Wren[else]Rita New & Tia Wren[end if]" []
"Winterhold in the World[r], by Eldon Wirth"
"Wipe Eyes: Yes, I Weep[r], by Wei Espey"
"Wire Gangs Swagger In[r], by Greg Swain"
"Wire Till I'll Write[r], by [if player is male]Wilt Iler[else]Lili Wert[end if]"
"Wired Shut, We'd Rush It[r], by Trudi Shew"
"Wiry-Leg Yew-Girl[r], by Gil Wrey-Wrigley"
"The Wisdom Tom Wished, Tim Showed with Demos[r], by Dim Stew Ho"
"Wisdom Verge: Give Me Words[r], by [if player is male]Mr. Edwig Vose[else]Ms. Vergie Dow[end if]"
"Wise Woman is Mean, Wow[r], by Wei Mawson"
"A Wish For Fair Show[r], by Rofi Shaw"
"Wish On Sad in Shadows[r], by Odis Shawn"
"Wish Ten: The Wins Hit News[r], by Newt Shi" []
"Wit Song: to Swing no Twigs[r], by Og Swint" []
"With Cold Child Two, Old Witch[r], by Dot Wilch"
"With Hate, White Hat[r], by Hew Hiatt"
"With Some Showtime[r], by Tim Howes" []
"With Zero or the Wiz[r], by Zoe Wirth"
"Wither, Old Idle-Worth Lord White[r], by Wilt Rohde"
"Wittner, Written[r], by Ren Witt"
"The Wives['] West Hive[r], by Wes Veith"
"A Wobble, Low Babe[r], by Ola Webb"
"Woe, Berserk Worker Bees[r], by Wes Broeker"
"Woe, Raft of Water[r], by Fae Trow"
"Woes Herein, Hereon Wise[r], by Sherie Owen-Eisenhower"
"Wolf Clan Clown Alf[r], by Fawn Coll"
"Wolf Lore Follower[r], by Rolf Lowe"
"Won't Sal Walston Last Now[r], by Al Towns" []
"Won't Sell a Stone Wall[r], by Lela Towns" []
"Wonderful Low Refund[r], by DeRon Wulf" []
"Wonderful Underflow Flew Round[r], by Rudolf Wen" []
"Wonkery: Know Yer New York[r], by Ryno Kew"
"Woo Kind Wood-Kin I Do Know[r], by Odo Wink"
"Wood Hunts Down South[r], by Stu Howdon" []
"Woodier Ride, Woo[r], by Rio Dowe"
"Word Games, Mod Wagers[r], by [if player is male]Mos DeGraw[else]Meg Soward[end if]"
"Work, Play, Wry Polka[r], by Kyla Prow"
"Work Sleep Prowl Seek[r], by Polk Ewers"
"Work Visa: Vow, a Risk[r], by Avi Krows"
"Workable Bleak Row[r], by Bo Walker & Karl Bowe"
"Worked-On Dork Owen[r], by Drew Koon"
"World, Go Grow Old[r], by Lord Gow"
"World of Owlford[r], by Rod Wolf"
"The World, Wroth-Led[r], by Drew Holt"
"A Worldly Wary Doll[r], by [if player is male]Daryl Low[else]Lyla Word[end if]"
"A Worm's So Warm[r], by Sam Row" []
"Worms Feed From Weeds[r], by Ford Mewes"
"A Wormy Elf May Flower[r], by Mary Wolfe"
"Worry Not, Towny Orr[r], by Ron Towry"
"Worry Tons, Sorry Town[r], by Torry Snow"
"Worse Than Haters Now[r], by Seth Rowan" []
"Worsened Endowers[r], by Red Owens & Wes Roden"
"Worst Foe of Towers Swore Oft[r], by Stew Roof"
"The Worst Shrew-Tot[r], by Stew Roth"
"Worthy Lad: Hardly, Wot?[r], by [if player is male]Thad Lowry[else]Dorthy Law[end if]"
"Wow, I and a Window[r], by Awi Down"
"Wow, St. Len Went Slow[r], by Lew Towns"
"A Wren's Answer[r], by Reswan Swaner-Warnes" []
"A Wretch's War Chest Watchers[r], by Chas Wert" []
"Wretched Chet Drew[r], by Ced Werth"
"A Wretched Creed, What[r], by Chet Warde"
"Wriest Writes[r], by Wirt Weissert" []
"Writes I Strew[r], by Wet Sir Si Wert" []
"Writs Dome Most Weird[r], by [if player is male]Tim Sowder[else]Tomi Drews[end if]" []
"Wrong Time, Grime Town[r], by Tom Winger"
"A Wry Con's Way: Scorn[r], by Cary Snow"
"The X-Ray: a Hex Try[r], by Tex Yahr"
"XL, On-Ice Lexicon[r], by [if player is male]Neil Cox[else]Cleo Nix[end if]"
"Yack, Bro, By a Rock[r], by Cory Bak"
"Yah, Debt: By Death, They Bad[r], by Beth Day"
"Yahweh, a He: Why?[r] by Hew Hay"
"The Yard: Hydrate? Dry Heat?[r], by Art Hyde & Thad Rey" []
"Yawn, Plot Won't Play[r], by [if player is male]Walt Pony[else]Twyla Pon[end if]"
"Ye Barn Nearby[r], by Ben Ray"
"Ye Both the Yob[r], by Eb Hoyt" []
"Ye Den Needy[r], by Deeny Deyne"
"Ye Dork, Dr. Okey[r], by Ed York-Rodkey"
"Ye Hardest Three Days Shared Yet[r], by [if player is male]Reed Hasty[else]Thresa Dey[end if]" []
"Ye Laden, Leadeny[r], by Danyele Delaney" []
"Ye Old Yodel[r], by [if player is male]Dooley Lyde[else]Dolly DeYoe[end if]"
"Ye Ole Lorry[r], by Elroy LeRoy" []
"Ye Raw, Ye War Weary[r], by Ray Ewer-Way" []
"Ye Stoic Society[r], by Ice Stoy"
"Ye Very Sad Every-Days[r], by Avery Syed"
"Yeah, Write Either Way[r], by Arie Wyeth"
"Year Flow: a Flowery Low Faery[r], by Ray Wolfe"
"Yearn, Beg, Green Bay: Bye, Anger[r], by [if player is male]Ben Yager[else]Bree Yang[end if]"
"Yearn, Nayer[r], by [if player is male]Arney Raney[else]Reyna Rayne[end if]"
"Yearn On, Annoyer[r], by Ryan Eno"
"Yell Us Ire Leisurely, Ere I Sully[r], by [if player is male]Yuri Selle[else]Sue Reilly[end if]"
"A Yelling, Genially[r], by Gil Layne"
"Yellow, Low Ely[r], by Loy Lew" []
"Yelp, Pyle[r], by Ly Eppley"
"Yelp-Set, Ye Slept Steeply[r], by Sly Peet"
"Yen Still Silently[r], by Ty Ellins"
"Yep, Al, a Yelp[r], by Paley LePay"
"Yep, Ann, a Penny[r], by Nan Pye" []
"Yep, Ed's Speedy[r], by Des Pye"
"Yep, Sam Pays Me[r], by Pa Syme"
"Yes, Ardor So Dreary Arose Dry[r], by [if player is male]Rory Sade[else]Rosa Dyer[end if]"
"Yes, Arm My Ears[r], by Sam Rey" []
"Yes, Bart Betrays By Tears[r], by Rey Bast"
"Yes, Bill, Be Silly[r], by Sly Lieb"
"Yes, Both Bytes, Oh, They Sob[r], by Seth-Boy Sotheby" []
"Yes, Both the Boys[r], by [if player is male]Toby Esh[else]Betsy Ho[end if]" []
"Yes, Comets, Ecosystem[r], by Moses Tyce"
"Yes, Ewen Sweeney, New Eyes[r], by Swen Yee" []
"Yes, Farm My Fears, Mrs. Faye[r], by Sam Frey"
"Yes, Groan, Gray Ones[r], by Rose Yang"
"Yes, I Jaw: [r], by Jay Wise"
"Yes, I'm for Misery of Miry Foes[r], by Romy Seif" []
"Yes, Lu, Win Unwisely[r], by [if player is male]Wiley Sun[else]Linsey Wu[end if]"
"Yes, Ma, Say Me[r], by Masey Aymes-Mayes"
"Yes-Man Sam Ney[r], by Amy Sen"
"Yes, Mend My Needs[r], by Ned Syme"
"A Yes, Mr. Ramsey-Mayers[r], by Sam Rey" []
"Yes, Raw Wry Sea[r], by Wes-Ray Sawyer" []
"Yes: Road So Ready[r], by [if player is male]Roy Sade[else]Rosa Dye[end if]"
"Yeshiva is Heavy[r], by Vi Hayes"
"Yet Cavil Actively, Vile Caty[r], by [if player is male]Clive Tay[else]Evita Cly[end if]"
"Yet Coo, Coyote[r], by Toy Coe"
"Yet Harm the Army-Era Myth[r], by Ty Hamer" []
"Yet Roll, Trolley[r], by Roy Tell"
"Yet Roughen the Younger[r], by Theo Gurney"
"Yet Shirk the Risky, Eh, Kristy[r], by Trish Key"
"Yet Walls Ally West[r], by Sly Ewalt" []
"Yet Whilst With Style[r], by Sly Hewitt"
"Yo, Bold Bloody Old Boy[r], by Bo Loyd"
"Yo, Drop Droopy or Dopy[r], by Rod Yop"
"Yo, Frauds, Your Fads[r], by Fay D'Urso" []
"Yo, Groups: Gory Opus[r], by Guy Spoor"
"Yo, Max Not Taxonomy[r], by Tay Moxon"
"Yo, Mika, I'm Okay[r], by Kim Yao" []
"Yo, Modern Roomy Den, Dr. Mooney[r], by Don Moyer"
"Yo, Mr., All May Roll Morally[r], by Loyal Mr. Mallory" []
"Yo, Nerdy Drone[r], by Rodney Yerdon" []
"Yo, Puns So Puny[r], by Su Pyon"
"Yo, Rapt to Pray: O, Party[r], by Pat Roy"
"Yo, Rend, Dry One[r], by Ned Roy & Don Rey" []
"Yo, Rent: One Try[r], by Rotney-Tyrone Toyner" []
"Yo, Rogue, Your Ego[r], by Reo Yugo"
"Yo, Shut Out, Shy[r], by Toy Hsu"
"Yo Soy Yo-Yos[r], by Sy Yoo"
"Yo, Stunt So Nutty[r], by Tony Tsu"
"Yo, Word, a Doorway[r], by Ray Wood"
"Yogurt: a Gay Tour[r], by Guy Orta"
"Yoke and a Donkey[r], by [if player is male]Deon Kay[else]Ken O'Day[end if]"
"A Yoke, Aye, OK[r] by Yaeko Oakey"
"Yokel Herd Keyholder[r], by [if player is male]Kyle Herod[else]Keely Hord[end if]"
"A Yolk Lay OK[r], by Kyoko Layla"
"Yon, a Jig: Gain Joy[r], by [if player is male]Gino Jay[else]Joni Gay[end if]"
"Yon Bald Land Boy[r], by Bo Dylan"
"Yon Desk Donkeys[r], by E. K. Dyson"
"Yon Fit Not, FYI, of Tiny[r], by Ty Fino" []
"Yon Glad Long Day[r], by Lyn Goad"
"Yon Mad Monday Dynamo May Nod[r], by Don May" []
"Yon Marked Dark Money[r], by [if player is male]Myron Dake[else]Kendra Moy[end if]"
"Yon Organza Rannygazoo[r], by Zona Gaynor"
"Yon Pitch Hypnotic[r], by Tony Chip"
"Yon Seed So Needy: Done, Yes[r], by Ed Noyes"
"Yon Tearful Funeral Toy[r], by Tony 'Earful' Fauntleroy"
"Yon Urge on Ye Rug[r], by Geno Ruy"
"Yon Valet, a Novelty[r], by Val Toney"
"Yon Web, New Boy[r], by Bo Wyne-Owenby"
"Yon Wish So Whiny: I, Shy Now[r], by Swin Hoy"
"Yon Wrath Way North[r], by Troy Hawn"
"You Can Thwart Wrath, Can't You?[r] by Truth Conaway"
"You Carve Your Cave[r], by Eva Coury"
"You Led His Lousy Hide Hideously[r], by Doyle Shiu"
"The Young: Hey, Go, Nut[r], by Huey Tong"
"Young Lad, an Old Guy[r], by Lou Gandy"
"Your Choice, Our Icy Echo[r], by Corey Chiou"
"Your Death, Dear Youth[r], by Hearty Duo Theo Audry & Doretha Yu"
"Your Facts, Crusty Oaf[r], by Fausto Cyr"
"Your Fad's Four Days[r], by [if player is male]Rudy Faso[else]Fay D'Urso[end if]" []
"Your Heart, Rare Youth[r], by Arturo Yeh"
"Your Kind, You Drink[r], by Koy Rudin"
"Your Neat Any-Route: Year Unto a Tourney[r], by Tony Auer"
"Yup, I Roister: Superiority[r], by Roy Espiritu"
"Yup, Loft to Fly Up[r], by Ty Plouf"
"Yup, Roam Your Map[r], by Roy Puma"
"Zap Each Haze-Cap[r], by Chaz Pea"
"Zap, I Use a Size Up[r], by Su Paiez"
"Zap, Lie or Polarize[r], by Zoe Plair"
"Zen Chat Chez Nat[r], by Zach Ent"
"A Zine's Zanies: Ian Sez[r], by Sean Zi"
"A Zooms Zoo, Sam[r], by Somoza Somoza"
"Zorinho's Horizons[r], by Roz Hoins"
"Zounds, No Sudz[r], by Oz Sund"

to say an-other:
	say "--an[one of][or]other[cycling] embarrassingly fawning biography of you";

table of sports chatter [xxm05]
blurb
"'Air Ira?! Air Ari!'"
"'Air Lev?!'"
"'Bad calls, ball-cads!'"
"'Bad team! Mad! Beat!'"
"'Bears are BS!'" []
"'Bossin['] Bisons? Is NOBS.'"
"'Buckets Stu Beck be stuck.'"
"'Cal won?! A clown!'"
"'Checked out? Cute. CHOKED.'"
"'Chumps at match-ups!'" []
"'Cons rig scoring!'"
"'Dam['] ref. Framed!'"
"'Denton's tendons...'"
"'Ducks suck'd!'"
"'Duke FC?!'"
"'Each KO, a choke!'"
"'Ed Ford? Odd ref. Fodder.'" []
"'Eh, umps push me.'"
"'Evah have an ump man up?'"
"'Fake punt. Punk fate.'"
"'Fest for soft ref efforts.'" []
"'Fowler? Low ref.'"
"'Friedel: fielder? Refiled: defiler!'"
"'Fullback? Flab! Luck!'"
"'Goodstein got onside!'"
"'Gus DeNaro. Dangerous nose-guard.'"
"'Hero ball? Hell, bro, a blah role.'"
"'Hickson? Chokins[']!'" []
"'How now? WHO won?'"
"'Impugn gumpin['] umping!'"
"'Impure umpire.' / 'Sobs, boss.'"
"'Infura-unfair.'" []
"'A jump shot? Uh, stop. JAM.'"
"'LeSage Eagles? Gee, las[']."
"'Lions? Losin[']!'" [x]
"'Low shot. ... Who lost?'"
"'Main ref? FIRE, man!'" []
"'Mean ref, Freeman. Men fear...'"
"'Mitch Sam? Mac Smith? Mismatch.'" []
"'Moehring: homering more nigh.'"
"'Mr. Cub? CRUMB.'"
"Of FGs hit, of fights: 'Go fifths, stiff hog.'"
"Oh-fer Hofer. Ho, ref!"
"'Oh, ream a homer more, ha!'"
"On impulse: 'No! Umps lie!'"
"'Our refs? Furores!'" []
"'Our team's so mature.'"
"Pompous ump: 'Oops!'" []
"'The prize? Three-zip.'"
"The pros, eh, sport?"
"'Puck-fu [f-w]-up!'"
"'Rankest tankers!'" []
"Ref rants transfer."
"'The refs? Eh, frets!'"
"'Ridiculous! I...ludicrous!'"
"'Riskin['] Kirins? Irkins[']!'"
"'Ruined. Ref under fire.'"
"'The scorer? Rochester.'" []
"'See-not-ONE-set Osteen? Ee, snot.'"
"'Shortstop? Shot, sport!'"
"'Sikes SKIES!'"
"'SIX ump mix ups! Sum pix!'"
"So-agile Goalies['] egos ail." []
"'Starkey? Streaky!'"
"'Sub them, the bums!'"
"'Sucky ol[']...so lucky!' Coy sulk."
"Super lucky? Purely suck! Ruckus, yelp!"
"'Super? Poorest! Preposterous!'" []
"'That loss. Last shot...'"
"'Throw it to Wirth!'"
"'Tip-ins? Spitin['] tip-ins.'"
"'To ref: o, fret ofter!'"
"'Umpin's sumpin['] un-simp.'"
"'Unkind dunkin[']!'"
"'We lost. Lowest.'" []
"'Whiffs at whatiffs? Haw, stiff.'"
"'Ye Snake-Yankees!'" []

book stores

table of idiotic babbler points [xxs1]
blurb
"applauds the rigorous squalor of [i]Grub, Dust, Drug Bust[r]."
"asks, how do you want your life? Bald? Acne? Or BALANCED?" [x]
"asks the crowd to chant 'Hemp? So po[']. Mehs.'" [x]
"bemoans cut-rules cultures." [x]
"berates a front-rower drawing smileys messily." [x]
"booms 'Dopamine Paid Me? No!'" [x]
"booms ADORE METH? MORE DEATH." [x]
"claims heroin = NO HIRE." [x]
"claims things happening causally happen casually. Or vice versa." [x]
"continues 'Dope. How WHOOPED.'" [x]
"continues 'Dope is POISED: Die-ops!'" [x]
"continues 'Dopers to doorstep, so? DEPORT!'"
"continues 'Drugged? Grudged'"
"continues 'DRUGS: medicating? Decimating!'" [x]
"continues 'DRUGS: soul-y? LOUSY!'" [x]
"continues 'Habits? Bash it!'" [x]
"continues 'Hie to dope? Hope to die!'" [x]
"continues 'Lo-med model? Me: OLD!'"
"continues 'No roids indoors! Rid soon!'" [x]
"continues 'smoke shop: Hemp, ok? SOS!'" [p] [x]
"continues 'STD! DTs!'" [x]
"continues 'STONED: DOESN'T. TO ENDS."
"continues 'Truly coked? Cold turkey? Cloudy trek.' Retold. Yuck." [x]
"continues presentation neater points." [x]
"continues to belt out stipulated platitudes." [x]
"cuts down famous, um, oafs." [x]
"discusses his move from troublemaker to maturer bloke."
"endorses the work of Dr. Gus Gruds." [x]
"explains weasely leeways drug addicts use to avoid their punishment." [x]
"forces the crowd to chant, 'Nope! Do no dope!'" [x]
"gives radioactive advice--a riot, if you had ironic distance or didn't have a quest to get back to." [x]
"hawks his favorite of the vast mini-vitamins out there." [x]
"intones 'Hemp, dust: the dumps! Um, depths!'" [x]
"isn't here for dealin['] denial." [x]
"laments how e-drugs surged." [x]
"mentions pupils slip up without Baehr Herba-Rehab."
"moans 'The drugs SHRED! GUT!'" [x]
"moves between anecdotalism and declamations." [x]
"notes even crackheads can see POT is the reverse of TOP." [x]
"notes the underlying sympathy of the no-punches-pulled [i]Plausible Pill Abuse: Pa, Bullies[r]."
"outlines DevOps vs. Dope." [x]
"pushes the virtues of Tim's Stim-Mist over drugs." [x]
"rails against the Oceanic Cocaine cartel."
"recounts how [i]Axed to a Detox[r] could be about you, or you... OR YOU!"
"revels in his repenters presenter role."
"says drugs leave you nicked?! DECKIN[']." [x]
"shouts 'Do-meth method? Mo['] deth!"
"shouts down a Thera-Heart Hater."
"smacks down someone who yells 'Poobah? Pah! Boo!'" [x]
"warns against strudel laced with LSD-ture." [x]
"warns people against trying Methy Thyme." [x]
"yells 'Sh, li'l shill' at some interruption you didn't hear." [p] [x]

table of overdone movies [xxs2]
blurb
"admits [i]Wendie's Sin Weed Dies New[r] is weak, but it's not WRONG." [x]
"agrees [i]Fop, Indeed? Dope Fiend[r] is funny, well, TIL IT ISN'T." [x]
"alerts people to [i]Spill, Sip: Pip's Ills[r]."
"almost weeps at the simple truth of [i]Ah, Vilest, the Vials[r]." [x]
"analyzes the dystopian backdrop of [i]Czar-Urged Drug Craze[r]." [x]
"analyzes the mix of social and hard sciences in [i]The New Drug, Hunted, Grew[r]." [x]
"applauds the cautious optimism of [i]Rehab is Bearish[r]." [x]
"applauds the confrontationalism of [i]All Drugs: Dull Rags[r]." [x]
"'appreciates' the avant-garde 'wit' of [i][crap-u] I'd Do: Drop Acid[r]." [x]
"argues nobody could handle the excitement of [i]Lude Duel[r]."
"assures the camp value of [i]Peg's Tot Gets Pot[r] causes even MORE deaths, but that's not the video's fault." [x]
"assures the veracity of [i]Nose Candy Once, Sandy? Any Second[r]." [x]
"blabs on a while how there's not much to add to [i]Chaotic Coca Hit[r]." [x]
"branches into non-physical addiction with a discussion of [i]Lots-Lost Slot[r]." [x]
"calls for more fantasy novels like [i]Shipmate is at Hemp[r]." [x]
"claims [i]Mr. Heaping: Hampering a Hemp Ring[r] is more exciting than any high." [x]
"claims the creators of [i]Risk, to a Rat, is OK[r] believed in their artistic vision." [x]
"claims you only need to like one part of [i]Tips to Stop It[r]." [x]
"commends a mythological allusion in [i]Drugs['] Cost: Curst Gods[r]." [x]
"compares [i]Pepe Hit the Pipe[r] with [i]Hip Pete: the Pipe[r]." [x]
"compliments the old- and new-school balance in [i]Ye Bistro: Yo, Bestir Sobriety[r]." [x]
"DARES anyone to laugh at [i]Tedd, Acid-Addicted[r]." [x]
"delves into the simplicity of [i]Eh, Most Mehs to Meth, So[r]." [x]
"discounts the glitz of [i]Bar Hunter Heartburn? Rehab! Turn[r]." [x]
"discusses how the extra-long title of [i]Mother or meth, eh, Mort[r] personalizes it."
"discusses the deeper meaning of [i]The Bar: Her Tab[r]." [x]
"discusses the NECESSARY repetition in [i]That Heroin: Another Hit[r]." [x]
"discusses treatment of mental addictions in [i]Sad Dice Caddies[r]."
"dismisses claims of overacting by the star of [i]Hot Pill Hilltop[r], Phil Olt." [x]
"dismisses those who gave [i]Noe Rast: Saner to a Stoner[r] one star." [x]
"dissects [i]So I Went to Wines, Townies[r]." [x]
"elucidates the gripping story of [i]A Dud's Growth: What Drugs Do[r]." [x]
"encourages emulating the TRUE protagonist of [i]Mistaken Snake Tim[r]." [x]
"endorse [i]Got Such, Ugh, Cost to Chugs[r]."
"explains [i]Addicts Did Cast[r] shows even minor legal drugs can be so harmful." [x]
"extrapolates [i]Or Do Sin on Roids[r] to drugs not illegal yet."
"exults in the optimism of [i]Haskins Sank His Shakins[r]." [x]
"feels [i]A Stoner: No Tears[r] clearly deserves more than one star." [x]
"gasps at the emotional power of [i]Thurgood's Drug Shoot[r]."
"hails the artistic daring of [i]Skid-Bars: Brass, Kid? Bad Risks[r]." [x]
"has little that needs to be said about [i]The Rum Hurt Me[r]."
"hashes out legal details of [i]Audi: a DUI[r]." [x]
"hat-tips [i]Mess Around: Sour Amends[r]." [x]
"hints at the fantasy redefinition in [i]A Demon on Mead[r]." [x]
"hopes nobody ever FULLY sympathizes with the subjects of [i]To Scrape at Copers: Pot Scare[r]." [x]
"injects deeper social meaning into [i]The Wimp Wit['] Hemp Met WHIP[r]." [x]
"knows everyone knows about [i]Durham's Rum Dash[r]." [x]
"knows everyone's seen [i]Addicted Dad, Cited[r]." [x]
"labels [i]Pitbull's Pill Bust[r] sobering in more ways than one." [x]
"laments the main character's--and actor's--drug habit in [r]Need Kilo, Keen Idol? Like, DONE[r]." [x]
"lauds the ambiguously powerful narrative of [i]Pot Smoker? Me? OK, Sport[r]." [x]
"lauds the characterization in [i]Corrupted Doper Curt[r]." [x]
"lauds the directness of [i]To Punks Pot-Sunk[r]." [x]
"lauds the poetry-like quality of [i]No Spiel: One Slip Piles On[r]." [x]
"lauds the refreshing directness of [i]Point in Pot? Tip: NO[r]."
"lauds the revolutionary perspective in [i]I, a New Drug, Waged Ruin[r]." [x]
"lauds the supernatural creepiness of [i]Methadone: Death Omen, the Daemon Ahem, Noted[r]." [x]
"laughs at people who laugh at [i]Jean, Took: Not a Joke[r]." [x]
"loud-whispers that [i]Not Dirk: Kid, Torn, to Drink[r], has an understated truth to it." [x]
"mansplains [i]Turds Go to Drugs[r] is full of tough love, not snide put-downs." [x]
"marvels at the simple pleasures found in [i]Pipe Rehab: Be Happier[r]." [x]
"mentions everyone finds [i]Wobegon Bong Woe[r] above average." [x]
"mentions hip pop-culture allusions in [i]Just One More Neuters Mojo[r]." [x]
"mentions nobody better laugh at [i]LSD: I Slid[r]." [x]
"mentions nobody but everybody is at fault in [i]Odd Couple: Dope Could[r]."
"mentions the balance of sympathy and fact in [i]Ol['] Sots So Lost[r]." [x]
"mentions the message of [i]Meth Day: My Death[r]." [x]
"mentions the sudden shocking twist in [i]Egberto Got Beer[r], featuring Bo Egert." [x]
"moves on from drugs for a moment to [i]Reality of a Toy Rifle[r]." [x]
"name-checks an actor from [i]Joints Cue No Justice[r]." [x]
"name-drops the latest didactic work [i]Bo's Free of Beers[r]." [x]
"notarizes why [i]Sunk Drip Drinks Up[r] is tough but fair." [x]
"notes [i]So Wicked Dick's Woe[r] is tough but fair." [x]
"notes [i]Unwary Ryan Wu[r] underlines too much education is never enough." [x]
"notes all the clever implications in [i]The Pill: Help, [']Til[r]." [x]
"notes anyone can be tempted, like in [i]Stars Go to Grass[r]." [x]
"notes how [i]Thug Life: Ugh, I Left[r] isn't just about drugs."
"notes that [i]THEM, METH[r], does, indeed, 'h/t me.'" [p] [x]
"notes the budget of [i]Hemp, Dust: The Dumps[r] was worth every penny."
"notes the exoticism and down to earthiness of [i]The Ganja, Then a Jag[r]." [x]
"notes the factual relevance of [i]They Said It's Heady[r]." [x]
"notes you have to appreciate the down-home candor of [i]Nelson's Lesson'N[r] starring Sol Ness." [x]
"outlines how the multiple protagonists of [i]Abuse Pot: So Beat Up[r] reach their fates." [x]
"overdoes his sympathy for [i]This Cold Child-Sot[r]." [x]
"pauses for effect before meta-spoiling [i]April's Spiral[r]." [x]
"personalizes the multiple tragedies in [i]Lose Ring: Gin's Role[r]."
"plugs the short [i]To Inhale a Lone Hit[r]." [x]
"points out [i]Steroid: Rots. DIE[r] was so influential in the whole genre." [x]
"points out [i]Tout IQ to Quit[r] has multiple positive messages." [x]
"points out how [i]Bar Kid's Bad Risk[r] balances sympathy and reality." [x]
"points out it's not just the illegal stuff. [i]Hank's Cig Hackings[r] proves that."
"praises the gritty, gripping, noir, curt REALness of [i]Vi's IVs[r]." [x]
"praises the presentation, if not the content, of [i]Nutmeg: a Mutagen Augment[r]--the main character should've become a mega-nut." [x]
"praises the REAL way-out insights of [i]folds of LSD[r]." [x]
"praises the straightforward humor in [i]Boozed Bozo Ed[r]." [x]
"proclaims [i]Me, a Drunk, Unmarked[r] poignant but not the way to get sympathy." [x]
"promises not to spoile the end of [i]The Rum Hurt Me[r]." [x]
"'proves' how general [i]Face it, I.E. Fact[r] really is." [x]
"quotes from the 'gripping' biopic [i]Dust-Head Thaddeus[r]." [x]
"rants anyone who hated the ambiguous ending of [i]Frail-Skin Liar-Fink's Final Risk[r] is pro-drug." [x]
"raves about [i]Good Try to Go Dry[r]."
"re-enforces the 'happy' ending of [i]Gunther's Nth Urges[r]." [x]
"re-enforces the humanity of [i]Booster-Reboots: to Sober[r]." [x]
"reads an excerpt from his next 'modern, advanced' 'nonfiction,' [i]Not My Monty[r]." [p] [x]
"reasons [i]Me, Froth for Meth From the Fort, Hem[r] has as much action and emotion as any blockbuster." [x]
"reassures everyone they aren't low enough to have to watch [i]Straighten-Shattering[r] yet." [x]
"recalls how [i]No, Ted's Stoned[r] brought back a poor fellow he knew from his youth." [x]
"recaps how he met the real-life 'inspiration' of [i]Mitt Booth Hit Bottom[r]." [x]
"recites a 'killer' quote from [i]Much Pot: Top Chum to Chump[r]." [x]
"recommends [i]Cocaine's Con is Ace[r]." [x]
"recommends [i]Coke! Rad? CROAKED[r]." [x]
"recommends [i]Fustian Howl, a Wishful Ton: His Own Fault[r], for people who love hearing their own excuses." [x]
"recommends the hard-hitting simplicity of [i]So, Meth Shot Me[r]." [x]
"recounts the sad denouement of [i]Phenom on Hemp[r]." [x]
"recounts the trauma and relief of the protagonist of [i]Other Kids Risked, Tho['][r]." [x]
"refers to [i]Bo's Thing: Bong Hits? Sob Night[r]." [x]
"reflects [i]RIP Moe's Semi-Pro Promise[r] has been overall good for society--BUT THAT DOESN'T HELP MOE." [x]
"rehashes [i]No Weed! End Woe[r]." [x]
"reiterates the FACTS of [i]The Polls: Pot's HELL[r]." [x]
"relates comparisons of pro- and anti-jokes in [i]Drum Rough Drug Humor[r]." [x]
"relates the measured sympathy of [i]Pared Joy Jeopardy, Doper Jay[r]." [x]
"reminds people [i]Nice Into Nicotine[r] is old because it's true." [x]
"reminds people all drugs are wrong, as in [i]Kent's Doom: Don't Smoke[r]." [x]
"reveals historical accuracies in [i]Fie Now: on, Wife of Wine[r]." [x]
"reveals the personal nature of [i]I'd Do: Facts of Addicts[r]." [x]
"riffs on the subtleties of [i]Alco-Lust Calls Out[r]." [x]
"rues technology's contributions to addictions with [i]To Click a Cocktail[r]." [x]
"says [i]Acid Rages: a Disgrace[r] HAD to be graphic to be truthful."
"says [i]Bad Slick Backslid[r] is not just a catchy title." [x]
"says [i]Deed Story: Trey, Dosed, Destroyed[r] obviously NEEDS to be THAT long." [x]
"says [i]Mugs Order More Drugs: Go, Murders[r] probably won't happen. But can you risk it?" [x]
"says [i]One More Hit: Her Emotion, Moot Herein[r] would be lying if it weren't drawn out and overdone." [x]
"says [i]Strom, Mr. Sot[r] is nowhere near as demeaning as the drug itself." [x]
"says [i]To Snare a Stoner[r] by Ron East is grippingly realistic." [x]
"says [i]Way Stoned, Swayed Not: Today's New, Steady Now[r], deserves to be such an epic." [x]
"says [i]Withdrawal: a Wild Wrath[r] has one unrealistic point: the junkies are too attractive." [x]
"says if you're on drugs, of COURSE you'll miss the point of [i]Drugstore: Urges Trod[r]." [x]
"says ignorance is no excuse, proved by [i]Ten Fools to Felons[r]."
"says nobody's disproven [i]Like Drugs? Sulk, Dirge[r], yet, though they've tried."
"says of course society NEEDS a movie like [i]Stern Avert: Never Start[r]." [x]
"says only fools laugh at [i]I'm Seth: Meth is This, Me[r]." [x]
"says right-thinking folk deserve the humor in [i]The Drunks['] Herd Stunk[r]." [x]
"says the audience just can't admit they want to be the narrator in [i]Woe Underway: We Warned You[r]." [x]
"says the humor in [i]So, Teach Each Sot[r] is NOT overbearing, thank you." [x]
"says you can laugh at AND with [i]Toasted Ted: a Sot[r]." [x]
"says you really need to re-watch [i]Try Once: Note, Cry[r] for the full effect." [x]
"says you'll have to re-watch [i]One Puff is Fun? Fie, Sop[r]." [x]
"shakes his head at the clear implications of [i]Deviance, Even Acid[r]." [x]
"shivers at that passage in [i]One Drug Urged on: Go Under[r]." [x]
"shows clearly how the lessons in [i]Wise Up to Wipeouts[r] can generalize." [x]
"shows tough-but-fair sympathy for the main character in [i]I Began a Binge[r]." [x]
"shrugs over the conclusion of [i]A LSD Lad's Sad L[r]."
"shudders at [i]Tad's Habit is THAT Bad[r]."
"suggests people watch the 'classic' [i]Falk's Flask[r]." [x]
"sympathizes with Fay Klos, the main character in [i]Yo, Flask? So Flaky[r]." [x]
"takes a while to say there's nothing to say about [i]Needle Lendee[r]."
"tempts people to watch [i]Eying Ye Gin[r], which is of course about resisting temptation." [x]
"throws up his hands about [i]I Cotton to Tonic[r]."
"touches on the protagonist's life-long struggles in [i]Real Fog of Lager: FEAR LOG[r]." [x]
"underlines the importance of peer groups in [i]Overdose: Do Veer So[r] starring Rose Dove." [x]
"validates the street language in [i]One Hit, Eh? Into Nite, Ho[r]." [x]
"verifies the science of [i]Drugstore: Dregs['] Tour[r]." [x]
"vouches for the veracity of [i]A Drinker's Risen, Dark: Kinda Errs[r]." [x]
"weepily recounts the tragic [i]June Keith, the Junkie[r]." [x]
"weeps for everyone in the cautionary [i]Panic, Tots: I Can't Stop[r]." [x]
"weeps silently on mentioning [i]A Tot's Toast[r]." [x]
"yells about [i]Steroids Tried? SOS[r]." [x]

table of sicko movies [xxs3]
blurb
"[a-word-u]-Hump Smash-Up."
"[a-word-u] Porn Parsons."
"[d-word-u] Hoes Had Men So Handsome." []
"[if player is male]SOB Seth[else]Hot Bess[end if] the Boss."
"Abasin['] Sabina."
"Able Size, Seizable."
"Abuse Us, [a-b]!" []
"Ace Fine's Fiancees."
"Ace Trio Erotica." []
"Ace's Sty: Ecstasy."
"Active Tart, Attractive."
"Admired Red Maid Demi Ard."
"Adore: a Redo."
"Ah, Dr. Hard."
"Ah, So, Men: No Shame." []
"Ahoy, Spent Pantyhose!" []
"Aid-Men Maiden!"
"Aidan's Naiads."
"Aiden, Edina, Andie, Diane."
"Air-Smut Atriums."
"Al, Hot to Hal." []
"Al, Lillia, Alli, Lila."
"Al's All Ass!"
"Alan, Lana."
"Albiness Lesbians."
"Aldo's Loads." []
"Alice, Celia, Lacie."
"Aline, Liane, Elina, Nelia." []
"Alison Lain So."
"All Do a Doll!"
"All Over Lover Al." []
"Alleg. Legal."
"Alley Leyla."
"Allow Me to: a Low Motel."
"Alluring Girl Luna."
"Ally, Lyla, Y'all."
"Alvin's Slavin[']."
"Am-Horny Harmony." []
"Ami/Mia/Ami."
"Amy, Mya, May."
"Anal Roust So Natural."
"Anatoly, Yolanta, Latonya."
"And Risque Quandries."
"Andii, India, Nidia."
"Andrei, Randie, Darien." []
"Andro-DaRon, Dan or Doran." []
"Aneesh, Sheena, Neesha."
"Anne, Luc, Unclean."
"Another Hilly Roll in the Hay!"
"Any Fast Fantasy."
"Aphrodite's Hot Diapers."
"Aretha, Eartha, Reatha."
"Ari's Sexy Six Years."
"Arik, Kira, Kari, Rika."
"Arlo, Al or Oral Lora."
"Arnita, Anitra, A-Train."
"Aroused: a Sure Do!"
"Arsene, Serena, Naseer." []
"As Punks Spank Us."
"Ash Has [a-word-u], Ahh!"
"Assaults: a Lust [a-word-u]."
"Assumer Masseur."
"At Lech Chalet."
"Athletic Lithe Act."
"Australian Saturnalia."
"Aw, Bride, I'd be Raw, Bawdier." []
"Aw, Kin I Wank a Wink?"
"Axel, Lexa, Alex."
"Ay, Lad, a Lady."
"Babes of Be-So-Fab."
"Baby, Do Bad Boy."
"Back-End Dan Beck."
"Back Room Boom Rack."
"Bad Doll, Bold Lad."
"Bad Self Alf's Bed!"
"Bald ABDL."
"Bambino an['] Bimbo." []
"Bared Debra." []
"Barest Breast."
"Be Hot, Bo the He-Bot."
"Be? No. BONE!"
"Be Rad--Er, Bad--Bared." []
"Bear on a Boner." []
"Beat Off, Eat, Boff."
"Bed-Singe Big Needs."
"Beeswax: a Sex Web."
"Bend [']N Bed."
"Bend, Ow: We Bond." []
"Benino Bein['] on Bonnie." []
"Bent Sam, Best Man."
"Beresford Bros Freed for Breeds!"
"Bert, Bret, Treb."
"Bertha's Bathers."
"Beslag-Gables." []
"Beth in the Bin."
"Beth Was Best, Haw."
"Bi Idols['] Libidos."
"Bi Jen, Jeb in Benji."
"Bi Ned Biden."
"Bidden, I'd Bend."
"Big A, Gabi, Gaga Bibi."
"Big-Anus Abusing."
"Big Len, Gil, Ben, Bi Glen."
"Big Lon's Sin Blog." []
"Big Tease, I Get Base!"
"Bill, We Will Be Bi Well."
"Bimbo Bi Mob."
"Bimboes Mobbies."
"Bimbos is BOMB!"
"Bite? No, Bone it, Benito!" []
"Bizarre Rare Biz."
"Blaine's Lesbian."
"Blalock's Ballocks."
"Blissy Sybil's."
"Blouses to Bust Loose."
"Blue-Organ Boulanger." []
"A Bluster: Bare Lust." []
"Bo Hunt's Hot Buns."
"Boarding Andi Borg."
"Bod Un-Bound? No, Bud!"
"A Bod's So Bad." []
"The Body by Hot Ed." []
"Bois So Bi: Bios."
"Bolden's Blondes."
"Bombastic Bimbo Cast!"
"Boner-Borne."
"Boner Menu Number One."
"Bonnie, Bone in Bin One." []
"Boo at a Boot Taboo."
"Boom, Desire: More Bodies."
"Boot a Taboo." []
"A Booty Girl: Obligatory!"
"Both Wild With Bold."
"Bow, Cosy Cowboys."
"Brand New Brawn Den."
"Brandy [']N Brady."
"Brandy and Bry." []
"Breast Baster." []
"The Bride Herb Tied: Her Debit."
"Bride, I, Bred."
"A Bride's Bi Dares." []
"The Bud Bed Hut."
"The Bulls Bust Hell." []
"Bum Boy Bob, Yum."
"Bunnies Bus Nine." []
"Burlesque Rub: Sequel."
"But is Stu Bi?"
"Buttsex Subtext."
"Buxom? Mo['] Bux!"
"Cami-Lex's Exclaims-Climaxes."
"Candi, Eve, Deviance."
"Candi in a CD." []
"Candice and Ceci."
"Cane-Me Menace."
"Captain, Pati Can." []
"Cardinal Carnal-Id." []
"Carla's Rascal."
"Carly On Carolyn." []
"Carol, Carlo, Coral."
"Cavers['] Craves."
"Cece's Sin Sciences."
"Chasier Cherisa." []
"Chasier Sharice." []
"Cheerly Lechery."
"Cher Scot Crochets Crotches."
"Chestier Christee."
"Chestier Heretics." [p] []
"Cierra, Carrie, Errica."
"Cindy, Sam, My Candi's Dynamics."
"Clad-Sans Scandals."
"Clara's Rascal." []
"Claudine, Dulcinea, Lucia, Ned." []
"Cleavage Ava Cleeg."
"The Cock to Check."
"Cold? Wet? Lewd Cot!"
"Cooter is So Erotic."
"The Cop's Hot Pecs." []
"Cora's Oscar." []
"Corin's Scorin[']."
"Cornelia, Caroline, Coraline." []
"Cosplay Coy Pals." []
"Cougar is Gracious."
"Crass Rude Crusaders."
"A Cream Camera."
"Creamy Marcey."
"Creamy McRaye." []
"The Crowds Doth Screw."
"Crude-Ass Crusades."
"A Cruise, Saucier."
"Cucumbers Succumber."
"Cuddly DD Lucy."
"Cum Into My Community."
"Cum is Music." []
"Cum-on-Me Commune."
"Cute Mom's Commutes."
"Cuter, Re-Cut." []
"Daaamn, Amanda."
"Dam Yer Dreamy My Dear." []
"Damian's Mainads."
"Damn Sissy Sassy-Mind Sysadmins."
"Danny, Dyann [']N Andy."
"Dark Skin, Rad Kinks."
"Darlena, Leandra and Earl."
"Darn, He and Her Harden."
"Daughters Get Us Hard." []
"Debased Bad Seed."
"Debauch Each Bud."
"A Debt at Bed."
"Dede's Deeds."
"Dee's Boss: Obsessed."
"Deena, Andee, Danee: a Need."
"Def Mom Femdom."
"Delaware: Lewd Area." []
"Delia, Elida, Leida, Adiel."
"Dennis's Sin Dens."
"Deprave, Pervade: Repaved."
"Deviants, Mar Maidservant Animadverts."
"Di Sims: Miss Id."
"Diana, Aidan, Daani."
"Did WHAT with Dad?"
"Diedra, Raided." []
"Dina, Andi, Dani, Dian and I."
"Dinkin's Sin-Kind."
"Dionne & Donnie." []
"Dire Lust, Luridest."
"Dirtiness Disinters Direst Sin."
"Disco Ball Basic Doll Local Bids."
"Disgraceful [if player is male]Claus Ferdig[else]Claris Fudge[end if]."
"Disgusting Snug Digits."
"Disturbed Bride, Stud."
"Dive Party Depravity." []
"Do Ann, and On, Donna."
"Do Cluck, Cuckold!"
"Do-Ho Hood."
"Do THAT to Thad? Hot, Tad."
"Do-Us Duos."
"Doable Old [a-b]."
"Doc Luck, Cuckold."
"Doin['] Dion." []
"Doing So-Good Sin."
"Domina Domain." []
"Domination Admonition."
"Don, Be Boned."
"Don's Bulge Bludgeons."
"Don't Use ONE Stud!"
"A Donkey, Naked, Yo!" []
"Donna, Danno, and On and On." []
"Donor, Do Ron or Don." []
"Dope Sex EXPOSED."
"Dorm Chief Forced Him."
"Double Down Now, Loud Bed."
"Dr. Lo-Vibe Lovebird."
"Dr. White Hit Drew, Writhed."
"Drips Won't Strip Down!"
"Drusila, As Lurid."
"The Dude Hut Deed."
"Dumbest Bed-Smut."
"Duplicate Adult Epic."
"Durty Trudy."
"Dyan, Andy [']N Ady."
"Dying to Dig Tony, Tiny God." []
"Dynamite Tiny Dame." []
"E-RSVP Pervs."
"Each Fappy Happy Face."
"Ed Long: Le Dong Golden."
"Ed Shared Redheads."
"Ed's New Sick Wickedness."
"Eden's Needs."
"Eek, Rev. Keever."
"Eep, Males Please Me!"
"Eh, Fat is a Fetish."
"Eh, Go Try the Orgy."
"Eh, Not on the Net, Ho." []
"Eight-Inch Itching, Eh?"
"Eight Sin Nighties." []
"Elana, Leana, Alane, Alena."
"Elating Genital Atingle." []
"Elena, Leean, Alene." []
"Eli Nabs Lesbian Base Lin." []
"Elida's Ideals Aslide."
"Elise, Elsie, Liese."
"Elma's Males." []
"Elysia, Easily."
"Elysian Ainsley."
"Employ My Pole."
"Encounter None Cuter."
"Engulf Leg Fun."
"Enhanced Dee Chann." []
"Enjoy Jen, Yo."
"Enrique's Queer Sin."
"Enticers In Secret."
"ePervs Vesper." [p]
"Er, Dang, I'm Dreaming!" []
"Er, FYI if Yer Fiery."
"Er, I'd Ride."
"Erection: Encore It!"
"Erica, Carie, Ciera."
"Erik, Keri, Iker." []
"Eros Rose, Sore." []
"Erotic Ages: Categories."
"Erotism, Moister."
"Etta's Teats Taste..."
"Euro PVC Coverup."
"Euro-Roue."
"Evidant Deviant Vain Ted, [']Net Diva."
"Ex-Gays." [x]
"Exalt Latex!"
"Exhaust-a-Sex Hut."
"Exitless Sex Islet."
"Expects: Seep, XTC!"
"Explicit CitiPlex."
"Exstisy: It's Sexy."
"Extroverts['] Retro TV Sex."
"Face Sin Fancies."
"Fair Lewd Warfield."
"Fallen Hut: All the Fun!"
"Fap Now, Wan Fop."
"Fap-Us FUPAs."
"Far West Raw Fest." []
"Farm Up a Frump."
"Fawn's a NSFW an['] SWF."
"Fawn's a NSFW W/Fans!"
"Fee-Boys So Beefy."
"Feet Fete."
"Fefe's on Offense."
"Felisa's Falsies."
"Felix's X-Files." []
"Fetish Fits, Eh?"
"Few Can Do Co-Ed Fawn Face Down."
"Fine Leg Feeling." []
"Fine Low Life Now."
"Fine Mr. Fermin."
"Finer-Body Boyfriend Bry DeFino."
"A Finest Sin-Feat Fan Site."
"First Lady Flirt Days."
"Fit Anne Infante."
"Fit Arreola Taliaferro."
"Fit Cher Fichter."
"Fit Elsa Fleitas."
"Fit Else Stiefel-Fleites." []
"Fit Eryn Finerty."
"Fit Fiona Affinito."
"Fit Fleta Laffitte."
"Fit Leta Lafitte."
"Fit Nina Fantini."
"Fit Osuna Faustino."
"Fit Ree Eifert."
"Fit Retta Fertitta."
"Fit Roni Fortini."
"Fit Rose Fristoe-Foister."
"Fit Sera Freitas." []
"Fit Sun Sutfin."
"Fit Torie Fioretti."
"Fittest Tit Fest."
"Flo Kim, OK Milf." []
"Fogerty's Orgy Fest."
"For Mates More Fast."
"For-Pay Pro Fay."
"Forced to Co-Ed Fort."
"Formidable, Doable, Firm!"
"Fornicate Fo['] Certain, Erotic Fan."
"Four For U."
"Foxes of Sex."
"Fred 'Bod' Bedford."
"Frisson for Sins."
"Full-Body Folly, Bud."
"Fun Fist Stuffin[']."
"Fur Boot Foot Rub."
"Gail & Ted Get Laid."
"Gail R., a Girl-Grail." [p]
"Gal Hess Has Legs."
"Galen's Angels."
"Ganymede's Edgy Manse."
"Gearless Largesse." []
"Gee! Most Get Some."
"Gen-X is Sexing."
"Get Horny Then Orgy."
"Get Lucky Ty Glueck."
"Get Physical, Sightly Pace: Ghastly Epic."
"A Ghost Has Got to Shag." []
"Gil Roth's Hot Girls."
"Gimpel's Glimpse."
"Gina, Angi, Inga."
"Girls Went Wrestling."
"Givers to TV Orgies['] Vertigos."
"Glam Slut Slam Glut."
"Glenda's Legs and Dangles."
"A Glib Bi Gal, Gail B."
"Gnomes Snog Me."
"Go at the Hottage!"
"Go in More, Geronimo."
"Go Welsh Leg Show."
"Gods [']N Dongs."
"Going-Hard Darin Hogg."
"Gonads So...Dang."
"Goo Syrup Orgy Opus." []
"Gooly-Ology." []
"Goth Les, Hot Legs: the Logs."
"Goths [']N Thongs."
"Goths Do Hot Dogs."
"Graham's Arm-Hags."
"Grand Old Lard-Dong Rand Gold."
"Grand Rude Undergrad."
"Grand Stiff Grind Staff."
"Greg, Id Digger."
"The Group-Grope Hut." []
"Grungiest Gesturing."
"Gush On, Shogun So Hung." []
"Guthrie's Urges Hit."
"Guy-a-Guay."
"The Guys Gush Yet, Ye Thugs!"
"Handy Dynah."
"Hard Long Horn, Glad."
"Hard Ol['] Harold."
"Hardon Rhonda."
"Harem for Farm Hero."
"Harem Trek: Mark There."
"Harriet's Rare Hits."
"Having a Vain Hag."
"He ACTS Chaste."
"He's SHE? Sheesh."
"Heat By the Bay."
"Hedonist: The Doins[']."
"Henri In Her." []
"Hep Market, Kept Harem Theme Park."
"Her Antics in the Cars."
"Her Ass Shares Rashes."
"Her Glad Hard Leg."
"Her Lech's Herschel."
"Her Market-Harem Trek."
"Her Next, Then Rex."
"Her Ride, Rehired."
"Her Sin Shrine."
"Herb's Wild Welsh Bird."
"Here's to Her Toes." []
"Hereto Hetero."
"Heston's Hotness."
"Het or Other." []
"Hey, Go Nut the Young!"
"Hey Punk/Yep Hunk."
"Hey, Random Horny Dame."
"Hi, Guest...It's Huge!" []
"Hi, Twins with Sin!"
"Him Wet With Me."
"His Belt's the BLISS."
"His Fate: a Fetish." []
"His Nuts Sin Thus." []
"His Trek: Risk the Skirt, Eh?"
"His Want: Ah, Twins!" []
"Hit Me I'm Het."
"Hodgson's Hoss Dong."
"Hog on, Dr. Horndog."
"Holly's Shy? LOL."
"Hooters: Hers Too, or Those!"
"Hooters Reshoot." []
"Horniest Into Hers."
"Horny Hyron."
"Horny Treat: Another Try!"
"Hos, Try Shorty."
"Hot Action Intact, Ooh!"
"A Hot Amble: Fun, Unfathomable." []
"Hot Babes Bob Hates."
"Hot Bod? Do Both."
"Hot Clones, No Clothes."
"Hot-Enuf Fun Theo."
"Hot Kent: The Knot."
"Hot Sam Thomas." []
"Hot Sin Hostin['] on This." []
"Hot Teri: The Riot."
"Hot Women Townhome."
"Hot Women's Townhomes." []
"Hot Yum Mouthy."
"Hotness Nests, HO!" []
"Hotwife of White." []
"Hotwives['] Two Hives."
"Howser's Showers."
"Huge Libido: Uh, I Obliged."
"A Humid Maid, Uh!"
"Hung Al Hulgan."
"Hung Aldo Hoaglund."
"Hung Asa Sahagun."
"Hung Brice Buchinger."
"Hung Cris Schuring."
"Hung Dave Devaughn."
"Hung Earl Laughner."
"Hung Eloy Loughney."
"Hung Leaf Hufnagel."
"Hung Otha Haughton."
"Hung Rambo Broughman."
"Hung Sid Hudgins."
"Hung Sir Rushing."
"Hung Star Straughn."
"Hung, Ungh!"
"Hunt Fo['] Hot Fun."
"Husband Had Buns!"
"Hut-Camp Matchup: Act, Hump!" []
"Hutton's Hot Nuts."
"I, a Jaunt, Tijuana."
"I Abuse Abi-Sue."
"I, Al, Ali, Lia." []
"I Allot Lolita Tail, Lo!"
"I ASL Lisa."
"I Attain Titania."
"I B Bi."
"I Bag Gabi." []
"I Can Do Donica."
"I, Dangling Ding-a-Ling."
"I Did Didi."
"I FEAST LOL." [x]
"I Flash Al Fish." []
"I-Gag-Em Maggie." []
"I, Gent, Get In!"
"I-Go-Nuts Outings."
"I Greet Gertie."
"I Gulp Up Gil."
"I Hand Dinah a Hind."
"I Leash Sheila." []
"I Loan a Loin." []
"I Love Olive." []
"I Moan, Naomi!" []
"I Must Stim U."
"I, on Sadism: Admission."
"I, Prude? Pure Id, Ride Up!"
"I Rather Hit Rear, Harriet." []
"I Re-Seed Desiree."
"I, Sassy, a Sissy."
"I Score, Cosier."
"I, Seven-Sin Eve." []
"I Shower, Showier."
"I Sizzle Lizzie's!"
"I Slam a Salami." []
"I Slam a Slim Ms. Ali." []
"I, Slim Body, My Libidos."
"I, Soul-Iced, Delicious." []
"I Take Katie." []
"I Try Basic Sybaritic!"
"I Want Tawni Twain."
"I'd Bare a Bride."
"I'd Do Dido."
"I'd Goose Doogie's Goodies."
"I'd Like to, Like, Do It."
"I'd Molested Tied Models."
"I'd Ogle Goldie!"
"I'd Ring Ingrid." []
"I'd Slag Gladis."
"I'd Spank Skip and Sad Pink Di Panks."
"I'll See Leslie." []
"I'm a Pert Primate I. E. Tramp."
"I'm a Perv-Vampire." []
"I'm a Slut: Am I Lust? A Litmus."
"I'm Easy, Yes I Am."
"I'm Fine if in Em."
"I'm on Nomi, Moni." [p] []
"I'm Queer: Requiem."
"Id Story So Dirty."
"Idle Stag Gets Laid."
"IDOL, Oil'd." []
"If I Score Orifices."
"Iffy Yiff."
"Ilana, Alain, Alina, Lanai."
"Illegal Li'l Gale."
"Ilsa, Lisa, Alis." []
"Imagine Me in Gia." []
"Imp Kneads Pink Dames." []
"Improper Ripe Romp."
"In Bed I Bend." []
"In-Sex-Temper Experiments."
"In The: Thine, Then I."
"Incented, Indecent."
"Incorporate Procreation."
"Infidelity, Tidily Fine."
"Insatiable [if player is male]Eli Bastian[else]Tina Blaise[end if]." []
"Ira, Meg, Gamier."
"Irena, Arnie, Reina, Einar."
"Irma, Rima, Mira, Amir." []
"Is Joe Josie?"
"Is Poon Poison?" []
"It's Lu! I Lust!" []
"It's ON: to Sin So Int.!"
"Jalapeno Opal-Jean."
"Jane, Lust, Last June."
"Jim's." [x]
"Jo-Beth, Hot Jeb: The Job."
"Job One: Bone Jo."
"Join in, Jo!"
"Join OJ in Joni." []
"Jon An['] Joann on Jan."
"Joni, Art, Trina, Jo." []
"Joy Nurse Journeys." []
"Just Go to Jugs."
"Kalin: [']Nilla? A Kink."
"Key Largo Royal Keg Lake Orgy."
"Kidnap Da Pink."
"Kiera, Erika, Karie."
"Kim, Seen Sin-Meek."
"King Clod, Long Dick."
"Kinkier Neikirk."
"Kinky Nikky."
"Kiss on. Sin's OK."
"Kwan's Swank Wanks."
"Kylie Likey Kiely."
"La, Cheer A Lecher."
"Lace-Top Polecat." []
"Lack Bile, Lickable Lila Beck."
"Lad Stu: LA Dust."
"Lady Love: Val Doyle, Eva Lloyd, Velda Loy."
"Lasciv-Cavils!"
"Lascivious [if player is male]Louis Savic[else]Ola Viscusi[end if]."
"Latest is Saltiest."
"Laurel's Allures."
"Lava Alva."
"Lay There Leathery."
"Le Brusque Burlesque." []
"Le Flesh: She Fell."
"Le Sin: Neil's in Les." []
"Leaner Arlene."
"Least-Coy Acolytes."
"Leave Me Lame, Eve!"
"Lecherous Soul Cheer." []
"Lee Is Elsie!"
"Leer-Reel."
"Lem Near Real Men." []
"Lenore, Loreen, Elnore." []
"Let's-Fap-Pal Fest."
"Let's Forge Glee Forts."
"Let's Hump the Lumps!"
"Lettie [']N Linette."
"Lev, as Vela's Slave." []
"Lewd Al DeWall." []
"Lewd Carl Cardwell."
"Lewd Del Weddell."
"Lewd Dora Rodewald."
"Lewd Ed Weddle-Weddle."
"Lewd Elma Madewell."
"Lewd Fine New Field."
"Lewd Gia Ladewig."
"Lewd Len Wendell."
"Lewd Lin Windell." []
"Lewd Loo Woodell." []
"Lewd Mina Wildeman."
"Lewd Mirna Wilderman." []
"Lewd Nilsa Willadsen." []
"Lewd Nina Wineland." []
"Lewd Oafs So Flawed."
"Lewd Pics, Wild Pecs!"
"Lewd Regan Greenwald." []
"Lewd Ren Wendler."
"Lewd Rina Reinwald." []
"Lewd Si Wildes."
"Lewd Sol Doswell." []
"Lewd Stan Westland."
"Lewd Tad Twaddle."
"A Lewd Weald."
"Lewdling Dwelling." []
"Lewdster Wrestled."
"Liam, Amil, Mila."
"Licentious Coitus Line."
"Licentious Cutie Loins." []
"Licentious Soul, Incite." []
"Lick, Yum, I'm Lucky!"
"Lida, LAID." []
"Lido's Soil'd."
"Like [']Em Milkee."
"Limber Mr. Lieb."
"Lisa, Mona, Also Mina."
"Lo-Girth Hot Girl."
"Lo-Hint Hot Lin Hilton."
"Loch Ness Lech Sons."
"Loin Grab Laboring."
"The LOIN Hotline." []
"Lon's Gal, All Snog."
"Lonesome Loose Men." []
"Long Asa Salonga." []
"Long Asante Santangelo." []
"Long Colin Collignon."
"Long Dan Langdon-Glandon."
"Long DeVere Groeneveld."
"Long Dom Mongold."
"Long Eatman Lamontagne."
"Long Emil Mongelli."
"Long Ferdig Goldfinger."
"Long Huey Loughney."
"Long Kiser Gilkerson." []
"Long Les Gosnell."
"Long Mario Romagnoli."
"Long Milo Mongillo." []
"Long Mitch Mcglothin."
"Long Neal Gonnella."
"Long Nick Conkling."
"Long Niles Ellingson." []
"Long Omer Longmore."
"Long Reed Delnegro."
"Long Reid Dolinger." []
"Long Scot Clogston."
"Long Weber Lowenberg."
"Long Whistler Ellingsworth."
"Long Wilber Willenborg."
"Longed-for Fond Ogler."
"Loni's Lo-Sin Loins." []
"Loose Man Salomone." []
"Looser Ol['] Rose."
"Lord O['] Drool." []
"Lorraine's Rear, Loins."
"Lothar's Harlots."
"Louchest Lech, To Us."
"Louise's Oil Uses."
"Louts O['] Lust."
"Love Fest of Svelte." []
"Love Wish: Live Show!"
"Lovebird/Devil Rob." []
"Lovesum Volumes."
"Lt. Hudson Shouldn't."
"Lucy, as Lacy, Us."
"Lure [']Im, Muriel." []
"Lurer Ruler."
"The Lust Shuttle."
"Luther Lureth." []
"Lyn, Doug, Ungodly Ol['] Gundy."
"Madelin Laid Men, Made Nil." []
"The Maid Hid Meat." []
"The Man Who Hath Women."
"Manic Ex, Nice Max, Ace Minx."
"Many, Sis, in My Ass."
"Marilyn's Manly Sir."
"Marni, Mirna, Marin." []
"Marta, Tamra, Tamar." []
"Mary, Myra, Amyr, YR MA." []
"Mary Sue Sure May."
"Masoch-Machos."
"Masseur Erasmus." []
"Masseur User Sam." []
"Massive Miss Eva: Sam Vies."
"Match-Up Hut Camp." []
"Me, Em, MeMe, Emme."
"Me, Sly, Myles, Lem, Sy."
"Mead Dame." []
"Meat Team!" []
"Meatier Emirate Emerita."
"Meg's Sin Messing."
"Mega Ass Massage." []
"Mega-Sin Enigmas."
"Mel, Try Myrtle." []
"Melinda's Name Slid." []
"Men Bag, Bang Me."
"Messier Miss Ree."
"Mick, Pry My Prick."
"Mighty Sin Smithying."
"Mild? Naw, WILD Man."
"Milf Cade Camfield."
"Milf Chun Flinchum."
"Milf Dona Manifold."
"Milf Eady Mayfield." []
"Milf Ester Flemister."
"MILF Film."
"Milf Lan Fillman."
"Milf Lore Fillmore."
"Milf Nga Flaming."
"Milf Reda Armfield."
"Milf Renae Leiferman."
"Milf Roe Filmore."
"Milf Shane Fleishman."
"A Milfy Family." []
"Milky, My Ilk."
"Mindless Sins-Meld."
"A Minx, Maxin[']."
"Miss Ex-Sexism: Mess IX."
"Miss W. Swims."
"Mister P Permits: Strip [']Em!"
"Mix'n Minx."
"Mo['] Cut to Cum."
"Mo['] Men, Cupid: Compendium."
"Mo['] Randy, Don, Mary, Mandy or Raymond--and Mory." []
"Mo['] Spurt Pro Smut."
"Moan Coherent More Than Once!" []
"Moan the Hot Name!"
"The Mod Do-Them Method."
"Modeling Goldmine."
"Modem Domme."
"Molest [']Em Lots!"
"Mona, Noam, Moan!" []
"Mona's on Sam." []
"Moni's Simon." []
"Monica's So Manic." []
"Montague's Mountages." []
"Monty, a Man-Toy."
"More-Bod Bedroom."
"More Fetish Motifs Here." []
"More Fun Run of Me." []
"Mort is So Trim, Sir Tom!" []
"Mr. Beach's Chambers." []
"Mr. Bean's Men's Bar."
"Mr. Do-Dorm."
"Mr. FUPA, Farm Up a Frump." []
"Mr. Paste Tampers: Ms. Petra."
"Mr. Pat, Tramp."
"Mr. Pube Bumper."
"Mr. Up-Rump."
"Mr. Was-Ms., Raw."
"Mrs. Male-Slammer." []
"Ms. Hypno-Nympho's."
"Must Do Mo['], Stud."
"A MVP Vamp Pam V."
"My Act in Man City: Tiny Cam."
"My Candi, Dynamic."
"My Coed Comedy."
"My Gang [']N Maggy."
"My Group Guy Romp."
"My Maid Dim May."
"My Sprees: Sperm, Yes."
"My Tits, Smitty."
"Mythical-Lay Mitch." []
"Nadine, Dianne, Dannie."
"Naiad: Nadia, Adina, Diana." []
"Nail Lain Lina."
"Nail Me, Melina an['] Emil!" []
"Nailee Elaine."
"Naked? Danke." []
"Nasdy Sandy and Sy." []
"Neat Sly Stanley Lays Ten." []
"Ned, Earl, Leander, Darlene." []
"Need-Big-Bed Inge."
"Needful Nude Elf."
"Neil, Elin, Leni."
"Nekid, Inked."
"Never Old Den Lover Don Vreel."
"Next a Tan Ex-Texan."
"Nia, Ian, Ani."
"NICEST." [x]
"Nicole's In Close." []
"Nimblest-Limb Nest."
"Nine Sub Bunnies." []
"No-Envy Yvonne."
"No Fist in Soft." []
"No, I Crave Veronica."
"No Nude Undone."
"No Parts." [x]
"No Pros." [x]
"No Rascal So Carnal."
"No-Rules Su Loren."
"No Steed Needs to Do Teens." []
"No Tail? Ol['] Tina to Nail!"
"No Tunic? Count In."
"Nom the Hot Men Then, Mo."
"Nookie OK, Eoin?"
"Nourish-Sin Hour." []
"Nu-Flix Infux: Lin ***." [x]
"Nu-Sex Nexus."
"The Nude Need Hut."
"Nude Pro Pounder."
"Nudism, Mud, Sin."
"Nudism Mundis." []
"Nun-Cad Duncan."
"Nuts, I'm in Smut, Un-Smit."
"O, a Manly Anomaly." []
"O Rears So Rare."
"O, to Cries So Erotic." []
"Obligatory Girly Taboo."
"Of Pain I Fap On."
"Oft-Bi Fit Bo." []
"Oft-Racy Factory."
"Ogle, but Beg, Lout, to Bulge."
"Oh Darn, Ron Had Da Horn, Dr. Noah." []
"Oh, I Tend Hot Enid: Hide Not."
"Oh, Mate, to Me, Ah, Meat Ho: Mo['] Heat at Home."
"Oh, Seed, He Does."
"Oh TITS It's Hot!"
"Oh, Use Sue Ho!"
"Oiled Oldie Odile."
"OK, Cis Sicko." []
"OK, Want to Wank."
"Ol['] Chef of Lech."
"Ol['] Thad's Hot Lads Had Lots."
"Old Vices: Close Vid."
"Older Slob Bordellos."
"Ole Tart Loretta."
"Oleg's Ogles." []
"On I Tug, Outing Guiton."
"On, Triad Not Arid."
"Onanism Mansion." []
"One Bang Began On, Gonna Be."
"One Bed Be Done."
"One-Dozen-Done Zone."
"One Goth Gone Hot." []
"One Limb's So Nimble."
"One Stiff Toe-Sniff." []
"Oo, Heart a Hooter!"
"Ooh, Naughty Youth Hogan."
"Or Fem for Me." []
"Or Up, Man, on a Rump."
"Or Was He a Shower?"
"Organism in Orgasm."
"Osborne's Boners, So."
"The Other Hot Three: Eh, Hotter."
"Our Sally, All Yours."
"Overland Lover Dan." []
"Overpictured Reproductive."
"Oy, Tarts So Ratty or Tasty!" []
"Pa's Got to Gasp."
"Paid Cults, Adult Pics: Cupid Last."
"Pamela's a Sample."
"The Pansy Nat Hypes Stephany."
"Paris Pairs."
"Pathics['] Hip Acts."
"Paths of Hot Faps."
"Pati or Portia." []
"Peek, Mr. Kemper."
"Peer in, I Preen."
"Peers Spree."
"Pelvic Clive P."
"Penetrations Presentation."
"Penis at Panties: a Step In." []
"Peretti's Pretties."
"Perms." [x]
"Pert Sex Experts."
"Perv Antwan Vanantwerp."
"Perv D'Angelo Vanderploeg."
"Perv Donte Devenport."
"Perv Doolan Vanderpool."
"Perv Ena Parveen."
"Perv Etta Prevatte."
"Perv Laci Percival."
"Perv Lea Peavler."
"Perv Linda Vanderlip."
"Perv Londa Vanderpol."
"Perv Lu Pulver."
"Perv Macedo Campoverde."
"Perv Maria Primavera."
"Perv Neal Penalver."
"Perv Rina VanRiper."
"Perv Sandi Pendarvis."
"Perv Tonda Davenport."
"Perv Zona Provenza."
"Pervess Vespers."
"Pervy-Vyper."
"Pete's, Um, Meetups."
"Physical Lacy Hips." []
"Pilot Sex Exploits."
"Pinafore-Open Fair."
"Pink Tush, Spunk-Hit." []
"Please! Ur-Pleasure!"
"Pleasing-Lips Gena."
"Plow Us Up Slow."
"Pluto's Po['] Slut Lost Up."
"Ply Ol['] Polly."
"Po['] Rev. Pervo."
"Pokings at Pink Togas."
"Porgy's Spry Go."
"Porn O['] NPR."
"Porno Time, Minor Poet." []
"Portia's Spa Trio." []
"Pounces on E-Cups."
"Poxes! Sex-Op Expos."
"Prattish Tartship." []
"Prey, Elated, Repeatedly."
"Prod, Be Probed."
"The Prof's Hot Prefs."
"Profanest Porn Feats."
"Prom Romp."
"Prove, O Perv!" []
"Prude Duper."
"Prude Perdu." []
"A Prude's Rude Spa." []
"Puritans a-Spurtin[']." []
"Purity's Try is Up."
"Push-All Phallus."
"Push it Up This."
"Que Sera as Queer." []
"Rab the Bather." []
"Rachel is Charlie's." []
"Rachele, Charlee, a Lecher." []
"Racier Carrie." []
"Racy Ester, Secretary."
"Racy VIP Privacy."
"Rad Boy Byroad." []
"Rad Sin Nadirs."
"The Rake: Take Her."
"Ralf on Ol['] Fran."
"Ram Up a Rump."
"Randee, Endear Needra and Ree." []
"Randier Derrian." []
"Randier Drainer Reinard." []
"Randiest-Rated Sin: Snared It! (Strained.)" []
"Randy Daryn."
"Randy Len Nylander." []
"Randy Mei DeYarmin." []
"Randy Vi Vinyard."
"Rapt Oily Play Trio."
"Rash Vice Archives." []
"Raunchier Hurricane."
"Raunchy, Unchary." []
"Raving Ole Live-Groan Loving Era (Given Oral) Gone Viral!"
"Real Big Gabriel." []
"Real Lady, All Ready."
"Real Men Learn Me." []
"Really Odd Older Lady."
"Ream Erma."
"Reaming Germain." []
"Red Anus Asunder." []
"Red Hair? Raid Her!"
"Red-Hot Dr. Theo: the Rod." []
"Red Lew, Lewder Welder."
"Red's Vice, Serviced."
"Relapse, Pleaser."
"Relishy Shirley."
"Renita, Terina, Terian." []
"Rev. Pa, a Perv."
"Rev. Pop's Perv Ops."
"Rex's Ex Xerxes."
"Rexie's Sexier Ere Six."
"Ric Glover's Cover Girls."
"Riding, I Grind." []
"Risquee Queries." []
"Rita, Tari, I, Art."
"Rob the Het Bro, or Beth? Er, Both." []
"Rogues Urge So: Go, Sure."
"Romanticised Dominatrices."
"Ron Had Da Horn." []
"The Room: More Hot." []
"Room, Walls, Low Morals."
"Rosy Ages? So Greasy Orgy Seas!"
"Rub Out: Our Tub!"
"Rude Sex Reduxes."
"Rumpf's Frumps."
"Rupert's Spurter."
"Sadist Not So Distant."
"Sailable Isabella."
"Sam Doin['] Madison." []
"Sauna-Trial Saturnalia." []
"Scamp Camps."
"Schwager's Shag Crews."
"Scorers Re-Cross."
"Scorings Crossing." []
"Screw Crews."
"Sea Babes Be As Base."
"Seamen Enemas."
"Sean's Nessa."
"A Seduction: Educations." []
"Seedier Desiree." []
"Seedin['] Sindee, Denise." []
"Seismal Melissa." []
"Select Celest."
"Sensual Unseals."
"Sergey's GEYSERS."
"The Sergio Het-Orgies."
"Serial-Fun Frauleins."
"Servin[']-Sin Rev."
"Sex Doc Sed Cox."
"Sex-in-Pools Explosions."
"Sex Life: Lee's Fix, Feel Six!"
"Sex Party Extra/Spy."
"A Sexing Hut, Exhausting." []
"Sextin[']: Next Is SIN, Tex."
"Sexual Alexus."
"Sexuality? Say, I Exult."
"Sexuality: Use Laxity." []
"Sexy Chenard Schexnayder."
"Shag Beau Seabaugh."
"Shag Breslin Hasselbring."
"Shag Brice Griesbach."
"Shag Burton Stanbrough."
"Shag Doll Godshall."
"Shag Elli Hillegas."
"Shag Ellis Hillegass."
"Shag Enid Headings." []
"Shag Gino Higgason."
"Shag Hags."
"Shag Idell Dalgleish."
"Shag Lin Singhal."
"Shag Lu Slaugh." []
"Shag McDill Schmidgall."
"Shag Mir Grisham." []
"Shag Mort Hagstrom."
"Shag Paul Alspaugh."
"Shag Reaver Hargreaves."
"Shag Ren Hargens."
"Shag Rena Sanghera." []
"Shag Rico Chargois."
"Shag Ruth Shughart."
"Shag Teri Searight."
"Shag Una Sahagun."
"Shallow Show-All." []
"Shanika, Nakisha, Kanisha." []
"Shari, Haris, Arish, Risha." []
"Sharon Has Ron or Hans." []
"She Bangs, Hans Begs."
"She Devil I Shelved!"
"She Fit Thief's Fetish." []
"She-God Hodges."
"She, to Those So Het." []
"Sherrie Re-Hires Her Sire."
"Shiftiest Fetishist: She Fits It."
"Shippish Hips." []
"Shireton: Heir Tons Horniest!"
"Shooter-Hooters." []
"Shout-Hot Su South." []
"Shy Earl Lays Her."
"Shy Elle? Hell Yes!" []
"Shy Pet Stephy."
"Shy to Bi? Oh, Sit by!"
"Siana, Anais, Asian Anisa." []
"Sickos['] Co-Kiss."
"Sicky Lu is Lucky."
"Signatory Gyrations."
"Signor Groins." []
"Sikes's Kisses."
"Silver Fox Lovers['] Fix."
"A Sin at Tania's."
"Sin Cove Novices."
"Sin-Decree Residence." []
"Sin Deed/Id Needs!"
"Sin Game Enigmas."
"Sin-Haste Shanties." []
"Sin Lady Lindsay." []
"Sin-Rent Interns."
"Sin Toy So Tiny."
"Sinful Tera Saintfleur." []
"Singlet-Tingles."
"Sir, Do Doris or Sid." []
"Sir, Flog Girls of Fir-Logs."
"Sir, Mean Reamins[']."
"Sir, to Roist." []
"Sir's Pent Spinster."
"Sis Has His Ass."
"Six Gent Sexting."
"Sixties Sex is It."
"Skeevy Eve Sky."
"Slag Gals."
"Slam by My Slab, Sam Bly."
"Slave Andra VanArsdale." []
"Slave Ben Venables."
"Slave Boy Love Bays."
"Slave Darla Valladares."
"Slave Dora Salvadore."
"Slave Gil Villegas."
"Slave Gina Gavilanes."
"Slave Lin Sanville." []
"Slave Nick VanSickle."
"Slave Olin Sevillano."
"Slave Ron Alverson." []
"Slave Son Salveson."
"Slave Stan VanTassel."
"Slave Ty Stavely."
"Slicker Lickers."
"Slithering Girthlines."
"Slow-Boff Blow-Offs."
"Slut Greta's Great Lusts."
"Sly, Bi Sibyl Lisby." []
"Smack Lips, Kiss, Clamp."
"Smackin[']-Skin Cam." []
"Smoking Ms. Konig."
"Smoldering Demon Girls."
"Smoocher Moochers."
"Smorgas-Orgasms."
"Snottily, Stony [']Til Tits Only."
"Snow White: Wow, the Sin."
"A Snuggly Guy [']N Gals."
"So, Bride is Bored."
"So Buff, Boff Us!"
"So-Lean Sloane On Sale." []
"So Leer or Else." []
"So Meaty Teams, Yo!"
"So Naked on a Desk."
"So Naked Soak Den." []
"So, Relax!" [x]
"So Steamy, Most Easy."
"So, Tim! Tom is Moist!"
"So, to Her Hooters." []
"So Wrong Snog Row." []
"Sodom Moods."
"Soil'n Olin's Loins." []
"The Son's Hotness: He's No St." []
"Sordid Droids." []
"Sore Bung Burgeons."
"Southern Hot Nurse." []
"Spandex Expands."
"Special-Lips Ace."
"Spicy Hot, Copy This!"
"Spinosa's Passions."
"Spite Wank: We Spank It." []
"Spoilt Pilots." []
"St. Geoff Gets Off."
"St. Kelli's Kiss-Tell Skillset."
"St. Lu's Lusts."
"St. Rece's Secrets."
"Stacey's Ecstasy." []
"Stay So, [a-word-u] Toy!"
"Steamier Emirates."
"Steamin['] Inmates."
"Stefania's Fantasies." []
"Stew & Del: Lewdest."
"Stick, Eat: Tits, Cake!"
"A Stiffy Sat Iffy."
"Stiger's Tigress."
"Stingy Tyings."
"Strained Randiest Red Satin." []
"Strip Club Clip Burst."
"Strip Club Pic Blurts." []
"Studlier, Luridest." []
"Stuff-My-Muff Sty."
"Stuprate, Upstater."
"Su Tait Is Taut!"
"Succeed to Cot-Seduce Cute Coeds."
"Such Neat Unchaste Nut-Aches."
"Suctioned Seduction is Counted!"
"Sue's Path Up the [a-word-u]."
"Sure, Go, Go, Gorgeous!" []
"Surge, Urges!" []
"Swag, Eh? We Shag."
"Sweet Bi Website."
"Sweeties is Wet, See."
"Sweetness, Wetnesses."
"Swingers['] Sins Grew."
"Switcheroo: Erotic Show." []
"Sy Ain't Stayin['] Sainty."
"Sybian Bayins[']!"
"A T-Shirt, Tartish."
"Taboos: a Boost[r]."
"Tad, Rex: X-Rated."
"Taint-So Station." []
"Tally-Ho, at Holly!"
"Tamer Tabus, Smart Beaut."
"Tan Bod: Not Bad."
"Tania, Anita, Tiana an['] Tia."
"Tara's a STAR!"
"Tart Sin Startin[']."
"Tartish, Athirst!"
"A Tarty Show: What a Story." []
"Taste of Fat Toes."
"A Tasty Stay at Tatya's."
"Tayra's Astray." []
"Team Duo Made Out."
"A Tease At Ease."
"Tease Pro Operates."
"Teaser Teresa." []
"Technical's Lech Antics."
"Teen Burt's Brunettes."
"A Ten-Girl Tanglier Triangle."
"Ten-Inch Chet Nin."
"Testes Sestet."
"Tex Cass: Sex Acts."
"Tex Ho's Hot Sex."
"Tex's Sext."
"That Romp, Hot Tramp."
"Their Son, Horniest."
"Then More Other Men."
"There's Ma, Her Mate's Harem-Set."
"They Win Whitney." []
"Thigh, [a-word-u]: Shag This."
"This Boy Shy to Bi." []
"This Load is Hot, Lad!"
"This Rat a Thirst: Tits, Rah." []
"Thorough, Rough, Hot."
"Those Kids Kissed Hot."
"Threads['] Dearths."
"Thunderin['], Nuder, Thin."
"Ticklish, Lick This."
"Tickly Kit Cly."
"Tiffy's Stiffy."
"Tiger Gerti."
"Tijuana Juanita." []
"Tina, Naomi, Tonia, Mina, Iona, Minta: Mania into Animation!"
"Tisha HAS it." []
"To Bang Bo Gant."
"To-Do: Hug Hot Doug."
"To Flus of Lust!"
"To Have Hot Eva."
"To Invade Into Dave." []
"To Sandy: Do Nasty." []
"To Siring So Tiring."
"To Slurp, Pro-Lust."
"To Slurps, Lust Pros."
"To Want No Twat." []
"Tomboys, Boots, MY!"
"Toned Mr. Redmont."
"Tongues Get on Us."
"Tony, Cal, Clayton." []
"Tony is So Tiny." []
"Too-Lurid Loud Trio."
"Too Sick For Crook So Fit."
"Top Live Love Pit."
"Tori's Trios." []
"Torn, Nude, Turned On." []
"Torrid Dorrit."
"Touched Coed Hut Tech Duo."
"The Town Went Hot."
"Toy, Lust Stoutly!"
"Trainable Albertina."
"Trampy Try, Pam."
"Treat Us, Tart Sue."
"Tree Homes Threesome."
"Trim-Id Dmitri."
"Trouser Rouster Su Torre."
"Trouser Routers." []
"Trouser Tourers!"
"True Bent Brunette."
"True Ladies['] Real Duties."
"True Lady Adultery."
"True Moms: More Smut."
"Truster of Frotteurs."
"Try, Bone, Rent Boy!"
"Try Me Yet, Mr.?"
"Try Pam, My Prat--Trampy." []
"A Tryst: Whoa, What a Story." []
"Tut, Sly." [x]
"Twerk-On Network."
"Twin Peaks Spite Wank: Pew, a Stink." []
"The Two: Hot, Wet."
"Ty, Bo, Toby."
"U Crave a Curve."
"Ugly Cats, Cagy Lust."
"Uh, Soothe, Hothouse!"
"UK Bekka." [x]
"Um, Hot Mouth."
"Umm, Pry My Rump."
"Un-Torn Turn-On."
"Uncensored Nude Crones." []
"Unclean Lace Nun." []
"Undress-Sunders."
"Undressing, Sunderings."
"Ungarbed Brundage."
"Ungodliest Longitudes."
"Uniforms Firm on Us!"
"Unready Nude Ray." []
"Unrobed Bounder Ed Bruno." []
"Unrobed Bounder Nude Rob." []
"Untidy." [x]
"Up-North Porn Hut. Turn! Hop!"
"Upland Orgy Playground." []
"Urges O['] Rogues." []
"Us an['] Una's Anus."
"Us-Gay Guays."
"Use-QT Quest."
"Use Sue."
"Valery's Slavery."
"Vast Ogle: Slave Got Voltages."
"Vast Ripe Privates."
"Venial Elvina LaVine." []
"Verboten Bent Over Bro Event."
"The Vicar's Craves Hit."
"Vices Are a Service."
"Villagers['] Slave Girl."
"Virgin Irving."
"Voyeurs? Us? O Very."
"Waitress Wastries."
"Wanton Antwon."
"Washing His Wang."
"Watch? Aw, Tch."
"Watkins Wanks It." []
"Wax Event: Next Wave!"
"We Fit if Wet."
"Wee Nik's Sin Week."
"Well Done, Lewd Leon!"
"Wendie's Sinewed."
"Wes Cort: Two Recs to Screw."
"Wet Porn Went Pro." []
"Wet Sins['] Witness." []
"WHEE! Pop's Peep Show!"
"When Folks Know Flesh."
"Whip, Cute? Up, We Itch."
"Wideman's New Maids."
"A Wife? I, a Few!"
"Wild Boy, Wily Bod."
"Wild Set: it's Lewd!" []
"Witness Sin Stew." []
"Witness Stew Sin." []
"Women Do Woodmen: Demo Now!"
"Won't Sid Do Twins?" []
"Worship or Whips."
"X-Rated Rad Tex." []
"Xena, an Ex."
"XTC Seas Sex Acts."
"Yasmin May Sin."
"Yay Wants Way Nasty."
"Yes, Jon Enjoys Jonesy."
"Yes, Tom, My Toes."
"Yet Ma's Steamy." []
"Yet Risk Kirstey: Ike's Try."
"Yo, Doms, Sodomy." []
"You Doll, You'll Do."
"You Pervs So Very Up."
"Yr Slut, Sultry, Yr Lust."
"Yum-Lass Asylums."
"Yum, Pass Up My Ass."

table of store c ads [xxs4]
blurb
"Ace Sin As Nice!"
"Adults only! On, Lady Lust!"
"Bobo's advertises here." [x]
"Bud, a cheery debauchery!" [x]
"Burma Station advertises here." [x]
"BYO BOY has a line through it. Good they have SOME morals." [x]
"Crotches['] Crochets are sold here." [x]
"Dancy Candy advertises here." [x]
"Date/time for an evident id event." [x]
"David's VD Aids!"
"A discount on a Tingles Singlet." [x]
"A document that would turn your settler PGRYRYGP makes you blush." [x]
"An Erotic Creation." [x]
"Everbond lube is on sale." [x]
"Hef-T-Sins Fishnets are this season's hot item." [x]
"'Helpin['] you deuces seduce!'" [x]
"Jeff Kors and Geoff T have given this place their personal porn seal."
"Kim Rosen: Smokin-er! More Skin!" [x]
"LEGALIZE HERB LOTS, a sign reads." [x]
"Lipsopolis: Oops, I Spill!"
"A lurid URL ID."
"Mad Dog's Odd Mags."
"Margo's."
"The Mod Method is the latest 'literature.'" [p] [x]
"No coital location? Clan I-Too! Lo, action!"
"No-Saint Nations are apparently a support groups for the Onanist." [x]
"'No SHOWER here. Don't ask.'" [x]
"Oh, darn! Throb-Broth, debonair boner aid, sold here." [x]
"Oh dear. Not a legit ad. 'Get L...'? Whoah." [x]
"Old IDs are sold here. Huh?" [x]
"Onan-Anon leaflets. All with anno. Bleah." [x]
"A personal porn sale." [x]
"Porn We Preown: Adult Epics['] duplicates." [x]
"PORNOG = NO PROG is spray-painted in a corner." [x]
"Racy Lit: Clarity!"
"Riesgo-Ogier's Orgies." [x]
"Smoking Kim Song and Illegal Li'l Gale have shopped here." [x]
"Spiciest Pics Site."
"Splitman Implants sold here!" [x]
"Steamy Mateys may set." [x]
"A strumpet trumpets all-babes baseball." [x]
"They don't discriminate: nudies or undies." [x]
"Tommy's Mm-toys: dirty I'd try." [x]
"Um, mopier? Mo['] Impure Emporium." [x]
"Vandalism! HERPES PHEERS SPHERE defaces part of Store C."
"Vandalism! HIDEOUS ID-HOUSE defaces part of Store C."
"Wares from Bad John's." [x]
"Whoopie's Whoopsie: Bondage Gone Bad."
"You briefly wonder if you'll find sapient panties in there that might give a hint, then you feel kinda guilty." [x]
"You overhear 'Preview.' / 'Ew, I... perv!'" [x]
"You see a warning: Loot Porn? Poltroon!" [x]
"You see striptease tapestries and are sorry you did." [x]
"You think you hear 'You perv, voyeur :p' but notice the nice moot emoticon." [p] [x]

table of store c competitors [xxs5]
blurb
"Agony Thus So Naughty"
"ArtCo IE Erotica" []
"At Sty Tasty"
"Bad-for-My-Body Farm"
"Brassiere Brasserie"
"Bub's, Err, Rubbers"
"Bulkiest Lube Kits"
"Bulls['] Ease Lube Sales"
"Claypoole Yolo Place" []
"Clean Bums: a Men's Club"
"Colin's Sin Loc"
"Condom-Up Compound"
"Coxe's SexCo"
"Coy Kat's So-Tacky Toy Sack"
"Crisper, Err, Pics"
"Custom SmutCo" []
"Dennis [']N Enid's Sin Den"
"Deviances an['] Devices"
"Dickens Sin Deck"
"Discreet Ted Rice's"
"Dives O['] Videos So Vied" []
"Eastern-Port Penetrators"
"Ecstasy-Case Sty"
"An Edgy Gay Den"
"Epic Coeds['] Codpieces (Eco-Spiced)"
"EZ-Sin Zines"
"Feralised Elfrieda's"
"Fremont Men Fort" []
"Fun Stock, [f-w] Tons"
"Fun Times Fine Smut"
"Gibson Sin Bog" []
"Gonnella Nonlegal-Long Lane" []
"Got Hedonism: Do Something"
"Gotham's Hot Mags"
"Hamer's Harems"
"Havelock's Love Shack"
"Hedonism-Cad Odd Machines"
"Hef-T-Sins Fishnets"
"Holbert's Brothels"
"Honedist Hedonist" []
"Hot Pets: the Spot" []
"Hot Spicy City Shop."
"I-Is-Bold Libidos" []
"I-Leering Lingerie"
"I'm-In-U Condom Condominium"
"In-Haste Hentais" []
"India's Sin-Aid"
"Insertable Albertine's"
"Karin's Sin Ark" []
"Kendrick's Kink-Creds"
"Kink Cubs['] Buckskin"
"Klondike Kink Lode"
"L'Harem Harlem"
"Leathers: a Shelter"
"Let's Play: All Types" []
"Lipsopolis"
"Lo, Binge on Bilge" []
"Lube Sacks: Bulk Cases"
"The Lurid Idler Hut"
"Maher-Ahmer Harem" []
"Maiden Median" []
"Mart Chen's Charm-Nest Merchants" []
"Martin's Sin-Mart"
"Massively Slimy Eva's"
"McSnood Condoms"
"Mo['] Sick Mick-O's"
"Moist Tomi's" []
"Moister Mortie's" []
"Moody's Sodomy" []
"Mortal-Sin Loins-Mart"
"Naomi's Maison" []
"Nas-T Nat's"
"Nastier Renita's" []
"Nasty Tyna's" []
"Nik-Nik's Sin-Kink"
"Nikki's is Kink"
"No-Maid Domain" []
"No-Rules Ron Lue's" []
"North Pole Porn Hotel"
"Obscener Cerbone's"
"Oft-Sucky [f-w]-Toys"
"Old Evia's Love Aids"
"Our Types['] SuperToy" []
"Pat's Lucid Adult Pics" []
"Paternoster Penetrators" []
"Patrick's Trick Spa"
"Pay-Lots Top Lays"
"Penni's Penis [']N Sin Pen"
"Pert Erv's" [x]
"Perversion Prior Seven"
"Perversions-Preen Visors"
"Phallic Pic Hall." []
"Pleasure's Super Sale"
"Po['] Ron's Pornos"
"Pop Hay's So-Happy Pay Shop"
"Princeton's Nicest Porn"
"Priscilla's Clips Lairs"
"Pro-Stim Imports" []
"Regal Io's Seraglio"
"Relapse-Us Pleasures" []
"Ringo's Groins-Sin Org" []
"Riskiest Kirstie's"
"Risque Squire"
"Roof Sty for Toys"
"Rox Estes Sex Store"
"RudeCorp's Producers."
"Salty Tyla's"
"Satoya's: To Assay at Yo['] Ass"
"Schroader Hardcores"
"Seider's Desires"
"Self-Toys of Styles"
"Sensorial Rosaline's" []
"Serene Renee's"
"Shockvale Love Shack" []
"Sicker Erick's"
"Silk, Boots, Bliss Took"
"Simulated Ideal Smut"
"Sin Bay's Sybians"
"Sin-Forum Uniforms"
"Sin Hog Honig's" []
"Sin-Sprayed Dispensary"
"Sinner Erinn's"
"Siren Erin's."
"Sizlin['] Linzi's"
"Skee-Z-Zeke's"
"Slattern Lattner's"
"Smooch-Art Chat Rooms"
"Smut-Offer-Fest Forum"
"So Dirty Toy Dirs."
"So Sticky Sick Toys"
"So-Tacky Toy Sack" []
"Sultry URL Sty" []
"Super Deal, Pleasured"
"Swinger Gerwin's"
"Sybian Sin Bay"
"Tarquin's Sin Quart"
"Tartest Tatters"
"Tips-On-Top-Sin Stop-In" []
"To Rude Detour D'Outre" []
"Tokyo's OK Toys"
"Toll-Free Leer Loft"
"Tom-Boy's Boom Sty, by Smoot" []
"Tom's Patient Temptations"
"Trashier Harriet's" []
"Tuppence **** Peep" [x]
"Unchaste Ace Hunt's" []
"Unspeakable Anal Peek Bus"
"Urge-Toys Rogue Sty"
"Us-Be-Sins Business"
"Val's Dope Love Pads"
"Vic Ree's, Er, Vices Service" []
"Vices an['] Sin Cave" []
"We-So-Dirty Weird Toys"
"Weygandt's Edgy Wants"
"Ye Slim Smiley Emily's"
"Yes Bux Buy Sex"
"Your Lit: Further Rule Thirty-Four"

table of tokers nonsense [xxs6]
blurb
"'[n-t] Tokes. Take notes,' says [if nestor is touchable]Nestor[else]one of them[end if], and his pals all giggle." [x]
"'The A-Ok Toke! Ah!'"
"'Ah, post: Host Pa has pot so phat!'" []
"'Any pot? Pay not!' they tempt you, but things are mind-bending enough." [x]
"Aw, sock? So wack!"
"'Bad-Poey Peabody be a dopy...'" []
"'Bake crew, we're back!'" []
"'Bake mud, make bud. BAM, Duke!'"
"'Bake some, Kemo Sabe!'"
"'Bakins['] ... baskin[']...'"
"'Bask there: Herbs take the breaks!' they say, channeling Herb Keats." [x]
"'Be a dork--or baked!' / 'OK, Debra.'"
"'BE! Chase cheeba's beaches!'"
"'Be stoned: bested? No!'"
"'Beg-a-thon? Bong heat!'"
"A belch. A 'Blech.'"
"'Big Deals Ads? Bilge!'"
"'Bogart? Go, brat!'"
"'Bong hit, Ox?' / 'Hotboxing!'"
"Bong hits. Both sing."
"'Bong, yes? Bygones!'"
"'The bong's bent? Gosh!'"
"'Bum, do mo['] bud!'"
"'The Club's THC Blues belt SUCH.'"
"'The colors! Hot! Closer!'"
"'Cop, toke! Pot! Coke!' they chant." [x]
"'Dang wild dawdling!' they laugh, waddling some." [x]
"'Dat hemp's phat meds!'"
"'Daub a bud!'"
"'Dime bags? Mega dibs!'"
"'Do?' / 'Eh, OK.' / 'Hooked!'"
"'The dope: deep, hot!'"
"Dreamy recollections of Mac's Herb Chambers." [x]
"'Drug use urged us,' they smirk." [x]
"'Dual bong, loud bang!'"
"'Ed, Wes! Seed w/ weeds!'"
"'Eh, Pip, I...' / 'Hi! Pipe, hippie!'"
"'For Ed is so fried!'" []
"'Frantic narc fit!' someone yells, giggling." [x]
"'Get dope: top edge!'"
"'Gets baked? Beats keg'd!'"
"'Go-ban-a-bong Bogan? No, bag!'"
"'God is SO, dig?'"
"'God Runs on Drugs!!!'"
"'Good point! I'd go on pot.'"
"'Got tensed? Get stoned!'"
"'Hash shah?!' Ahhs."
"'Help me, le hemp!'"
"'Hemp Ace MacPhee came hep! Cheap, me?'" []
"'Hemp! Dust the dumps!'"
"'Hemp is hep, Sim!' / 'I'm SHEP!'"
"'Hey, bros! Yo! Herbs by shore!'"
"'Hi, Neal. Inhale? Healin[']!'"
"'High? Us? HUGH is...'"
"'Hip med, hemp? I'd dip, hem!'"
"'HIS pot? Po['] [s-w]! To pish!'" []
"'Hog his high, so? Shh! I go!'"
"'Hog it, ho!' / 'Too high.'"
"'Hog it? Oh, too high!'"
"'Hop to pot, ho!'" []
"'Hot [']n big bong hit!'"
"'Hotbox?' / 'Thx, Boo!'"
"'I met TIME!'"
"'I'm baked!' / 'Bad, Mike!'"
"'If pure, fire up!'"
"'The imps['] mesh pit: it's hemp!'"
"'Items, Don.' / 'Send Tom. I--I'm stoned!'"
"'Join at a joint!'"
"'Joint, Al? JAIL!!!! NOT!'"
"'Junkies juke sin!'"
"'Le bong! Belong!'"
"'Lo! Binge! I belong!'" []
"'Lot-of-Weed Fleetwood? Tweed fool!'"
"'Make out, um, a toke...'"
"'Many cop company, man! Copy?' / 'No. Campy.'"
"'Me, I'd... Medi-dime!'"
"'Me's took mo['] tokes to smoke!'"
"'Men, fail life, man! Inflame!'"
"'Mo['] Herb, Hombre!'"
"'Mo['] Stash to Smash!'" []
"'Mo['] takes at smoke? ASK me to!'"
"'Monged? God, men! Go mend!'"
"A moony 'Yo, mon.'"
"Music by Droning Grondin plays." [x]
"'My poem: mm, poey!'"
"'Narco-acorn?' ... 'AN ORC!'"
"'No highs? Sigh, hon.'"
"'No weed now, dee? We done!'"
"'O Drug Gourd Ur-God!'"
"'O phat pot, ah!'"
"'O yep! Poey!'"
"'Oblong ol['] bong!'" []
"'Oh Petey, the poey poet, hey!'"
"'OK, Poets spoke to toke-ops!'"
"'OK, set, stoke!'"
"'OK! Ted toked!'"
"One of them wakes up. 'Eh, P.M.? HEMP!'" [x]
"'Our lucid is RIDICULOUS!' one toker yells." [x]
"'Pass not sans pot!'"
"'The pipe, Pete? Hip!'"
"'Poey's POESY!'"
"'Pot deal to plead, tadpole,' they sing the blues." [x]
"'Pot fair? A profit!'" []
"'Pot has paths o['] PATHOS!' / 'Ha, stop!'" []
"'Pot's Tops.' / 'STOP!' they giggle." [x]
"'Pot...slow...lots...POW!'"
"'PROUD TO DROP OUT!' the tokers chant in unison." [x]
"'Raw pot? Aw, [i]trop[r] to warp.'"
"'Ref-Poet Peter? Of Free Pot Reef Top?'"
"'Resist puff? Super stiff!'"
"'Rex! To re-tox!'"
"'Seek Job? Be jokes!'"
"'Seek out toke use!'"
"'Share it! HASTIER!'" []
"'Sick THC Schtick!'"
"'Sit. Bong.' / 'Big?' / 'Tons!'"
"'Skateboard?' / 'Sorta baked.'"
"'Snort coke? Scorn! TOKE!'"
"'So baked.' / 'O-K.' / 'BE sad.'"
"'So, make a smoke?' / 'O, ask [']em!'"
"'So, tend to dens stoned!'"
"Some tokers recall Bong-Ade gone bad." [x]
"A song: 'I sort dung. It's ground into drugs: tin gourds!'" [x]
"'Squad to do Squat!' they giggle." [x]
"'Stoner man ornaments? Neon? Smart!'"
"'Stoner so rent!' one of the tokers overacts." [x]
"'Such poey! Chop suey!' Yups echo."
"'SunFit: it's fun!' / 'If NUTS!'" []
"'Take-home toke, me? Ha!'" []
"'Ten-high night, eh?'"
"They jock the THC MD Si Schmidt." [x]
"They lecture that mescal-pot-ectoplasm has ample cost--you clamp toes then come splat." [x]
"They perform a skit on St. Niko Kitson." [x]
"They recap [i]Em's Took to Smoke[r], a particularly bad/good movie."
"They recap the PSA-turned-camp [i]Wickedest Weed Stick[r]." [x]
"They recount the plot of the cult 'classic' [i]Ken's Weed Weekends[r]." [x]
"'To bangs at bongs!'" []
"'To takes at tokes: OK, taste!'"
"'Toke, Jake! Take joke!'"
"'Toke up to puke.'"
"The tokers dance a rebels['] BS reel for a bit, then settle down." [x]
"The tokers discuss [i]Postmodern Stoned Romp[r], by Red Tompson." [x]
"The tokers dream of ESP-word powders." [x]
"The tokers have a mid-store idea storm." [x]
"The tokers have a moment of silence for Hotboxer Rex Booth before whooping his cry 'Oh, bro Tex!'" [x]
"The tokers joke 'Mo['] grass? Gross, ma!' You groan when you see the 'subtlety.'" [p] [x]
"The tokers mention they want to read [i]Hemp Chat: the Champ[r], by [if player is male]Chet Pham[else]Pam Hecht[end if]." [x]
"The tokers pan [i]The Jock's Chest O'J/K[r]. Not real THC jokes!" [p] [x]
"The tokers pan the book [i]LSD Trips: TLDR Piss[r]." [x]
"The tokers pooh-pooh eyespot peyotes." [x]
"The tokers quote the latest issue of [i]Sedition Editions[r], by [if player is male]Sid Nieto[else]Enid Tsoi[end if]." [x]
"The tokers recall a hot drug drought." [x]
"The tokers recap [r]Toke Hobby By the Book[r], by Hotkey Bob." [x]
"The tokers recap the plot of [i]The Scamp Hemp Cats[r]." [x]
"The tokers recite from the canon of Bad-Joke Baked Jo." [x]
"The tokers sing [i]Dime Bag Mega Bid[r] by Dim Gabe." [p] [x]
"The tokers sing [i]Heed Pot, the Dope[r] by [d-t] Heep. Hot! Deep!"
"The tokers sing [i]Hip Tune up in the Pine Hut.[r]" [x]
"The tokers sing [i]The Wide Weed Hit With Dee.[r]" [x]
"The tokers sing [i]We ain't at Wine[r] by [if player is male]Nat Wie[else]Tia Wen[end if]." [p] [x]
"The tokers sing tha dope phat ode [i]Oh Adept Pothead[r] by Tad Hope, Dah Poet." [x]
"Tokes, Smack, Smokestack!"
"'Tokin[']? No kit?'"
"'Tom! Repo more pot! Promote!'"
"'Torch [']em! More THC!'"
"'A trance can rate!' / 'Rant, Ace!'"
"'Uh, gone enough?'"
"'Um, no THC?' / 'Not much.'"
"'Umm! Ripe! Premium!'"
"'Up, aces, to space out! [']Cause pot...'"
"'Warm-toke teamwork!'" []
"'We smoke, mo['] weeks!'"
"'Weed is Wise, Ed!'"
"'Yo, bake, be okay!'"
"'Yo, Hemp My Hope.'"

book routes

table of horbert farewells [xxu1]
blurb
"'Arch woes? Show care. Reach. Sow.'" []
"'Bud, lack bad luck.'"
"'Consult No Cults.'"
"'A credo: do care!'"
"'Cure cads accursed!'"
"'Disperse no depression.'" []
"'Do no harm: MAD honor!'"
"'Edify! Deify!'"
"'Faith in God? Fight no aid! Oh, fading, it!'"
"'Follow truth to full worth.'"
"'Go. Do Good.'"
"'Go! Our cause, courageous.'"
"'Go! Serenity! Generosity!'"
"'Go, tread, do great.'"
"'Go up the gut. Hope.'"
"'Goal: hit Goliath.'" []
"'Goodbye. Obey God.'" []
"'Heal envy? Heavenly!'" []
"'I put love up to evil.'"
"'On the run, hurt none.'"
"'Pace woes, sow peace.'"
"'Peace, yo! Yea, cope.'"
"'Piety. I type. Yep, it...'"
"'Pitiful? I uplift.'"
"'Plights? Dear, spread light!'"
"'Postpone not Popes.'"
"'Pray less sparsely.'"
"'Rate Evil, reveal it, avert lie...relative.'"
"'Reach out! Care, thou!'" []
"'A rec: care!'"
"'Roll! Stop troll-ops!'"
"'Run to God! Good turn!'"
"'See church. Such cheer!'"
"'Seek holy keyholes.'"
"'Seekin['] is keen.'"
"'Show faith! Ah, wish oft!'"
"'Showing wings, oh!'"
"'So, go send goodness!'"
"'Stem venom movements.'"
"'To-do: big good bit.'"
"'True pays. Stay pure!'"
"'Walk soft: flow, task.'"
"'Yea, trust, stay true.'"

table of horbert musings [xxu2]
blurb
"aching pre-preaching? Change. Rip. Recap nigh."
"ah, yon, Mr. A hymn or harmony." []
"Aid Ida, Adi..."
"and sellin['], all sinned."
"anecdote, sir: decorate sin, acridest one? Noise! Redact!" []
"angry? Wow, wrong way."
"antidote...donate it."
"argument? Nag [']em? Rut." []
"Ave Eva."
"avenge it? Negative. Get naive. Give neat even gait."
"award show? How sad, raw..."
"Baal? Blaa!"
"banters be rants." []
"Be set, St. Bee."
"best mode: be modest."
"a bilk? I balk..."
"a bliss-gen blessing."
"bring down? Bind? Wrong."
"buried fresh, hubris freed, refurbished!"
"burn ego, burgeon." []
"cash-only cans: holy? Ach, no, sly."
"cash, souls... such a loss."
"cattiness? Scantiest."
"chartless? St. Charles."
"clans weep: new places, clean pews."
"Cure Dan Durance...uncared..."
"Cyan nun? Uncanny."
"Dave's saved!"
"dawn, faith: what a find!"
"death is staid, eh?" []
"desiring's rigidness."
"dodge a goaded ego-add."
"doings in God's song I'd sing. Do dig, son!"
"Donatism...saintdom."
"eclat? Pique? Quiet place."
"Ego, eh? Oh, gee..."
"ego, lust: let us go. Get soul."
"ego? Oy, gooey."
"Ego rut? Get our urge to go true."
"ego tilt? Legit to let it go."
"egotism? Lo, gloomiest."
"enemies seen: I, me!"
"er, tens resent St. Rene." []
"erotica...to I CARE." []
"famished, made fish."
"Fish at Faiths? Ah, fits." []
"Forgiveness: serving foes. Sin fevers go."
"Gad, mo['] Dogma? Go mad."
"gaslight gigs? Halt!"
"get meaner?! AGREEMENT." []
"get rid of ego. Drift." []
"get vicious? Scout, I give."
"givin['] ... invig..."
"glorified if godlier."
"Goad a god? O gad!"
"the goal's hog least."
"God's nice. Cognised. Co-signed."
"good heart: greathood." []
"got snared? Strand ego."
"Goy Doug...good guy..."
"grow venom? Wrong move."
"gutsy St. Guy..."
"halt a vile have-it-all hate villa..."
"halt stark trash talk."
"halt weapons? How pleasant!"
"happiness is. Happens."
"a harm-not marathon..."
"hatred: apt? Death trap." []
"hatred: in the drain."
"Havins['] vanish." []
"Holiness shines, lo."
"Holy grail? Hail glory."
"hymn idea in my head...many hide..."
"I act pure: a picture?"
"I confer in force for nice."
"I fathom mo['] faith."
"I, man unto mountain." []
"I start it. Rats, St. Rita is tart." []
"I'll stay on saintly, lo."
"I'm lost, St. Milo." []
"I've got to give."
"id, ego, go die."
"id rose, or dies, so dire."
"if proud, up! Rid of..."
"in sum, minus, um, sin..."
"Inept? Beat? Be patient." []
"is soul nil? Illusions."
"It's noon. To no-sin notions!"
"its name is meant...tame sin." []
"Justice, St. Juice."
"kind toll: don't kill."
"Kingdoms dig monks."
"Lamzor moralz."
"less of self, so."
"less rage. LARGESSE." []
"Let Sin Enlist? SILENT!" []
"let us care? Ace result."
"Let's go, St. Oleg."
"life's short? Selfish rot."
"loathsome tool, shame."
"love war? Lo, waver."
"lustin, d'oh! I shouldn't." []
"mad ire? Dim era." []
"make use of famous? Eek."
"man, sense meanness."
"'Me, sir:' mires."
"melee pits? Sleep time."
"mend soul un-seldom."
"mindfulness mends sinful."
"monthly Holy Mtn. hymn-lot..." [p]
"my arisen seminary an['] misery."
"my BONES. Money? BS." []
"my rec: mercy!"
"narcissism: man's crisis."
"Nazareth? Ah, art, zen."
"Nun bio...gave me a bunion." [x]
"O Kevin, invoke: vein OK, vine OK."
"O, St. Nina anoints nations." []
"O, venom, move on."
"Oh, Tither Hitherto."
"oh, Torah's too harsh." []
"oh, whisper is power."
"old low want? Don't wallow."
"one itch: the coin? No ethic."
"Or sin? No, sir!" []
"ordering? Err, doing."
"pilpul, li'l pup."
"presently sly? Repent."
"...prevents ten pervs."
"pride? He's perished!"
"Pride: I derp." []
"Puff-outs put us off."
"Pure's super."
"Rabbi Barbi..."
"rats fit...at first."
"Raw monk, mark now. Work, man." []
"regroup, go purer! Up! Roger!"
"The remorse...there's more."
"Rev. Ho's Shrove Hovers."
"Rev. Stan, servant, St. Verna."
"Rev. Triton's introverts..."
"rot! Pay to pray? Trap, oy." []
"routines orient us, rise unto us, tonier." [x]
"rue, grief, rife urge: refigure."
"safety, St. Faye." []
"Sanitary Saint Ray: a strayin[']?"
"Sanity, any, [']tis sainty." []
"seclusion, close us in."
"see glint, gentiles!"
"See real release." []
"a sermon enamors moaners." []
"Simply my slip..." []
"Sin at Insta-Saint Satin Tina's... it's an..." []
"sin, hatred: it hardens, tarnished." []
"sins['] fear? Fairness sans fire."
"So, in my...I'm nosy...simony is on. My!"
"so it goes. I toss ego."
"soft Ol['] St. Olof..." []
"Soul Pit? Slip out. Pilot us."
"spenders['] derpness..."
"St. Alex exalts..."
"St. Aric... St. Leo... so imperfect." [x]
"St. Audrey: rudest, ay."
"St. Candice ... accidents desiccant..." [x]
"St. Elmo lost me..." []
"St. Kerin, stinker? Ten irks." []
"St. Kira, Tark is At-Risk."
"St. Linus insults..." []
"St. Lip-Split IS. PTL."
"St. Martin, transmit tantrism." []
"St. Prius Stirs Up Purists. It spurs..."
"St. Tony? Snotty." []
"Stern Rents, St. Ren." []
"Stu? Jed? St. Jude? Just Ed."
"stuff by St. Buffy."
"Sustain us, Saint Sanitus!" [x]
"Thanks, St. Hank!"
"theologian? Healing, too."
"to be like Rev. Figo, Giver of Org Five."
"to prey? Rot. Yep."
"To sin is not on, is't?" []
"to undergo a good nature: outraged? No!" []
"trite, posy posterity rots piety."
"truce cruet... he doesn't eruct." [x]
"Ug. Some egos. Um."
"uh, I lit my humility."
"untruths stun, hurt."
"Up, I try purity."
"A vicar? Caviar?"
"Virtues rivet us."
"vulgarities['] guilt varies."
"waive sly evil ways."
"wannabe? Naw, bane." []
"warring? Oh, harrowing."
"weaponry? No, we pray."
"wish elite? White lies."
"work at it: ok, art, wit."
"worthy? Why rot?" []
"you hate? Yeah, out!" []
"zap ire: a prize!"
"zen: fry frenzy."

table of mantle laments [xxu3]
blurb
"ABET?! BEAT"
"ABNORMAL BAN = MORAL" []
"ADS KILL ALL KIDS"
"ADULTERY? TRY A DUEL"
"AFOS = OAFS"
"AH, VOWIN[']? HOW VAIN"
"ALLURIN[']: RUIN ALL"
"ALOHA, OL['] OOH-LA-LA"
"ANIMIST? YO, ANIMOSITY"
"ANTI-PROGRESS? PRISON'S GREAT"
"ANY DOUBT? BANDY OUT"
"APHORISMS NET MISANTHROPES"
"ARTFUL, YOU? YOUR FAULT"
"ASK NO KOANS"
"ASPIRANT ANTI-RAPS PARTISAN, RIP SATAN" []
"ATHEISM'S MASHIEST"
"AY, LAWS ALWAYS" []
"BAD: DO IT A BIT ODD"
"BAKINGS BASKING? BAG, SKIN"
"BAN LOONEY? NO BALONEY"
"BANG-O! GO BAN A BONG" []
"BASSLINE, LESBIANS = SIN, BALES" []
"BAWDINESS IS BAD NEWS"
"BE CARING? NICE BRAG" []
"BE DECENT: BENT, CEDE"
"A BE-IN? I? BANE"
"BE-INS/IBSEN BE SIN"
"BE LIT? I BELT"
"BE MINDLESS? SEEMS BLIND" []
"BEATLES BE STALE"
"BEER, CADS? BE SCARED"
"A BEER DELUGE? A BLUE DEGREE? BREED LEAGUE? BELEAGUERED"
"BEER? VILE, BELIEVER"
"BEERS? CAD, BE SCARED"
"BEN-WA? EW! BAN"
"BILLIARDS? RABID ILLS"
"BIT TRUE TRIBUTE? REBUT IT" []
"BLOW UP, LOW PUB"
"BLUNDER-LED? BURN" []
"BONA FIDE? NO? BAD, FIE"
"A BONG? BOGAN"
"BOOZE DENS NEED BOZOS"
"BORN AGAIN? NO BARGAIN"
"BREATHE WRONG? BANE REGROWTH"
"THE BRIG BE RIGHT"
"BRING UP BURPING? BURN, PIG"
"BUDDHAS? BAH! DUDS"
"A BURP'S SUBPAR"
"BUST THE BET HUTS"
"CENSOR A SCARE? NO"
"CERTITUDE! RECTITUDE"
"CHA-CHA? ACH! ACH"
"CHARITABLE? LIAR, BETCHA"
"COMPASSION? SCAM! POISON"
"CONSIDER, SCORN, DIE" []
"CONSUMING GIN? NO, SCUM"
"CONTEMPLATE ALE: CONTEMPT"
"COOP LIARS, ACROPOLIS"
"COPULATE-PLACE? OUT"
"COPULATIONS? UNAPOSTOLIC"
"CRAVE GOLD? COLD GRAVE"
"CREATIVES? VISCERATE"
"CREED CEDER? DE-REC"
"A CROOK? O, CROAK"
"CULTURES, CURE LUST"
"CUPIDITY? PUDICITY"
"CURVIEST, VICE = RUTS"
"DANCE = CEDE DECADENCE"
"DEALINGS = DANG LIES"
"DEISM NOW, MR? SIMMER DOWN"
"DESIST, DEISTS"
"THE DEVIL: A VILE DEATH"
"DIANETICS INDICATES ANTICS. DIE"
"DIG NIL IDLING"
"DIG NOT DOTING"
"DIG THOR? DO RIGHT"
"DIGNITY? TIDYING"
"DIRTY JOKES? RISKY! DO JET"
"DISDAIN SIN, I ADD" []
"DISLIKE LIES, KID"
"DISLIKES: KIDS['] LIES"
"DISORDER = SORDIDER"
"DO INK? NO, KID"
"DO WRONG? GO DROWN"
"DOFF LUST? OLD STUFF"
"DOING IN GOD? NO, DIG" []
"DONATE? ATONED" []
"DOOBIE? BOO! DIE"
"DOWN THY WHY-DON'T"
"DREAD NOT? DON'T DARE" []
"EBONICS? NICE, SOB"
"EDITORIALS = IDOLATRIES"
"EGO: VIRUS, GRIEVOUS"
"EH, A TOT TO HATE" []
"EH, PURE UP HERE"
"EH, RYE'S HERESY" []
"EH, SEX = HEXES"
"ELEGISING = EGGIN[']! LIES"
"EMPATHY IS SHAM PIETY"
"END SASS. SADNESS"
"ENERVATE? VENERATE"
"ENSHEATH HEATHENS" []
"ERECTIONS NECROTISE"
"EUDEMONISTS? SEDIMENTOUS"
"F'ING ODD? FIND GOD"
"FAD, U R FRAUD"
"FAIRY TALES ARE FALSITY"
"FAITHFUL-FITFUL? AH"
"FAST? COOL? SCAT, FOOL"
"FEELING UP? FIE! PLUNGE"
"FERULE? RE-FUEL"
"FIB? RELY BREIFLY" []
"A FIDDLE: ADD LIFE? IDLE FAD"
"FILM SET? LEFTISM"
"FILTH AS TEXT? LET'S FIX THAT"
"FITNESS FEST = SIN"
"FLAKINESS: SINK A SELF"
"FLASHIEST? FAITHLESS" []
"FLESH IS SELFISH"
"FLOUT-PRAY? PARTY FOUL"
"FOCUS ON SIN: CONFUSIONS"
"FOIL SLOTH, SOLO FILTH" []
"FORBID DIF, BRO"
"FOREGO, GOOFER"
"FOREPLAY? PRAY, O ELF"
"FORESTALL, FELLATORS" []
"FORGO YE GOOFERY" []
"FORNICATING = FRACTIONING"
"FOULNESS LOSES FUN" []
"FRIED UP? I = PURIFIED"
"FUN? DROOP: PROFOUND"
"FUN? ICK" [x]
"GAIETY IN TV = NEGATIVITY"
"GAY PRIDE? GRIPE DAY"
"GEISHAS? HISSAGE" []
"GENTILES? STEELING" []
"GET PHYSICAL? CHASTELY, PIG. PITCH SAGELY" []
"GIN HATE GAINETH" []
"A GIN LUSH? LANGUISH"
"GIN-SMIT? SMITING"
"GO BET? BE GOT"
"GO FUND GOD? FUN"
"GO SOBER, GOOBERS" []
"GOD BANS BAD SONG"
"GONE BAD? GOD BANE! NO BADGE" []
"GORE FAN? FAR GONE"
"GORGIN['] IN GROG? GRINGO" []
"GOT LINGERIE, ELITE GRINGO? GET RELIGION"
"GRACE = LIES/SACRILEGE"
"GREED, CATS? GET SCARED"
"GRIEF'S FUN! SUFFERING" []
"GROG = SELF FLOGGERS"
"GUILDERS = SLUDGIER"
"GUILE = LIE, UG"
"GUITARS? OUT! GRATUITOUS" []
"HARDLINE HANDLER = I"
"HASSLE? LASHES"
"HATE FREER HEREAFTER" []
"HATE GOD? GO! DEATH"
"HATE SIN IN HASTE" []
"HATE SIN, OK? SHAKE ON IT"
"HATEFUL, EH? FAULT" []
"HBO'S BOSH" []
"HEATHEN? NAH, THEE"
"HEDONISM? MIS-HONED"
"HEDONISM? MONISHED" []
"HEDONISTS = DISHONEST: [']STONISHED" []
"HELLFIRES RILE FLESH"
"HEURISM? MUSHIER"
"HICKEYS: SICK, HEY"
"HIDE AWAY A WHY IDEA"
"HIS DEMONS: HEDONISM'S DIMNESS, OH"
"HIS GOAL: NO HOOLIGANS"
"HOLIDAYS? I SAY, HOLD"
"HONEST AIM: NO ATHEISM" []
"HOPE? EH, PO[']"
"HOPING? ROT. POOR THING"
"HOPING'S NIGH? SOP"
"HOT DIVE = THE VOID" []
"HOT SIN? [S-W] NO" []
"HOT TUBS? TUT! BOSH" []
"HUMANISM? SHUN! MAIM"
"HURT GOD? DROUGHT"
"I BLESS? BS! LIES"
"'I DODGE GOD?' DIE"
"I FLED SINNERS['] FRIENDLINESS"
"I KNOCK KINKCO"
"I RE-DAMN DREAMIN[']" []
"I SANCTION ONANISTIC INACTIONS"
"I SCOFF OFF SCI"
"I SCORN SCORIN[']" []
"I SENSE SIN, SEE" []
"I SHUT DOWN WHODUNITS"
"I SUNDER RUDE SIN"
"I'D SLUR LURIDS"
"I'D STROKE?! DORKIEST! DO STRIKE" []
"ICY MALT: A CALAMITY"
"IDLE, EH? TV? THE DEVIL"
"IDLINGS GILD SIN"
"IDOLATRY DAILY = ROT"
"IF BINGE, BIG FINE"
"IF NEUTRAL, REAL UNFIT" []
"IF NO CUSS, FOCUSINS[']"
"IF PRIDE, FIE, DRIP"
"ILL TEMPER? PRIME! TELL, MELT PERIL"
"IN DOUBT? NOT I, BUD"
"INCULPATE! CLEAN IT UP" []
"INFIDELS FIND LIES"
"INSOUCIANT? CAUTION: SIN"
"INTO CRUDE? INTRODUCE REDUCTION"
"INTO US? SIN: OUT"
"INTOX? NO! X IT"
"IS HOPE NEAR? NO, PHARISEE"
"IT'S NORMAL? MORTAL SIN" []
"IT'S PAP, PAPIST"
"IT'S THE TITHES, THEIST" []
"KO LUST TO SULK"
"KORAN? O, RANK"
"KUMBAYAS? SAMBA? YUK"
"LABS BE BABELS"
"LACK BIBLE? I'LL BE BACK"
"LECHERY? CRY, HEEL" []
"LECTORSHIP? SPLOTCHIER"
"LEGIT RAVE: GIVE LATER = GREAT EVIL"
"LENIENT? A POX: EXPONENTIAL" []
"LESS CRIME! MERCILESS"
"LET'S FIX SEX-FILT"
"LEVY NOT NOVELTY" []
"LEWD ACTOR? COLD WATER" []
"LIE, PERSON? NO REPLIES"
"A LIE TOLLS? LOSE IT ALL"
"LIES DANDY? DYED NAILS? DEADLY SIN"
"LOOK WEIRD? LO, WORK, DIE"
"LOST ONCE? NOT CLOSE" []
"LSD IS NOT SIN? DOLTS"
"LUST, HERE? THE RULES SLUR THEE" []
"LUST-LED = DULLEST"
"LUST'S RIFE, FRUITLESS"
"LYIN'S SINLY"
"MAGIC? BS! BIG SCAM"
"MAGIC USER? SCUM! I RAGE"
"MALT, SON? LOST MAN"
"MAMBO? VILE! IMMOVABLE"
"MANKIEST? MISTAKEN" []
"MASTURB = BUM ARTS! MUST BAR"
"ME, I BAN BEAMIN[']"
"MERCY IS CRIMES-Y"
"MIRACLES? LIE! SCRAM"
"MISERABLE? RISE! BLAME" []
"MISSED DEISMS? DISS [']EM"
"MODERATE = MERE TOAD MADE ROTE" []
"MODERNITIES? MISORIENTED"
"MOOSH HOMOS" []
"MOST DYE. MY DOTES? MODESTY"
"MUSICAL? AIL, SCUM" []
"MUSING SIN? MUG"
"NAG-MIND? DAMNING"
"NAG MOOD? GOOD MAN"
"NAG PROUDLY. PARDON? UGLY" []
"NEED MORE? NO REDEEM"
"NEW AGE? GEE, NAW" []
"NICKNAMES SICKEN, MAN"
"NIL PUBIC IN PUBLIC"
"NO-GUILT GIN? LOUT"
"NO-HATE HEATON"
"NOBLESSE? BONE LESS" []
"NOIRS? NO SIR" []
"NOISY? OY, SIN"
"NOS TO TOONS"
"NOT MAD TO DAMN"
"NOT ODD? DON'T DO D-N-D, TOO"
"NOT SERIOUS = TOO-SURE SIN"
"NOVENAS SAVE? NON"
"NUTS TO NO-TUTS SUTTON" []
"O, DOGMATIST MATT IS GOOD"
"O, STOW WOOTS"
"ODD IF DO DIF"
"OF SIN: NO IFS"
"OGLE OFT? FOOL, GET LET GO OF"
"OGLIN'S LOSING"
"OH, I'D SLAY HOLIDAYS" []
"OHH, SWAG? HOGWASH"
"OL['] MINDSET: DON'T SMILE? NOT MISLED"
"ONE FLIRT, NO FILTER: LIFE TORN" []
"ONE THRILL? ROT IN HELL"
"ONE URGE, YO? YOU'RE GONE"
"ORPHANED: HARD? NOPE"
"OUGHTNESS = TOUGHNESS"
"OUT, RASH AUTHORS"
"OVID? VOID"
"OW, SIN WINS, O WINOS" []
"PANTHEIST? IN THE PAST" []
"PAR-TAY? AY, TRAP! PAY, RAT"
"PARDON DA PORN? NO, PARD[']" []
"PART BUNK? BANKRUPT"
"PASSION IN SOAPS? NO, I PASS" []
"PEER? SPY? YEPPERS"
"PENETRANT? REPENTANT"
"PENTAGRAM? PAGAN TERM" []
"PERISH NOT THE PRISON"
"PERVERSION OVERRIPENS"
"PERVERSION RISE? PROVEN"
"PERVERSIONS? SERVE PRISON"
"PHARISEE, EH? PRAISE HEAPS? IRE! I RESHAPE"
"PHOBIA'S A BISHOP"
"PICK NOSE? SICK PEON" []
"PINAFORES IS PROFANE"
"PINBALL? PILL? BAN"
"PLAID SUIT? AIL, STUPID"
"PLAY DICE? YEA, CLIP'D"
"PLAY PARTY? PAY RAPTLY? PRAY APTLY"
"PONTIFF, I? PFFT, NO"
"PONYTAILS PLAY TO SIN"
"POPELESS, PEOPLES'S PEP LOSES"
"PORN HAS ORPHANS"
"PORN IS PRISON"
"PORNO, EH? NO-HOPER" []
"POSH BI BISHOP HIP? SOB"
"POSIT NO POTIONS" []
"POUND NO PUD"
"POUTISH? SHIP OUT"
"PRESBYTERIAN BRAYS INEPTER"
"PREVENT TV-PREEN" []
"PRINCIPLES CRIPPLE SIN"
"PRO-GAY? GO PRAY"
"PRO-SIN? PRISON ROPIN'S" []
"PROCLIVITY: CIVIL TO PRY"
"PROSECUTE CREEP-OUTS" []
"PROVE ARTSY? PARTY'S OVER"
"PUB RUN? BURN UP"
"PUBLIC HOUSE, EH? PIOUS CLUB"
"PUN-CREED? PRUDENCE"
"PURE BOD? BE PROUD" []
"PURITANISM IMPAIRS? NUT"
"PURSUER, US = PURER"
"QUESTIONS QUOTE SINS"
"RAPTURES? RUSE! TRAP" []
"RATE VICE CREATIVE?! REACT! VIE" []
"RATS TO TAROTS"
"RAYS AIN'T SANITARY"
"RE-OFFEND? FOREFEND" []
"RE SMOKING: SMIRK GONE"
"RE-SPRAY PRAYERS"
"RE-UPDATE: I REPUDIATE"
"REASONING? GO NEAR SIN"
"RECIDIVOUS, VERIDICOUS"
"REPULSE A PLEASURE PLEA? SURE" []
"RESOLVING SIN? GROVEL"
"REVEL? STOP! OVERSLEPT"
"RID PLAY RAPIDLY" []
"RIP A CULT? A CULPRIT"
"ROTE PAGANS['] PATRONAGES: GROPE SATAN"
"RUE ALL ALLURE"
"RUT? WRATH! RAW TRUTH"
"(S'MORE MORES)" []
"SALOONS? NO! A LOSS"
"SANCTION NO ANTICS"
"SANEST SIN? NASTINESS"
"SAUCINESS CAUSES SIN"
"SCANTITY = SANCTITY"
"SCI-FI IS FIC"
"SCOWL AT LOW ACTS" []
"SECULAR? CLEAR US"
"SECULAR? NO: LARCENOUS" []
"SECULAR RECUSAL: SLUR? ACE" []
"SEE GIN: GEE, SIN" []
"SEEDIER? I SEE RED" []
"A SELFIE? FAIL, SEE"
"SELFIES? FIE! LESS"
"SEX JOINT? TO JINXES! JOT NIXES"
"SHINTO? NO, THIS" []
"SHOOT CRAPS: SPORT? CHAOS"
"SHOOT UP? THOU P O S" []
"SHOULDN'T HOLD NUTS" []
"SICK PORN?! NO PRICKS"
"SICKO? I SOCK" []
"A SICKO? OI, SACK"
"SICKOS? ICK! SOS" []
"SILLINESS IS ILLNESS"
"SIMONY? O MY, SIN" []
"SIN AMOUNT: MOUNTAINS"
"SIN? COUNT UNCTIONS"
"SIN FEARS FAIRNESS" []
"SIN HUT? SHUN IT" []
"SIN NOW WINS ON"
"SIN: ONENESS IS NONSENSE"
"SIN? OOP: POISON" []
"SIN? PROPOSE OPPRESSION" []
"SIN'S FEAR: FAIRNESS" []
"SING LEAST SLANGIEST"
"A SMILE IS LAME" []
"SMUT-CO = TO SCUM" []
"SNEAK FOR NO FREAKS" []
"SO PERVY? VERY? P O S"
"SO VALIANT? SALVATION AVAILS NOT"
"SODS, END ODDNESS"
"SOFT? NAA. A FAT SON OF SATAN"
"SORT OUT OUR TOTS" []
"SOT KING? GO SKINT"
"SPONSOR PORN? SOS"
"A SPORTING PASTORING? GROAN! PITS"
"SPURTIN[']? SPURN IT"
"ST. BRAD: A BAD STAR"
"ST. CINDI INDICTS"
"ST. DEON = STONED DEN-SOT" []
"ST. ELY'S SLYEST STYLES? LESS, T/Y"
"ST. ENCINI ISN'T NICE"
"ST. LOU, OL['] STU: LOUTS" []
"ST. TERIL LITTERS"
"STAGNATE: GET SATAN"
"STALE MIND, DISMANTLE ID-LAMENTS"
"STAND ST. DAN = AN STD"
"STAR SHINES? TRASHINESS"
"STARK FOE OF TAKERS TO FREAKS"
"START FEW WET FARTS"
"STIR? OBEY! SOBRIETY"
"STIR UP, PURIST! SPUR IT"
"STOP DRINKING, DROP STINKING"
"A SWINGER? SWEARING? EW! ARG! SIN"
"SYMPATHY: A PSY-MYTH"
"TABERNACLE, BAN TREACLE"
"TAILORED? IDOLATER"
"TAPHOUSE? PHASE OUT" []
"TAROT = A TORT"
"TAT-SHOD? SOD THAT"
"TECHIER? HERETIC"
"TEEN SIMPS? EMPTINESS" []
"TEMP-FAIL? AMPLE FIT? FLAME PIT" []
"THIRD LEG? RED LIGHT"
"THOR'S SHORT" []
"THOU, BEG? BE TOUGH"
"THRUST TRUTHS"
"THUS BLAME THE ALBUMS"
"THUS PRIM TRIUMPHS" []
"TIDY SUM? MIS-DUTY"
"TO DERP = DE TROP" []
"TO FAPS OFT? SAP"
"TO HAIL TOIL, AH"
"TO HAREMS: SHAME! ROT"
"TO RAP OR TAP = PO['] ART"
"TO RAP'S A SPORT, PASTOR? PART! SO"
"TO STUMP: SMUT, POT"
"TONS RATE NO TREATS"
"TOOK ANY? NOT OKAY"
"TORAH, HO? ART? HA, ROT" []
"TOUT ESPRIT? TUT, ROPIEST PROSTITUTE"
"TOYS? TRIPE! POSTERITY" []
"TRAIN UP, PURITAN" []
"TRANSGRESSIONS, ANGST, SORRINESS"
"TRANSMIT TANTRISM? TAINTS, MR" []
"TRIPE'S RIPEST"
"TRITHEISTS? THIRSTIEST"
"TURPITUDE: TIED UP RUT" []
"TV: ART, YES? TRAVESTY"
"U: FLAW? AWFUL" []
"UM, BILE'S SUBLIME" []
"UNCHOSEN? NONE SUCH. SHUN ONCE. ECHO, NUNS"
"UNCLEAR EVILS? SURVEILLANCE"
"UNTOWARD? DRAWN OUT"
"UP! I SO PIOUS" []
"UP, REVILE PURE EVIL"
"UP TO SIN? SPIN OUT" []
"UR-SIN: RUINS"
"URGENT! SIN INSURGENT" []
"US, POOR MUSIC, COPIOUS RUMS: PROMISCUOUS"
"V. PUERILE? PURE EVIL"
"VANITY IN TV? AY"
"VAUDEVILLE: VALUED? VILE"
"VILIFY ROT, FRIVOLITY"
"VITUPERATE? A VIRTUE, PET"
"VOICE HATE TO ACHIEVE" []
"WANDER? SINS. INWARDNESS"
"WANK? WOE, WAKE NOW"
"WANT? BASE! SWAT BANE"
"WASTE FOOD? OAF, DO STEW"
"WASTE MONEY: AMNESTY? WOE"
"A WHISKY? WHY, I ASK"
"WHO RIPS WORSHIP? MAD SIN ADMINS"
"WINES? EW, SIN" []
"WISDOM? NO, DOOM WINS"
"WRITE PORN? WORN TRIPE"
"A WTF = A FATWA"
"YO, A SIN? I SAY NO"
"YOLO FAN? NAY, FOOL"
"YOUR SIDE IS RUDE, YO"
"YOUTHFUL? UH, FLY OUT"
"YUP, I TRIM IMPURITY"
"ZERO BANS? SO BRAZEN"
"ZOROASTER? SORTA ZERO"

table of missing deli foods [xxu4]
blurb
"Appealing lagniappe"
"Apposed peapods"
"Artichoke, heck, a trio"
"Beef or beer of before"
"Belch-chleb"
"Blast-meal meatballs"
"Boars['] feet roast beef"
"Bran of no barf"
"Buffest buffets"
"Cold-meat-meld taco"
"Crud-Curd"
"Crumpets Spectrum"
"Dunes of fondues"
"Filet I left" []
"gluer gruel"
"Hug-food of dough"
"Idleness Linseeds" []
"Kelpic Pickle"
"A Lad's Salad" []
"Li[']l fest fillets"
"Lo-Fat Float"
"A lossier rissole"
"Lost-fever leftovers"
"Meals o['] lame-o's" []
"A moldy old yam"
"Near-goo oregano"
"Nirvana Navarin"
"No-ABC bacon"
"Obitual tabouli" []
"Olives so vile" []
"Panic-Set Picantes"
"A pecan canape"
"Picante nitecap"
"Pickles of folk-spice"
"Poets['] pesto" []
"Precious rice soup" []
"Previously soupy liver" []
"Prog-GORP"
"Rain-made marinade" []
"riot-act ricotta"
"Roasted red oats" []
"Sad-curst custards"
"Safe-begun angus beef"
"Semi-banal lima beans"
"sleek leeks"
"Some flat soft meal"
"Sorta-Top Pot-Roast"
"Soy true yet sour"
"Sprat-parts"
"Syrup of fry-soup"
"Tasto-toast-tatos"
"Toroid Dorito"
"Transience nectarines"
"Upstream tempuras"
"Usual Luaus"
"Utes['] suet"
"Zeal-shunt hazelnuts"
"Zoo-rich chorizo"

table of moralizers [xxu5]
blurb
"A-Grade Adager Ed Agar"
"A. Turnip, Puritan" []
"Abjured Jeb Radu"
"Abjurer Jae Burr"
"Act-Naif Fanatic Nia Fact"
"Admonisher [if player is male]Misha Roden[else]Sandie Rohm[end if]"
"Adviser [if player is male]Sid Vera[else]Vi Deras[end if]"
"Advisory [if player is male]Roy Davis[else]Ivy Rodas[end if]"
"Al 'Bzt' Blatz"
"Al Esquer, Le Square Squealer"
"Alarmist Ali Stram"
"Ale/Rum Mauler [if player is male]Mel Rau[else]Erma Lu[end if]"
"Amender Man Reed" []
"Analyst [if player is male]Al Tansy[else]Tana Sly[end if]"
"Anchorite Hortencia"
"Angelic Celia Ng"
"Annoyer Oren Yan" []
"Annoying [if player is male]Gino Yann[else]Nina Yong[end if]" []
"Anti-Booze Zoe Bonita"
"Anti-Clod Cid Alton"
"Anti-Crime Metrician Mina Trice"
"Aphorist Pia Short" []
"Ara 'Bzt' Braatz"
"Ardent Nat Erd" []
"Arg-No Rogan"
"Ashram Marsha" []
"Asinine Rut Insinuater Erin Austin"
"Assertoric Ostraciser [if player is male]Rico Sastre[else]Sari Cortes[end if]"
"Ax-Lies Alexis" []
"Axe-Grind [if player is male]Rex Gadin[else]Regan Dix[end if]"
"Badgerer [if player is male]Edgar Erb[else]Edra Berg[end if]"
"Ban-a-Trope Bonaparte"
"Ban-much Buchman"
"Ban-Them Bentham"
"Ban-Wild Baldwin"
"Barmy Old Lombardy"
"Be-Civil [if player is male]Vic Lieb[else]Bev Ilic[end if]"
"Beat-Sin Bastien"
"Been-Dark Bednarek" []
"Behaver Ev Baehr"
"Blamer Ada Balderama"
"Blamer Ali Mirabella" []
"Blamer China Chamberlain"
"Blamer Goen Longerbeam"
"Blamer Handa Abdelrahman"
"Blamer Keo Blakemore" []
"Blamer Lee Bellemare"
"Blamer Sofia Laframboise"
"Blamer Tash Halberstam"
"Blamer Ty Tremblay-Lamberty"
"Blamin['] Libman"
"Blustery [if player is male]Les Truby[else]Elsy Burt[end if]" []
"Bolstering Gilbertson"
"Bore Al Arbelo"
"Bore Art Barreto" []
"Bore Cal Barcelo" []
"Bore Calyn Clayborne" []
"Bore Carl Berrocal" []
"Bore Dan Broaden" []
"Bore Darin Berardino" []
"Bore Del Doebler" []
"Bore Elissa Labossiere"
"Bore Else Ebersole" []
"Bore Emery Obermeyer"
"Bore Evans Beaverson"
"Bore Fern Freeborn" []
"Bore Ford Oberdorf" []
"Bore Gerst Osterberg"
"Bore Glenda Baldenegro"
"Bore Grant Bontrager"
"Bore Hans Harbeson"
"Bore Ida Broadie"
"Bore Laci Alberico"
"Bore Lad Laborde-Belardo" []
"Bore Leif Belfiore"
"Bore Lenard Oberlander" []
"Bore Les Ebersol"
"Bore Lita Liberato"
"Bore Lu Bouler"
"Bore Lyda Boardley" []
"Bore Mae Boerema"
"Bore Mel Belmore"
"Bore Miller Obermiller"
"Bore Nat Boatner-Bartone" []
"Bore Odell Rebolledo"
"Bore Pam Poremba"
"Bore Sam Ambrose" []
"Bore Sandi Bedrosian"
"Bore Shaun Barnhouse" []
"Bore Sima Ambroise"
"Bore Stella Ballestero"
"Bore Tad Bretado" []
"Bore Ty Boyter"
"Bore Wm Bowmer"
"Borer Dick Broderick"
"Boring Aldo Longobardi"
"Boring Ara Garbarino"
"Boring Del Olberding"
"Boring Elsa Gabrielson"
"Boring Enos Bonsignore"
"Boring Grobin" []
"Boring Mae Giambrone"
"Boring Mo Imbrogno"
"Boring Rhee Boehringer"
"Boring Stan Brasington"
"Boy Rev Overby"
"Briber Ribber Bri Erb"
"Brimstone Bert Simon"
"Bunkered Debunker Ned Burke"
"Burdened Rene Budd"
"Burn-in-Hell Len Hilburn"
"Cabalist Staci Alb"
"Cajoler Joe Carl"
"Called Cadell" []
"Calvinist Civil Stan"
"Cancely-Clean Cy Clancey"
"Captious Tia Csupo"
"Caretaker [if player is male]Ara Eckert[else]Tara Creek[end if]"
"Caringest [if player is male]Eric Tsang[else]Traci Seng[end if]"
"Caringest [if player is male]Stan Grice[else]Cris Tegan[end if]" []
"Casuist Staci-Su"
"Catchiest Catechist Chet Ticas"
"Catchiest Catechist Sacchetti" []
"Cauter-Curate Art Cue"
"Caviler [if player is male]Al Cervi[else]Val Rice[end if]"
"Ceasing-Gins Ace"
"Celibate [if player is male]Abel Tice[else]Bee Altic[end if]"
"Censurer Ren Cruse"
"Changed Ed Chang"
"Chastiser [if player is male]Rich Seats[else]Trish Case[end if]"
"Cheap Rat Capehart" []
"Cherub Bucher"
"Chider Art Reichardt" []
"Chider Bean Reidenbach"
"Chider Les Scheidler"
"Chider Rees Scheiderer"
"Chider Rife Friederich"
"Chider Skeet Ketcherside"
"Chosen Schoen" []
"Citator [if player is male]Art Coit[else]Cari Ott[end if]-Ricotta" []
"Civil Man McIlvain"
"Clarion Carolin" []
"Clean Fun Fan Uncle"
"Clear Clare" []
"Clear Man MacLaren"
"Clergyman [if player is male]Glen Camry[else]Mercy Lang[end if]"
"Clot Alica Callicoat"
"Clot Anisa Colasanti"
"Clot Ann Clanton"
"Clot Ara Alcorta" []
"Clot Arie Talerico" []
"Clot Ariel Tallerico" []
"Clot Eden Delconte"
"Clot Elsa Costella" []
"Clot Eura Lucatero-Clouatre" []
"Clot Leila Locatelli"
"Clot Leta Colletta"
"Clot Lina Cantillo"
"Clot Lisa Castillo-Costilla" []
"Clot Lois Costillo"
"Clot Luci Tuccillo"
"Clot Maia Malicoat"
"Clot Malia Mallicoat"
"Clot Ming McGilton"
"Clot Mirna Clairmont" []
"Clot Nilsa Castillon"
"Clot Noe Loconte"
"Clot Rae Lacorte"
"Clot Ray Claytor" []
"Clot Rena Carleton" []
"Clot Rheba Batchelor"
"Clot Rina Coltrain" []
"Clot Rosa Locastro" []
"Clot Salena Castellano"
"Clot Samuel Muscatello"
"Clot Sharen Charleston" []
"Clot Skye Stockley"
"Clot Su Locust" []
"Clot Una Lacount"
"Clot Yan Clayton" []
"Coach-Man McConaha"
"Complainant Monica Plant"
"Concerned Ced Conner"
"Conformist Simon Croft"
"Confuser Ern Fusco"
"Conservative Veronica Vest"
"Contrary Ron Tracy" []
"Converted Trev Conde"
"Counselor Lou Cosner" []
"Crank Bell Bracknell"
"Crank Elmo Lockerman" []
"Crank Eva Vanacker"
"Crank Eve Cervenka"
"Crank Mae Ackerman" []
"Crank Mei Marcinek"
"Crank Mena Ackermann"
"Crank Mo Rockman"
"Crank Moe Ockerman"
"Crank Si Rasnick"
"Crank Sol Clarkson" []
"Crank Zee Ezernack"
"Creep-Bug Peg Bruce"
"Creeping-Nicer Peg"
"Critic Elli Riccitelli"
"Critic Ora Tricarico"
"Crucifier Ferriucci"
"Cured [tt] Coudriet" []
"Cured Al Caulder" []
"Cured Arn Durrance"
"Cured Sam DeMarcus" []
"Cured Seth Deutscher" []
"Cured Si Scuderi" []
"Curmudgeon Mungo DuRec"
"Damny Mandy"
"Dang-Rite Tangredi"
"Debunked Budd Keen"
"Deft Hater Father Ted"
"Demonizer [if player is male]Rod Menzie[else]Inez Moder[end if]"
"Denier Gal Geraldine"
"Derider Deirdre" []
"Derogatory Toady Roger"
"Detailer Ted Ariel" []
"Deviant-End Vita" []
"Devoted Ted Dove"
"Diluvian Ludivina"
"Dire-Flaw Warfield"
"Disgruntled Ed Lundgrist"
"Disgust-Digs Stu"
"Disputer-Purist Ed"
"Diviner Ed Irvin"
"Dogmatic Magic [d-t]"
"Dolt Agnes Gladstone"
"Dolt Aline Donatelli"
"Dolt Ash Holstad" []
"Dolt Barnes Balderston" []
"Dolt Chae Deloatch"
"Dolt Guinn Ludington"
"Dolt Hearn Leonhardt" []
"Dolt Herb Berthold"
"Dolt Higby Lightbody"
"Dolt Ira Altidor" []
"Dolt Lea Tellado"
"Dolt Luisa Astudillo"
"Dolt Luise Estudillo" []
"Dolt Rena Alderton" []
"Dolt Rhea Aderholt" []
"Dolt Sam Molstad"
"Dolt Sana Dalsanto" []
"Dolt Sauer Trousdale"
"Dolt Signe Goldstein"
"Dolt Tia Dattilo"
"Dolt Una Daulton" []
"Domineering [if player is male]Minger Deion[else]Mindi Greeno[end if]"
"Domineering [if player is male]Ogden Minier[else]Monnie Ridge[end if]" []
"Don't-Fart Natt Ford"
"Doom-Nag Goodman" []
"Dora 'Bzt' Dobratz"
"Dork Ana Koranda"
"Dork Annese Skenandore"
"Dork Ball Barkdoll"
"Dork Brice Broderick" []
"Dork Buhler Burkholder"
"Dork Cal Lockard"
"Dork Cast Stockard"
"Dork Cay Ackroyd"
"Dork Evans Vondrasek"
"Dork Freda Drakeford"
"Dork Ike Odekirk"
"Dork Lea Oldaker"
"Dork Mosby Dombrosky"
"Dork Nasby Dobransky"
"Dork Nat Kondrat"
"Dork Neal Kolander" []
"Dork Neel Kernodle-Knoedler" []
"Dork Nesci Derickson" []
"Dork Nunes Dunkerson"
"Dork Sima Radomski"
"Dork Siwek Kedrowski"
"Dork Win Dworkin" []
"Double-Nice [if player is male]Lucien Bode[else]Eboni Dulce[end if]"
"Downer Sal Rosenwald" []
"Dr. Bible-Dribble"
"Dr. Nag-Grand" []
"Drag Ana Granada"
"Drag Angele Delagrange"
"Drag Aron Norgaard"
"Drag Bee Debarge"
"Drag Belen Landgrebe"
"Drag Bo Bogard"
"Drag Breen Anderberg"
"Drag Byer Gadberry"
"Drag Celi Claridge" []
"Drag Chae Craghead"
"Drag Denis Sandridge" []
"Drag Eden Degrande"
"Drag Elden Delgrande"
"Drag Eli Gelardi" []
"Drag Elsa Ragsdale"
"Drag Elvin Vangilder"
"Drag Ena Granade"
"Drag Erin Gardiner"
"Drag Ernie Readinger" []
"Drag Ethan Dagenhart"
"Drag Eve Degrave"
"Drag Fae Degraaf"
"Drag Flo Galford"
"Drag Gene Anderegg-Degrange"
"Drag Helen Engelhard"
"Drag Heppner Pendergraph"
"Drag Ian Radigan"
"Drag Ike Akridge" []
"Drag Inez Danziger"
"Drag Jae Grajeda"
"Drag Jenna Grandjean"
"Drag Lan Lagrand"
"Drag Lea Lagarde"
"Drag Lee Arledge"
"Drag Leif Garfield" []
"Drag Len Dangler" []
"Drag Lenn Landgren"
"Drag Leo Geraldo" []
"Drag Les Geralds"
"Drag Lila Gaillard"
"Drag Lili Gilliard"
"Drag Lin Darling" []
"Drag Linton Darlington"
"Drag Lola Gallardo" []
"Drag Maia Madriaga"
"Drag Mila Madrigal" []
"Drag Milo Grimaldo" []
"Drag Ned Degrand"
"Drag Neil Aldinger" []
"Drag Nina Andringa"
"Drag Noah Hagadorn-Hargadon"
"Drag Noe Dragone" []
"Drag Ona Granado"
"Drag Piet Patridge"
"Drag Rene Gardener" []
"Drag Rhine Hardinger"
"Drag Roe Gerardo" []
"Drag Ron Norgard"
"Drag Sanabia Bagdasarian"
"Drag Selene Greenslade"
"Drag Serota Ostergaard"
"Drag Sona Granados"
"Drag Sonner Granderson"
"Drag Spenser Pendergrass"
"Drag Teena Teagarden"
"Drag Thuy Daughtry"
"Drag Tien Tangredi" []
"Drag Tori Girardot"
"Drag Yan Nygaard"
"Drip Arch Prichard"
"Drip Asa Paradis-Paradis"
"Drip Ella Delpilar"
"Drip Evans Pendarvis" []
"Drip Felice Percifield"
"Drip Flo Lipford"
"Drip Greta Partridge"
"Drip Ian Pardini"
"Drip Len Prindle"
"Drip Levan Vanderlip" []
"Drip Loree Delpriore" []
"Drip Mae Dampier" []
"Drip Mia Diprima"
"Drip Omer Pridmore" []
"Drip Oren Perrodin"
"Drive-Slow Drew Silvo" []
"Drivel-Led Irv" []
"Drone Al Renaldo" []
"Drone Alec Calderone" []
"Drone Ali Leonardi" []
"Drone Alica Candelario" []
"Drone Anh Hernando"
"Drone Ava Varnadoe"
"Drone Bari Berardino" []
"Drone Brian Bernardino"
"Drone Daws Edwardson"
"Drone Dora Arredondo"
"Drone Elsa Rosendale" []
"Drone Gena Degennaro"
"Drone Gil Reingold" []
"Drone Giles Delsignore"
"Drone Hal Leonhard"
"Drone Ian Andreoni-Orendain" []
"Drone Lash Rosendahl" []
"Drone Lila Nardiello" []
"Drone Lisa Leonardis" []
"Drone Luba Abdelnour" []
"Drone Mia Demarino" []
"Drone Oda Aredondo"
"Drone Ola Leonardo" []
"Drone Pavel Vanderpoel" []
"Drone Sal Roseland" []
"Drone Sam Soderman" []
"Drone Sana Andreason"
"Drone Star Ostrander"
"Drone Su Duerson" []
"Drone Sung Gunderson"
"Drone Val Overland" []
"Drugger Grudger Greg Urd"
"Dry Abel Bradley" []
"Dry Adele Adderley" []
"Dry Arlen Rylander"
"Dry Au Duray"
"Dry Ava Varady"
"Dry Bao Broady" []
"Dry Barber Bradberry"
"Dry Ben Bryden"
"Dry Berna Bernardy" []
"Dry Bo Brody-Dobry" []
"Dry Bree DeBerry"
"Dry Carmen Cryderman"
"Dry Clemons McReynolds"
"Dry Cora Cordray" []
"Dry Dale Ledyard-Adderly"
"Dry Eli Ridley"
"Dry Ena Radney-Draney"
"Dry Euna Reynaud" []
"Dry Eve Devery"
"Dry Ewan Wandrey"
"Dry Flo Lyford"
"Dry Friesen Reifsnyder"
"Dry Gail Gilyard"
"Dry Gena Gradney"
"Dry George Degregory"
"Dry Gina Ginyard"
"Dry Ivan Vinyard" []
"Dry Laci Claridy"
"Dry Lea Darley"
"Dry Leann Nylander" []
"Dry Lee Yelder"
"Dry Leif Fridley" []
"Dry Leon Reynold"
"Dry Mae Demary" []
"Dry Mana Maynard" []
"Dry Manie Deyarmin" []
"Dry Mina Minyard" []
"Dry Mona Raymond" []
"Dry Noe Dorney" []
"Dry Noemi Dorminey"
"Dry Olsen Reynolds" []
"Dry Pa Pardy"
"Dry Rae Ardrey" []
"Dry Rena Reynard"
"Dry Sen. Snyder-Synder"
"Dry Signe Dysinger"
"Dry Sina Sinyard"
"Dry Slate Stradley" []
"Dry Sol Berg-Goldsberry"
"Dry Tesha Hardesty"
"Dry Theo Doherty" []
"Dry Tia Dayrit"
"Dry Tisha Hardisty" []
"Dry Toi Dority"
"Dry Tona Drayton" []
"Dry Weber Dewberry"
"Dry Yael Yardley"
"Dull Amy Mullady"
"Dull Berna Rubendall"
"Dull Iris Rudisill"
"Dull Len Lundell"
"Dull Ma Ludlam"
"Dull Sharen Hulslander"
"Dull Theo Leuthold"
"Earl 'Bzt' Baltzer"
"Ed Most Modest"
"Eglise Gisele" []
"Eli 'Bzt' Belitz"
"Elie 'Bzt' Beitzel"
"Eternising Steininger"
"Evangelist [if player is male]Gavin Steel[else]Agnes Levit[end if]" []
"Evangelist [if player is male]Nigel Stave[else]Stevie Lang[end if]" []
"Evangelist Nate Selvig" []
"Evict-Sin Vic Stein-Vicentis"
"Ex-Snot Sexton"
"Explainer [if player is male]Alex Perin[else]Pearle Nix[end if]"
"Explanatory [if player is male]Early Paxton[else]Roxy LaPenta[end if]"
"Faith-Led Hatfield"
"Fake Saint Stefaniak"
"Faultfinder [if player is male]Delta Ruffin[else]Rutland Fife[end if]"
"Fearmonger [if player is male]Armon Grefe[else]Gema Renfro[end if]"
"Fine Narc Francine"
"Fingerer [if player is male]Ren Greif[else]Geri Fern[end if]"
"Fink Alsteen Falkenstein"
"Fink Cates Stefanick"
"Fink Ely Finkley"
"Fink Esta Stefanik"
"Fink Les Felkins"
"Fink Lis Filkins"
"Fink Lu Lufkin" []
"Fink Rae Frankie" []
"Fink Sabra Fairbanks"
"Fink Tessa Stefanski"
"Firebrand [if player is male]Brian Fred[else]Fern Baird[end if]"
"Flouts-of-Lust Loftus" []
"Fluster-Lust Ref St. Fleur"
"FORBID FIB ROD"
"Formally Fly Moral Myla Rolf"
"Found Fund-O Don Fu"
"Fractious [if player is male]Curt Sofia[else]Cari Foust[end if]" []
"Frank-Bias Fairbanks" []
"Frank Moe Formanek"
"Frank Old Lankford" []
"Frenetic Infecter [if player is male]Eric Fent[else]Fern Tice[end if]"
"Fussy Red Dreyfuss"
"Gainsayer Anisa Grey" []
"Gainsayer Anya Gries" []
"Gallant Tall Nag Nat Gall"
"Generalist Easterling" []
"Gilb Drone Olberding"
"Glum Acey Mcgauley" []
"Glum Ana Mangual" []
"Glum Anita Manigault" []
"Glum Aries Margulies" []
"Glum Dina Maulding" []
"Glum Ettie Guilmette" []
"Glum Hana Laughman"
"Glum Kena Kugelman"
"Glum Lina Mulligan" []
"Glum Lorie Guillermo"
"Glum Noah Loughman"
"Glum Rio Gilmour" []
"Glum Risa Margulis"
"Goat Arpin Pignataro"
"Goat Ben Boateng"
"Goat Bush Stobaugh"
"Goat Carline Caltagirone"
"Goat Deena Degaetano"
"Goat Ely Goatley"
"Goat Ena Gaetano"
"Goat Len Gleaton"
"Goat Linh Hotaling" []
"Goat Maren Agramonte" []
"Goat Mars Armagost"
"Goat Marti Margiotta"
"Goat Merlene Montealegre"
"Goat Nilsa Stagliano" []
"Goat Riva Garavito"
"Goat Rubi Buitrago"
"Goat Rush Grothaus"
"Goat Sina Santiago"
"Goat Su Tougas"
"Goat Teller Allegretto"
"God Botherer Herbert Good"
"God Botherer Robert Hodge" []
"God Given Ned Viggo"
"Godlier Gloried Gil Rode"
"Gong-Flaw Wolfgang" []
"Goob Ard Goodbar"
"Goob Hunt Boughton"
"Goob Irma Ambrogio"
"Goob Lan Bologna"
"Goob Ronni Bongiorno"
"Goob Rush Boroughs"
"Goob Rusher Rosebrough"
"Goob Shani Boghosian"
"Goob Sina Bogosian"
"Goob Sly Goolsby"
"Good Min Domingo"
"Good Rina Giordano"
"Good Saint Dagostino"
"Good Wilder Wooldridge"
"Grater Garret Trager"
"Gratin['] Tigran"
"Great Kid [if player is male]Tad Krieg[else]Gita Derk[end if]"
"Green Art Gaertner"
"Green Bill Bellinger"
"Green Del Legendre"
"Green Dona Degennaro" []
"Green Fidel Greenfield"
"Green Hugo Greenough"
"Green Iris Reisinger"
"Green Lee Greenlee"
"Green Rat Gaertner" []
"Green Rob Bergeron"
"Green Tod Edgerton"
"Green Val Lavergne"
"Grim Abe Brimage"
"Grim Alia Miraglia"
"Grim Alisa Marsiglia"
"Grim Allen Mallinger" []
"Grim Angel Riggleman"
"Grim Ann Manring"
"Grim Arntson Morningstar"
"Grim Ash Grisham" []
"Grim Cal Mcgrail"
"Grim Eden Medinger"
"Grim Ellen Mellinger"
"Grim Elsy Grimsley-Grimsley"
"Grim Ely Grimley"
"Grim Ena Germain" []
"Grim Hana Ingraham"
"Grim Heaven Everingham"
"Grim Lan Marling"
"Grim Lang Gramling"
"Grim Leo Gilmore"
"Grim Leola Gallimore"
"Grim Leon Longmire"
"Grim Leonel Moellering"
"Grim Leslee Seegmiller"
"Grim Lida Grimaldi"
"Grim Lionel Gremillion"
"Grim-Lip Prim Gil, Pilgrim"
"Grim Lou Gilmour" []
"Grim Nat Girtman"
"Grim Nola Margolin"
"Grim Oren Rominger"
"Grim Rae Armiger"
"Grim Reese Griesemer"
"Grim Reith Rightmire"
"Grim Rena Merrigan"
"Grim Rose Grismore"
"Grim Saul Margulis" []
"Grim Spann Springman"
"Grim Stone Motsinger"
"Grim Tacy McGarity"
"Grim Tona Morganti"
"Grim Tracy Mcgarrity"
"Grinch Rich Ng"
"Griper Noe Peregrino"
"Griper Tad Partridge" []
"Grouser Reg Urso"
"Grubby Bug Bry"
"Guide Aldo Delgaudio"
"Guide Alla Delaguila"
"Guide Ron Gourdine" []
"Guide Sal Gesualdi"
"'Guilts' Lustig"
"Guru Mia Murguia"
"Halter Thaler"
"Hammering Marge Minh"
"Harems Masher Mr. Ashe" []
"Harmless Les Marsh"
"Haro 'Bzt' Bozarth"
"Hassler Les Rash" []
"Hatin['] Alec Chatelain" []
"Hatin['] Amos Mathiason" []
"Hatin['] Else Haseltine"
"Hatin['] Ernest Hartenstein" []
"Hatin['] Mae Mathenia"
"Hatin['] Mel Thielman"
"Hatin['] Mose Mathieson" []
"Hatin['] Neal Nathaniel"
"Hatin['] Nell Tannehill"
"Hatin['] Wm Whitman" []
"Heap-Crime Impeacher [if player is male]Ari McPhee[else]Pam Cherie[end if]"
"High-Road Dari Hogh"
"Holy Ada Holaday"
"Holy Eda Hoadley"
"Holy Fidel Holyfield"
"Holy Ida Holiday"
"Holy Lida Holliday"
"Holy Man Lon Mahy"
"Holy Pure Hyper Lou"
"Holy Rod Holroyd"
"Holy Sue Housley"
"Holy Wailer Yellowhair"
"Hon. Clay Halcyon"
"Honester Hortense Thoresen"
"Hot-Dogma Thad Moog-Goodmath"
"Huge Bore Beougher"
"Humblest Seth Blum"
"Hurtful Ruth Ulf"
"Hypnotic, Pythonic Ty Chopin" []
"Hypocrite Hector Yip" []
"Hypocrite Hoyt Price" []
"I-Cure-Lust Lucretius"
"I-Know-Best Kit Bowens"
"I'm-Law Wilma"
"Ice Rat Tracie" []
"Icky Mr. Myrick"
"Ideologue Leo Goudie"
"Idolater [d-t] Ariel" []
"Ill [']N Grave Gallin['] Rev. Granville" []
"Imputer Pure Tim"
"Incisiver Eric Ivins"
"Infallible Blane Ifill"
"Inferior [if player is male]Orin Frei[else]Rori Fine[end if]"
"Informed [if player is male]Fred Mino[else]Fern Modi[end if]" []
"Ingrate Geri Tan" []
"Injured Dr. Junie"
"Internet-Renitent Trent Nei"
"Involved Liv Devon" []
"Jacked-Up Jude Pack"
"Jealous Soul Jae"
"Just-Saying Guy St. Janis"
"Just Wise Wes Tsuji"
"Justified Judi Feist"
"Kip Thoen the Pinko"
"Kneller Kellner"
"Know-it-All Will Tonka"
"Large Fink Garfinkel"
"Law-Nerd Waldner"
"Lea 'Bzt' Batzel"
"Ledo 'Bzt' Betzold"
"Legal Rev. Gravelle"
"Lemonhead [if player is male]Noel Ahmed[else]Dee Holman[end if]"
"Limit-It Lim"
"Literal [if player is male]Ira Tell[else]Tia Rell[end if]"
"Lorena 'Bzt' Brazelton"
"Low-Sin Wilson" []
"Lui 'Bzt' Lubitz"
"Luminary [if player is male]Marlin Yu[else]Myrna Lui[end if]"
"Lyncher Cherlyn"
"Mad Priest [if player is male]Tim Spader[else]Tari Demps[end if]"
"Make-Sense Sean Meeks" []
"Malicing-Claiming Gia McLin"
"Maligner [if player is male]Neal[else]Lena[end if] Grim" []
"Manner-Kid Kinderman" []
"Mannerist Martinsen"
"Marybeth Hemby, Rat"
"Meddler Mel Redd"
"Meek Clair Mielcarek" []
"Meek Lan Kleeman" []
"Meek Len Kelemen"
"Meek Mary Kammeyer"
"Meek Nona Koeneman"
"Meek Raymon Moneymaker"
"Meek Ron Kenmore"
"Melancholy Chloe Lyman"
"Melancholy Molly Hance" []
"Mentor Merton"
"Messiah Ami Hess" []
"Meticulous [if player is male]Miles Coutu[else]Lucie Musto[end if]"
"Micromanager Marco Germain"
"Militant Latin Tim"
"Min-Shag [if player is male]Mig Nash[else]Ms. Hanig[end if]"
"Minger Meri Ng"
"Miracle Claimer Ari Clem" []
"Mirthless Trish Elms"
"Misleading [if player is male]Miles Dagin[else]Mindi Gales[end if]"
"Moaner Al Molenaar" []
"Moaner Cathi Chiaramonte" []
"Moaner Otis Monasterio"
"Monachist Macintosh" []
"Monk Al Kolman"
"Monk Alf Folkman"
"Monk Aline Melkonian"
"Monk Art Kortman"
"Monk Burl Kornblum"
"Monk Cal Lockman"
"Monk Caleb Bockelman"
"Monk Cari Marcinko"
"Monk Ceci McConkie" []
"Monk Clare Lockerman" []
"Monk Hal Kohlman"
"Monk Ira Romanik"
"Monk Kelsi Mikkelson"
"Monk Lise Mikelson"
"Monk Nanci Mackinnon"
"Monk Nina Kinnamon"
"Monk Rae Romanek"
"Monk Reba Bronkema"
"Monk Renee Kennemore"
"Monk Rosia Romanoski"
"Monk Sadi Domanski" []
"Monk Sina Makinson"
"Monk Slater Klosterman" []
"Monk Sticha Mackintosh" []
"Monk Val Volkman"
"Mooter Toomer" []
"Moral Marlo"
"Moralist Lori Stam"
"Moralistic [if player is male]Racist Milo[else]Lori Stimac[end if]"
"Mortified Tomi Fried"
"Most-Proper Pop Stromer"
"Motivated [if player is male]Tom DeVita[else]Iva DeMott[end if]"
"Mr. Nice-Mincer"
"Mrs. Elle, Smeller"
"Ms. Nice-Minces"
"Muckraker Marc Kurek"
"Mudslinger Miles Grund"
"Mullah Al Hulm"
"Nagger Grange Gregan"
"Nat the Thetan"
"Needler Enderle" []
"Needliest Edelstein"
"Needly Nedley Leyden"
"Neg-Nut Nugent"
"Negative [if player is male]Avi Tegen[else]Eve Ganti[end if]" []
"Negster Gersten Stegner" []
"Never-Pert Preventer Vern Peter"
"New-Saintly Winstanley"
"Nice Al Celani" []
"Nice Aldo DeNicola-Caliendo"
"Nice Alison Nicolaisen"
"Nice Altha Chatelain" []
"Nice Alva Valencia"
"Nice Art Certain" []
"Nice Beulah Eichenlaub"
"Nice Cora Carcione"
"Nice Dara Caradine-Adriance"
"Nice Darla Cardinale" []
"Nice Debrah Reidenbach" []
"Nice Flora Fernicola"
"Nice Gala Angelica"
"Nice Ham Eichman"
"Nice Herb Beichner"
"Nice Larue Lieurance"
"Nice Lavona Valenciano"
"Nice Leland Clendaniel"
"Nice Lora Naclerio" []
"Nice Marc Mccranie"
"Nice Marty Macintyre" []
"Nice Mei Niemiec"
"Nice Nance Cancienne"
"Nice Nova Venancio"
"Nice Olin Lencioni"
"Nice Omar Caminero"
"Nice Palma Campanile"
"Nice Person [if player is male]Prince Enos[else]Roni Spence[end if]"
"Nice Rob Briceno"
"Nice Ross Cisneros"
"Nice Seth Steichen"
"Nice Shea Chianese"
"Nice Sheba Eisenbach"
"Nice Smart [if player is male]Marc Stein[else]Cami Stern[end if]" []
"Nice Thor Tichenor"
"Nice Tora Caterino" []
"Nice Trish Christine" []
"Nice Vilma McIlvaine"
"Nicer Alda Cardinale" []
"Nicer Bo Briceno" []
"Nicer Ham Reichman"
"Nicer Loma Marcelino" []
"Nicer Mac McCranie" []
"Nicer Petra Carpentier"
"Nicer Tim McIntire"
"Nicer Zack Czarnecki"
"Nippers Snipper Ren Sipp" []
"Nitpicker Kit Prince"
"No-Bad Abdon"
"No-Bar Baron Barb O'Ronan" []
"No-Beers Ben Rose"
"No-Booze Zoe Bono"
"No-Bosh Hobson"
"No-Brew Browne" []
"No-Candy Ann Cody"
"No-Change Genna Cho"
"No-Fraud Fundora"
"No-Greed-Den Ogre Don Eger" []
"No-Hate [n-t] Ho"
"No-Joke's-OK Jones"
"No-Lie Oline O'Neil" []
"No-Lies Elison"
"No-No Hal O'Hanlon"
"No-Salt St. Lona" []
"No-Smut Tom Sun" []
"No-Swears Rose Swan"
"Nono Chad Anchondo"
"Nono Dell O'donnell"
"Nono Gil Longino"
"Nono Miss Simonson"
"Nono Tia Antonio"
"Nosy Al Layson"
"Nosy Balik Yablonski" []
"Nosy Belt Blystone"
"Nosy Bo Boyson" []
"Nosy Cal Clayson"
"Nosy Mick Cominsky"
"Nosy Petra Petrosyan"
"Nosy Rae Reynosa"
"Nosy Roe Reynoso" []
"Nosy Tal Slayton"
"Nosy Wilk Wolinsky"
"Not-Dark Kondrat" []
"Not-Rash Hartson"
"Not-Sex Sexton Tex Sno"
"Not-Very-Tony Rev. Nev Troy"
"Noteworthy Ty Howerton"
"Nudger Gruden"
"Nullify-Fun Lily"
"Nun Alma Laumann"
"Nun Amy Munyan"
"Nun Beatris Braunstein"
"Nun Callie Cullinane"
"Nun Delma Nudelman"
"Nun Digna Dunnigan"
"Nun Erma Murnane"
"Nun Gia Guinan"
"Nun Iesha Nienhaus"
"Nun Mae Neuman"
"Nun Merlyn Munnerlyn"
"Nun Ree Neuner"
"Nun Roni Runnion"
"Nun Vada Dunavan"
"Nun Vida Dunivan"
"OFFENSIVE? I OFF SEVEN" []
"Ol['] Pat, Pal to Plato" []
"Old-Saw Oswald" []
"Oracle Carole Calero" []
"Oracle Cleora" []
"Oracular Raul Cora"
"Out-Bred Doubter Bud Rote"
"Overalert Revelator [if player is male]Trevor Lea[else]Lora Evert[end if]"
"Pain Aldo Paladino"
"Pain Alec Palencia" []
"Pain Alton Napolitan" []
"Pain Art Partain-Trapani" []
"Pain Clem McAlpine"
"Pain Cyr Cyprian"
"Pain Ed Pineda-Depina"
"Pain Glenna Pangelinan" []
"Pain Greer Peregrina"
"Pain Holt Oliphant" []
"Pain Les Espinal" []
"Pain Lester Pearlstein" []
"Pain Lido DiNapoli"
"Pain Lora Apolinar"
"Pain Lou Paulino"
"Pain Lu Paulin-Lupian"
"Pain Meagan Mangiapane"
"Pain Nelms Spielmann" []
"Pain Orr Parrino"
"Pain Oscar Sparacino"
"Pain Ren Pannier"
"Pain Rico Cipriano"
"Pain Sal Laspina"
"Pain Santos Passantino"
"Pain Seth Stephani" []
"Pain Sol Spinola-Spaniol" []
"Pain Tod Pintado"
"Pale Rev. Peavler" []
"Pam the Empath"
"Paradigm Prig Adam"
"Parson Rapson" []
"Partisan Pat Rains" []
"Passionate Iona Spates" []
"Pastor Sproat" []
"Paternal Pert Alan" []
"Pedant Pa Dent" []
"Pedant Ron Andrepont"
"Pedant Ted Pan" []
"Pensive Vespine Snip Eve" []
"Per-Sin Sniper Perrin Espins" []
"Pest Alan Pleasant" []
"Pest Alton Stapleton" []
"Pest Aron Paterson" []
"Pest Eichorn Stonecipher" []
"Pest Gardner Prendergast-Pendergrast"
"Pest Henson Stephenson"
"Pest Karan Pasternak" []
"Pest Kory Petrosky"
"Pest Lida Plaisted"
"Pest Lori LoPresti"
"Pest Mel Stemple"
"Pest Noah Stanhope" []
"Pest Oren Peterson" []
"Pest Reid Depriest" []
"Pest Rene Petersen"
"Pest Riley Priestley"
"Pest Ron Preston" []
"Pest Sal Staples"
"Pest Shen Stephens"
"Pete Marr, Mr. Repeat-Tamperer" []
"Petulant [if player is male]Neal Putt[else]Lu Patten[end if]"
"Phat Enos Stanhope" []
"Phat Olin Oliphant" []
"Phony Jett Pettyjohn"
"Pill Ace Capelli"
"Pill Ada Padilla"
"Pill Anh Allphin"
"Pill Ara Parilla"
"Pill Caesar Pascarelli"
"Pill Cesar Scarpelli"
"Pill Chase Palleschi"
"Pill Enos Spinello"
"Pill Erick Pickerill"
"Pill Ian Pinilla"
"Pill Lavonda Villalpando"
"Pill Marna Prillaman"
"Pill Ned Pindell"
"Pill Ona Pollina"
"Pill Ora Parillo"
"Pill Reda Delpilar" []
"Pill Regine Pellegrini"
"Pill Renato Pontarelli" []
"Pill Rene Pellerin"
"Pill Rufus Pursifull"
"Pill Sana Aspinall" []
"Pill Sean Spinella" []
"Pill Sun Pullins"
"Pill Tera Petrilla"
"Pill Teri Petrilli"
"Pill Tracie Patricelli"
"Pill Una Paullin"
"Pinko Ann Pankonin"
"Pinko Lis Polinski"
"Pinko Sal Polanski"
"Pinko Shon Hopkinson"
"Pinko Sly Polinsky"
"Plagiarist April Tigas"
"Play-Nice [if player is male]Lance Yip[else]Lacy Pein[end if]"
"Pliable Pill Abe"
"Polyester Proselyte [if player is male]Loy Peters[else]Elsy Perot[end if]"
"Ponderers['] Responder Ren Pedros"
"Poor Saint Pastorino"
"Pop, Virtues-Supportive"
"Pope Hermine Oppenheimer"
"Pope Ken Koeppen"
"Pope Les Peoples" []
"Pope Teri Rippetoe"
"Pray-Ban Parnaby"
"Preachiest Pat Scheier"
"Preachy Chap Rey" []
"Prick Dan Pinckard"
"Prick Ed Pedrick"
"Prick Elli Pickerill" []
"Prick Inge Pickering"
"Prick Isa Pisarcik"
"Prick Lea Pickeral" []
"Prick Lee Pickerel"
"Prick Les Spickler"
"Priest Ed Petrides" []
"Priest Enoch Stonecipher" []
"Priest Len Perlstein"
"Priest Neal Pearlstein" []
"Priest Ned President" []
"Priest Sean Saperstein"
"Priest Sona Petrossian"
"Priest Tia Petraitis"
"Prig Aleta Petraglia"
"Prig Asa Gaspari"
"Prig Deon Pridgeon"
"Prig Detra Partridge" []
"Prig Elden Erpelding"
"Prig Ines Spiering"
"Prig Lance Caplinger"
"Prig Len Pringle"
"Prig Leon Oplinger"
"Prig Leonel Pellegrino"
"Prig Luna Pulgarin"
"Prig Neal Galperin"
"Prig Ned Pridgen-Pridgen"
"Prig Nellie Pellegrini" []
"Prig Noell Pollinger" []
"Prig Omer Prigmore" []
"Prig Ponce Coppinger"
"Prig Renae Peregrina" []
"Prig Sean Spearing"
"Prig Tonie Pingitore"
"Prim Allan Prillaman" []
"Prim Kenna Pinkerman"
"Prim Lea Palmeri"
"Prim Leah Lamphier"
"Prim Neal Palmerin"
"Privileged Deep Virgil"
"Proud Nice Prudencio"
"Prude Stein Turnipseed"
"Prudent Pent Dru" []
"Prudent Pet Rund" []
"Pure [if player is male]Rupe[else]Prue[end if]" []
"Pure Abe Beaupre"
"Pure Ada Drapeau"
"Pure Asia Pariseau"
"Pure Dori Poudrier"
"Pure Ed DuPree" []
"Pure Got-to-Purge Peg Rout"
"Pure Mia Primeau"
"Pure Tisa Pusateri"
"Purposes Supposer [if player is male]Russ Pope[else]Rose Upps[end if]"
"Pushy Herm Humphreys" []
"Questioner Roque-Stein"
"Quibbler Riq Buble"
"Rae 'Bzt' Batrez"
"Railroader [if player is male]Errol Adair[else]Darla Rorie[end if]"
"Ramon 'Bzt' Brotzman"
"Rank-Bias Baranski"
"RAP NOTIFIES PROFANITIES" []
"Rat Agnes Sargeant"
"Rat Ash Tarsha"
"Rat Baez Tabarez"
"Rat-Bane Braaten"
"Rat Bart Barratt"
"Rat Bert Barrett" []
"Rat Bo Tabor"
"Rat Bore Barreto" []
"Rat Byrnes Stanberry"
"Rat Caine Caterina"
"Rat Caren Tarrance"
"Rat Crone Torrance" []
"Rat Efren Ferrante"
"Rat Elsa Lasater"
"Rat Else Laseter"
"Rat Elsy Straley"
"Rat Elton Tarleton" []
"Rat Elvira Valtierra"
"Rat Ely Ratley" []
"Rat Elyse Easterly"
"Rat Emil Latimer" []
"Rat Eric Cartier" []
"Rat Erich Chartier"
"Rat Erin Trainer"
"Rat Ernie Renteria"
"Rat Ester Streater"
"Rat Eva Tavera"
"Rat Exie Texeira"
"Rat Frye Raftery"
"Rat Gema Magaret"
"Rat Glen Largent"
"Rat Hager Gearhart"
"Rat Hans Strahan" []
"Rat Her Harter-Rather-Erhart"
"Rat Herb Harbert"
"Rat Holden Leonhardt" []
"Rat Ian Triana" []
"Rat In Tarin" []
"Rat Jon Trojan" []
"Rat Ken Kanter"
"Rat Lehman Halterman"
"Rat Leigh Gilreath" []
"Rat Leora Alatorre" []
"Rat Les Slater" []
"Rat Levy Laverty"
"Rat Lew Walter" []
"Rat Lory Traylor"
"Rat Lou Latour"
"Rat Lucie Lucretia"
"Rat Lugo Goulart"
"Rat Maguire Marguerita"
"Rat Marge Margaret"
"Rat McLean Marcantel"
"Rat Mel Martel-Tramel" []
"Rat Melinda Martindale" []
"Rat Meta Mattera" []
"Rat Mina Martina"
"Rat Mona Maranto"
"Rat Murch Mcarthur"
"Rat Naomi Taormina"
"Rat Ned Arendt" []
"Rat Rhea Earhart"
"Rat Rich Richart"
"Rat Rose Serrato" []
"Rat Rosi Sartori"
"Rat Rush Arthurs"
"Rat Sade Estrada" []
"Rat Semon Osterman" []
"Rat Shala Latarsha"
"Rat Simon Stromain" []
"Rat Simone Sarmiento" []
"Rat Skye Starkey" []
"Rat-Soon Santoro"
"Rat Star Sarratt"
"Rat Steele Satterlee"
"Rat Stew Watters" []
"Rat Sue Sauter"
"Rat Tamie Marietta" []
"Rat Tran Tarrant"
"Rat Verena Navarrete"
"Rat Verona Terranova"
"Rat Wes Waters"
"Rat Weston Watterson"
"Rat Zak Kraatz"
"Rational Ali Arnot" []
"Re-Cured Reducer Ed Curre"
"Re-Risen Reisner"
"Re-Voiced Divorcee [if player is male]Eric Dove[else]Eve Doric[end if]" []
"Reacher Cher Rea"
"Reactionary Tonya-Carrie" []
"Rebutted Burdette"
"Redeem-Em Reed"
"Ree 'Bzt' Betzer"
"Reformer Mo Ferrer"
"Reg Cly, Clergy"
"Regarded Degrader [if player is male]Ed Gerard[else]Dede Garr[end if]"
"Rehabs-Basher Absher"
"Relevant [if player is male]Art Leven[else]Val Treen[end if]"
"Religious [if player is male]Luigi Rose[else]Lori Segui[end if]"
"Rescued Ed Cruse"
"Resentful Len Fuster"
"Responsible Biles-Person LeBron Sipes"
"Rev. [a-b] Beaver"
"Rev. Ade Deaver"
"Rev. Agar Vergara"
"Rev. Alden Vreeland" []
"Rev. Alec Cleaver"
"Rev. Alica Cavalier" []
"Rev. Allison Villasenor" []
"Rev. Aly Lavery" []
"Rev. Ament Vanmeter"
"Rev. Angel Lavergne" []
"Rev. Arnetta Navarrette"
"Rev. Art Tarver"
"Rev. Burgin Rivenburg"
"Rev. Caden Cavender"
"Rev. Case Versace"
"Rev. Chas Chavers"
"Rev. Cher Vercher"
"Rev. Chris Schriver"
"Rev. Clay Caverly"
"Rev. Coon Conover"
"Rev. Dale Velarde" []
"Rev. Dalia Delariva" []
"Rev. Davin Vandiver" []
"Rev. Doe Devore"
"Rev. Donna Vandoren"
"Rev. Doug Verdugo" []
"Rev. Ed Dever-Verde"
"Rev. Else Reveles"
"Rev. Ely Everly"
"Rev. Elza Alverez"
"Rev. Enos Everson"
"Rev. Etta Averett"
"Rev. Ewa Weaver" []
"Rev. Gable Belgrave"
"Rev. Gay Garvey"
"Rev. Glinda Vangilder" []
"Rev. Gordan Vangorder"
"Rev. Green, Revenger"
"Rev. Hagar Hargrave"
"Rev. Hall Harvell"
"Rev. Hay Harvey"
"Rev. Hoose Voorhees"
"Rev. Hye Hervey"
"Rev. Ines Iversen-Severin"
"Rev. Iola Valerio-Olivera" []
"Rev. Ira Rivera-Vierra" []
"Rev. Isa Reavis"
"Rev. Issa Servais"
"Rev. Ivette Viverette"
"Rev. Larita Valtierra" []
"Rev. LaShon Halvorsen"
"Rev. Leaf Lafever"
"Rev. Leila Valliere" []
"Rev. Les Revels"
"Rev. Lila Averill-Revilla" []
"Rev. Lilian Rainville" []
"Rev. Lis Silver"
"Rev. Lisa Silvera"
"Rev. Lissa Silveras"
"Rev. Lola Overall" []
"Rev. Lon Lovern"
"Rev. Louie Louviere"
"Rev. Loy Overly"
"Rev. Luc Culver"
"Rev. Lyla Vallery"
"Rev. Mena Everman"
"Rev. Milan Liverman"
"Rev. Moll Vollmer"
"Rev. Mona Overman"
"Rev. Neal Vanleer" []
"Rev. Ned Denver"
"Rev. Nessa Severnas"
"Rev. Nigel Levering"
"Rev. Noah Hanover" []
"Rev. Nova Vanover"
"Rev. Nydia Vineyard" []
"Rev. Ola Olvera-Valero"
"Rev. Otis Restivo"
"Rev. Pitt Privett"
"Rev. Rana Navarre"
"Rev. Renata Navarrete" []
"Rev. Retha Everhart"
"Rev. Rio Rivero"
"Rev. Rish Shriver"
"Rev. Rog Grover"
"Rev. Rosette Overstreet"
"Rev. Sade Deavers" []
"Rev. Sage Greaves" []
"Rev. Saldana Vanarsdale" []
"Rev. Sash Shavers"
"Rev. Sea Reaves-Seaver" []
"Rev. See Reeves-Severe" []
"Rev. Sha Shaver"
"Rev. Sid Divers" []
"Rev. Sion Iverson" []
"Rev. Sloan Alverson" []
"Rev. Soila Olivares" []
"Rev. Sol Slover"
"Rev. Sotelo Roosevelt" []
"Rev. Star Travers"
"Rev. Stiles Silvestre"
"Rev. Stowe Westover"
"Rev. Styles Sylvestre"
"Rev. Teno Everton" []
"Rev. Toni Trevino"
"Rev. Tso Stover"
"Rev. Tuan Ventura" []
"Rev. Ula Lauver"
"Rev. Velda Valverde"
"Rev. Yan Varney"
"Rev. Zana Narvaez"
"Rev. Zane Nevarez"
"Rev. Zito Trevizo"
"Rev. Zoila Olivarez"
"Revolted [d-t] Lever"
"Riel 'Bzt' Blitzer"
"Right Abel Gilbreath"
"Right Alba Galbraith"
"Right Ana Hartigan"
"Right Dee Ethridge" []
"Right Della Threadgill"
"Right Lea Gilreath" []
"Right Len Lightner"
"Right Noren Herrington"
"Right One [if player is male]Thor Egin[else]Inge Hort[end if]"
"Right Ronna Harrington"
"Right-Way Gary Whit"
"Righteous Geri South"
"Rigorously-Sour Gilroy"
"Rios 'Bzt' Zobrist"
"Rivaling Virginal [if player is male]Gil Arvin[else]Avril Ing[end if]"
"Ro 'Bzt' Bortz-Brotz"
"Roundest-Tonsured Drone Stu"
"Rousing, Souring, Grousin['] [if player is male]Gus Rino[else]Su Gorin[end if]"
"Rule Hawk Hulk Ware"
"Rule-Scion Cornelius" []
"Rulemonger Geno Rumler"
"Rulesmonger Mungo Resler"
"Sad Prick Spickard"
"Sad Rev. Draves"
"Safe Cher Schaefer"
"Safe Donte Destefano" []
"Safe Joni Josefina"
"Safe Rhee Seehafer"
"Safe Roni Serafino"
"Safe Sol Lafosse" []
"Saint Agnus Sanagustin" []
"Saint Allan Santillana"
"Saint Asa Anastasi"
"Saint Bo Bostian" []
"Saint Bren Bannister"
"Saint Caron Scarantino" []
"Saint Cher Christena" []
"Saint Ed DeSanti" []
"Saint Fae Stefania"
"Saint Fred Standifer"
"Saint Heber Eisenbarth" []
"Saint Junio Justiniano"
"Saint Levan VanAlstine"
"Saint Marion Mastroianni" []
"Saint Mirna Mastrianni"
"Saint Moe Maisonet" []
"Saint Newell Wallenstein" []
"Saint Noella Santaniello"
"Saint Olga Stagliano" []
"Saint Omer Sarmiento" []
"Saint Rhee Eisenhart" []
"Saint Rich Christian" []
"Saint Rico Cristiano"
"Saint Risa Tassinari"
"Saint Romeo Monasterio" []
"Saint Ruben Braunstein" []
"Saint Shue Steinhaus"
"Saint Sid DiSantis"
"Saint Tom Mattison" []
"Sane Abel Albanese"
"Sane Bart Abrantes" []
"Sane Boris Soberanis"
"Sane Brad Banderas"
"Sane Burt Eastburn" []
"Sane Cal Canales"
"Sane Cari Saraceni"
"Sane Chet Chasteen"
"Sane Christin Christiansen"
"Sane Cleta Escalante"
"Sane Cora Saraceno"
"Sane Corbin Bernasconi"
"Sane Cris Narcisse" []
"Sane Daron Andreason" []
"Sane Dirk Iskander"
"Sane Dom Mendosa"
"Sane Ed Desena-Danese" []
"Sane Eli Eliasen" []
"Sane Elrod Rosendale" []
"Sane Em Seeman" []
"Sane Emil Milanese" []
"Sane Fred Sandefer"
"Sane Gema Geesaman"
"Sane Gil Gelinas-Sinegal" []
"Sane Gilb Ingalsbe"
"Sane Giles Lasseigne"
"Sane Hogan Haagenson"
"Sane Holt Haselton" []
"Sane Hyon Yohannes"
"Sane Irma Seminara"
"Sane Jim Jasmine"
"Sane John Johansen" []
"Sane Julio Jeanlouis"
"Sane Kristin Kristiansen"
"Sane Lev Leavens"
"Sane Loma Salamone" []
"Sane Loris Israelson" []
"Sane Luc Clausen"
"Sane Lupe Penuelas"
"Sane Marc Creasman"
"Sane Mei Eiseman" []
"Sane Mel Sleeman-Seelman" []
"Sane Michal Aeschliman" []
"Sane Michel Michaelsen"
"Sane Ming Siegmann" []
"Sane Mort Sarmento" []
"Sane Ned Sandeen"
"Sane Old Adelson" []
"Sane Opal Penalosa"
"Sane Pat Pestana-Tapanes"
"Sane Priest Saperstein" []
"Sane Rob Seaborn" []
"Sane Rock Ackerson"
"Sane Rod Nodarse"
"Sane Ron Arenson" []
"Sane Ros Reasons" []
"Sane Roy Reynosa" []
"Sane Ruthie Steinhauer"
"Sane Sam Seamans-Messana"
"Sane Seth Shasteen"
"Sane Sol Asleson" []
"Sane Storm Masterson"
"Sane Tad Sandate-Anstead"
"Sane Tall Santella"
"Sane Tam Eastman-Smetana"
"Sane Tobias Sebastiano"
"Sane Tod Desanto"
"Sane Tom Samonte" []
"Sane Tomi Maisonet" []
"Sane Tori Restaino" []
"Sane Treva Vantrease"
"Sane Trim Martines" []
"Sane Trula Arsenault" []
"Sane Ty Tansey-Anstey"
"Sane Von Evanson"
"Sanitary Nasty Ari" []
"Savior Arviso"
"Scapegoat [if player is male]Paco Gates[else]Peg Acosta[end if]"
"Scare-Cares Cesar" []
"Scholarly [if player is male]Ray Scholl[else]Sally Roch[end if]" []
"Scold Kate Stockdale"
"Scolder Dr. Coles"
"Scolder Les Cord" []
"Scoldy Clod Sy"
"Screedy Ced Ryse"
"Sectarian Cara Stein"
"Seer Al Easler"
"Seer Allan Arellanes"
"Seer Ann Arnesen"
"Seer Arn Reasner"
"Seer Aron Reasoner"
"Seer Art Resetar"
"Seer Beck Besecker"
"Seer Becki Biesecker"
"Seer Bev Beevers"
"Seer Blaine Siebenaler"
"Seer Bundy Dusenbery"
"Seer Byrd Sedberry"
"Seer Cher Scheerer"
"Seer Chi Scheier"
"Seer Dann Andersen"
"Seer Dawne Wandersee"
"Seer Donn Enderson"
"Seer Doris Desrosier"
"Seer Dutch Deutscher"
"Seer Dyson Desnoyers"
"Seer Ed Dreese"
"Seer Elmo Meserole"
"Seer Emory Rosemeyer"
"Seer Fendrick Fredericksen"
"Seer Gant Sergeant"
"Seer Gil Geisler"
"Seer Glenda Greenslade"
"Seer Hy Hersey"
"Seer Jung Juergens"
"Seer Katlyn Tankersley"
"Seer King Kesinger"
"Seer Kip Spieker"
"Seer Kyla Kearsley"
"Seer Lev Reveles"
"Seer Lin Neisler"
"Seer Linh Shirlene"
"Seer Lis Eissler"
"Seer Liz Zeisler"
"Seer Londa Rosendale"
"Seer Lu Lesure"
"Seer Lui Leisure"
"Seer Man Reesman"
"Seer Marte Estremera"
"Seer Mary Ramseyer"
"Seer Ned Resende"
"Seer Nick Ericksen"
"Seer Nigel Seelinger"
"Seer Old Delores"
"Seer Pat Peaster"
"Seer Quin Enriques"
"Seer Rees"
"Seer Rich Scheirer" []
"Seer Rich Schreier"
"Seer Ro Reesor"
"Seer Ron Rosener"
"Seer Roni Reierson"
"Seer Rus Reusser"
"Seer Sal Searles"
"Seer Sid Seiders"
"Seer Stew Sweetser"
"Seer Terri Riesterer"
"Seer Tim Meister"
"Seer Tona Senatore"
"Seer Tot Rosette"
"Seer Ty Eyster-Steyer"
"Seer Van Nevares"
"Seer Vance Severance"
"Seer Vi Rieves"
"Seer Von Everson"
"Sensible [if player is male]Neil Bess[else]Bess Neil[end if]" []
"Sensitive Ines Tevis" []
"Severe Reeves" []
"Shaker Harkes"
"Shamer Ramesh" []
"Sharia Ira Ash"
"Sharia-Thirst Trisha Hartis" []
"Shh-I'm-Pure Humphries"
"Sin-Fret Finster"
"Sin Noter Ornstein"
"Sincere Ericsen" []
"Sinned-Not Denniston" []
"Skeptical [if player is male]Kip Castle[else]Lita Speck[end if]" []
"Slandery Lysander" []
"Sly Bore Broyles" []
"Smack-Not Stockman" []
"Smartie Marie St. Reitsma-Maestri" []
"Smircher Schirmer" []
"Snitch Abe Steinbach"
"Snitch Fidel Stinchfield"
"Snitch Ira Christian" []
"Snitch Marci Mcchristian"
"Snitch Mikel Kleinschmit"
"Snitch Mo Mcintosh"
"Snitch Oma Macintosh" []
"Snitch Ona Atchinson" []
"Snitch Rose Christeson-Stroschein"
"Snitch Rosina Christianson"
"Snitch Serina Christiansen" []
"So-Careful [if player is male]Lucas Fore[else]Flo Surace[end if]" []
"So-Clever Rev. Coles"
"So-Nicer Ericson" []
"So-Right Og Hirst"
"Sober Chan Rosenbach"
"Sober Dina Bedrosian"
"Sober Elias Labossiere"
"Sober Em Ormsbee"
"Sober Evan Beaverson"
"Sober Fred Beresford"
"Sober Gent Stoneberg"
"Sober Glynn Bryngelson"
"Sober Kim Obremski"
"Sober Lee Ebersole"
"Sober Lilia Bellisario"
"Sober Mac Camberos"
"Sober Man Amberson"
"Sober Manu Rosenbaum"
"Sober Mia Ambroise"
"Sober Moon Rosenboom"
"Sober Nanci Bernasconi"
"Sober Ned Bredeson"
"Sober Nohemi Boomershine"
"Sober Ren Berrones"
"Sober Rock Rosebrock"
"Sober Ron Roberson"
"Sober Sal Labrosse"
"Sober Sandi Bedrossian"
"Sober Sean Soberanes"
"Sober Sina Soberanis"
"Sober Stella Ballesteros"
"Sober Trina Barrientos"
"Sober Ty Boyster"
"Sober Wilk Wrobleski"
"Sobering Giberson" []
"Sore-Fret Forester"
"Sorehead [if player is male]Dre O'Shea[else]Dee Haros[end if]"
"Spiritual [if player is male]Saul Tripi[else]Rita Pulis[end if]"
"Square Mo Mosquera"
"Square Pei Pesqueira"
"Stale Bo Seabolt" []
"Stale Dan Eastland"
"Stale Horn Rosenthal" []
"Stale Morgan Mastrangelo"
"Stale Rey Easterly" []
"Stan, Greed-Estranged"
"Stately Testy Al"
"Stern Gil Sterling" []
"Stevie Sin-Sensitive" []
"Steward Ed Straw"
"Stickler Rick Elst"
"Stingy Yingst" []
"Straw Man Mart Swan"
"Strident Ned Ritts"
"Superior [if player is male]Rupe Rios[else]Rose Puri[end if]" []
"Superior Prior Sue" []
"Sure Brenton Stoneburner"
"Sure Colin Cornelius" []
"Sure Coy Coursey"
"Sure Deana Dansereau"
"Sure Delta Truesdale"
"Sure Eli Leisure" []
"Sure Hank Hunsaker"
"Sure Leif Fuselier"
"Sure Olga Salguero"
"Sure Sol Roussel" []
"Sure Star Strauser"
"Swami Nelli Williamsen"
"Swami Wasim"
"Take-Charge [if player is male]Hack Gartee[else]Kathe Grace[end if]"
"Tattle Rog Altergott"
"Tattle Smidt Mittelstadt"
"Tattler Art Lett"
"Teach-Pastor Sacha Potter" []
"Temperance Pete Carmen"
"Tensioner Orenstein" []
"Theistic Ethicist Tish Tice"
"Theocratic [if player is male]Cicero Hatt[else]Cathi Ector[end if]"
"[']Thralling Thrill-Nag Grant Hill"
"Tired Nag Tangredi" []
"Tiresome Tom Riese" []
"Tit Aldo Dattilo" []
"Tit Bess Bissett"
"Tit Beulah Thibeault"
"Tit Brian Brittain"
"Tit Elva Leavitt"
"Tit Green Ettinger"
"Tit Karmen Kitterman"
"Tit Len Litten"
"Tit Lon Litton"
"Tit Mario Mariotti" []
"Tit Mason Mattison" []
"Tit Omer Moretti"
"Tit Ruben Brunetti"
"Tit Sam Mattis"
"Tit Sheron Rothstein" []
"Tit Su Titus" []
"Tit Vannessa Santistevan"
"Tit Weathers Satterwhite"
"Tolerant [if player is male]Trent Loa[else]Erna Lott[end if]" []
"Too-Humble Ol['] Bum Theo"
"Too-Near Tora Eno"
"Too-Smart [if player is male]Art Smoot[else]Rosa Mott[end if]" []
"Too-Strict Tori Scott"
"Touched Ted Chou" []
"Trample-Templar [if player is male]Art Pelm[else]Pam Ertl[end if]"
"Trier Terri"
"Trite Bess Brissette"
"Trite Dona Andreotti" []
"Trite Eli Lettieri"
"Trite Hans Steinhart"
"Trite Hong Hottinger"
"Trite Les Stiteler"
"Trite Moses Morissette" []
"Trite Ping Pittinger"
"Trite Renna Interrante"
"Trite Shenna Hartenstein" []
"Trite Shon Rothstein" []
"Trite Somer Morrisette"
"Trite Wm Wittmer"
"Troll Ash Shortall"
"Troll Em Mortell"
"Troll Ena Allerton"
"Troll Mae Martello"
"Troll Marie Martorelli"
"Troll Mash Hallstrom"
"Troll Pa Allport"
"Troll Paine Pontarelli" []
"Troll Pia Portilla"
"Troll Tice Cotterill"
"Troll Wes Worstell"
"True-Goat Garoutte" []
"Truthy Hurt Ty"
"Tutress Russett"
"Twit Cason Wainscott" []
"Twit Emery Wittmeyer"
"Twit Moll Willmott"
"Twit Sam Wimsatt"
"Twit Seth Whitsett"
"Twit Shea Thwaites" []
"Twit Sheely Whittlesey"
"Ultra-Nice [if player is male]Art Lucien[else]Trina Luce[end if]" []
"[']Umbler Mr. Blue" []
"Un-Deep Rox, Expounder"
"Un-Dreg Gunder Gruden" []
"Un-Free Rene Fu"
"Unamused [if player is male]Duane Sum[else]Sue Duman[end if]"
"Unbearable Reuben Alba"
"Unchanged Dean Chung"
"Undaring [i-n] Grund"
"Unsubtle Blunt Sue"
"Uplifted Tepid Ulf"
"Upstanding [if player is male]Dustin Pang[else]Agnis Pundt[end if]"
"Verbatim Bev Mitra"
"Vestigal [if player is male]Gil Taves[else]Val Tiegs[end if]"
"Victorian Victorina"
"Vintager Grievant [if player is male]Trev Agin[else]Teri Vang[end if]" []
"Violated Al DeVito" []
"Visionary [if player is male]Roy Savini[else]Rosina Ivy[end if]"
"Vocaliser [if player is male]Oscar Levi[else]Cora Slive[end if]"
"Vocalizer [if player is male]Levi Zarco[else]Liz Cavero[end if]"
"Wailer Yen Earlywine"
"Wan-Mood Woodman"
"Warnin['] Winnar Arn Win"
"Warnin['] WINNAR Narwin" []
"Wee Crank Warnecke" []
"Whiner Coe Icenhower"
"Whiner Ice Weinreich"
"Whiner Nottage Weatherington"
"Whiner Otting Witherington" []
"Why-Dare Heyward"
"Wonk Artis Tarnowski" []
"Wonk Cai Nowacki"
"Wonk Cari Nawrocki" []
"Wonk Ismail Malinowski"
"Wonk Les Knowles" []
"Wonk Lis Kinslow"
"Wonk Morais Romanowski"
"Wonk Shani Hawkinson"
"Worried Rod Weir"
"Worrying Rory Gwin"
"Wrong Avena Vanwagoner"
"Wrong Belle Wollenberg"
"Wrong Belli Willenborg" []
"Wrong Erik Workinger" []
"Wrong Holt Longworth"
"Wrong Ida Winograd" []
"Wrong Ines Niswonger"
"Wrong Kasi Gawronski" []
"Wrong Leif Wolfinger"
"Wrong Minto Wormington"
"Wrong Niese Neiswonger"
"Wrong Odle Gronewold"
"Wrong Tish Wrightson"
"Yap-Not Payton"
"Yell-Ban Allenby"
"Yuna, Epic Picayune"
"Zealot Zoe Tal"
"Zealous Sue Zola"
"Zen-Led Denzel"

book troves

table of sked items [xxv1]
blurb
"Accost ScatCo."
"Acy CYA."
"Allay Layla."
"Altru? La ultra-rut!"
"Approve Vera Opp."
"Arr, gee: Agree'r re: rage."
"Ask out Otsuka."
"Assimilate rule-cut culture."
"Astonish Shinsato." []
"Avert Icy Veracity: evict Ray." []
"Ax Bert Baxter."
"Ax Darlene Alexander."
"Ax Delcarmen Mcalexander."
"Ax Lea Alexa."
"Ax Leo Olexa."
"Ax Mr. Max R. Marx."
"Ax Neil Axline." []
"Ax Robt Tarbox."
"Ax Sean Saxena."
"Ax Son Saxon."
"Axe Bluth Huxtable."
"Axe Cho Heacox."
"Axe Doug Godeaux."
"Axe Eli Alexie."
"Axe Lenard Alexander." []
"Axe Lin Axline." []
"Axe Lord Axelrod."
"Axe Randal Alexandra."
"Axe Teri Texeira." []
"B Brave. Abbrev."
"Baleet Taleeb." []
"Ban a new wannabe." []
"Bank on Ann Bok."
"Bar Kyle Barkley, Ray Belk, Bry Lake." []
"Bar Tex Baxter." []
"Bash mad, bad sham."
"Be had = bad, eh?"
"Be late? Baleet!" []
"Be Lean. Enable."
"Be on Dr. Borden." []
"Beat Carmon Bracamonte."
"Beat Darrow Broadwater."
"Beat Henry Abernethy."
"Beat Herr Eberhart."
"Beat Horn Rathbone." []
"Beat Kilmer Timberlake."
"Beat Lis Stabile."
"Beat Lon Labonte." []
"Beat Lorrie Liberatore."
"Beat Myrl Tremblay." []
"Beat Norris Barrientos."
"Beat Risner Barrientes."
"Beat Ron Boatner." []
"Beat Rooks Estabrook."
"Beat Sol Seabolt." []
"Beat Spud 'Budapest' Bupstead." []
"Beat Trey Attebery."
"Belabor Rob Bale, Bob Lear."
"Belay Al Bey."
"Belt Arch Albrecht-Batchler."
"Betray Ty Baer." []
"Bin old Blondi Boldin."
"Blackmail Milk Cabal." []
"Blow off Bo Wolff."
"Brainwash Brian Shaw."
"Break Baker."
"Break up Pa Burke."
"Broach Co-Brah Orbach."
"BS til blush."
"BUDGET: bug Ted."
"Bug Al Glaub."
"Bug Albertha Bartlebaugh."
"Bug Amiri Imburgia."
"Bug Andre Brundage." []
"Bug Ara Grabau."
"Bug Armenta Baumgarten."
"Bug Ashli Silbaugh."
"Bug Beulah Bluebaugh."
"Bug Cabe Cubbage."
"Bug Chara Carbaugh."
"Bug Ciara Burciaga."
"Bug Dean Begnaud."
"Bug Derin Brundige."
"Bug Dorner Rodenburg."
"Bug Earl Glauber."
"Bug Ed Budge."
"Bug Erin Breunig."
"Bug Erinn Bruening."
"Bug German Bruggeman."
"Bug Gerner Gruenberg."
"Bug Greenman Brueggemann."
"Bug Han Baughn."
"Bug Hana Baughan."
"Bug Hara Arbaugh."
"Bug Harmon Broughman."
"Bug Harter Traughber." []
"Bug Hartson Stanbrough." []
"Bug Herr Burgher."
"Bug Hilma Limbaugh."
"Bug Horton Broughton."
"Bug Ines Buesing."
"Bug Karim Krigbaum."
"Bug Larae Balaguer." []
"Bug Lenart Altenburg." []
"Bug Lindler Dillenburg."
"Bug Lorena Boulanger." []
"Bug Maren Guberman."
"Bug Margene Brueggeman." []
"Bug Marita Brautigam."
"Bug Marline Burlingame."
"Bug Marren Bumgarner."
"Bug Marta Baumgart."
"Bug Mary Amburgy."
"Bug Mathus Stumbaugh."
"Bug Nine Buening."
"Bug Noah Boughan."
"Bug Nola Balogun."
"Bug Norah Bronaugh."
"Bug Rana Bangura."
"Bug Rand Bungard."
"Bug Reba Burbage."
"Bug Ren Bunger-Burgen."
"Bug Rene Buenger."
"Bug Rhea Baugher."
"Bug Rider Burridge."
"Bug Rina Bugarin."
"Bug Rio Burgio."
"Bug Ron Ogburn."
"Bug Ros Burgos." []
"Bug Rosander Darensbourg."
"Bug scam scumbag." []
"Bug Shala Slabaugh."
"Bug Shayla Slaybaugh."
"Bug Sheri Berghuis."
"Bug Soren Burgeson." []
"Bug Tenisha Stinebaugh."
"Bug Tera Gaubert."
"Bug Thomas Stombaugh."
"Bug Thora Trobaugh."
"Bug Tosha Stobaugh." []
"Bump Ola Palumbo."
"Burn Ada Brandau."
"Burn Aldo Bourland."
"Burn Dee Bendure." []
"Burn Della Rubendall." []
"Burn Dick Bundrick."
"Burn Ernesto Stoneburner." []
"Burn Evan Vanburen." []
"Burn Gema Guberman." []
"Burn Gia Bugarin." []
"Burn Gil Burling."
"Burn Hae Haubner."
"Burn Hosea Barnhouse." []
"Burn Inge Bruening." []
"Burn Kasi Urbanski."
"Burn Kate Bartunek."
"Burn Ken Brunken."
"Burn Kia Urbanik."
"Burn Lois Burlison."
"Burn Mac Camburn."
"Burn Mack Bruckman."
"Burn Magaret Baumgartner."
"Burn Man Brannum."
"Burn Marge Bumgarner." []
"Burn Miguel Muilenburg."
"Burn Milo Milbourn."
"Burn Ned Bundren."
"Burn Ola Lubrano."
"Burn Rae Brauner."
"Burn Rey Reyburn."
"Burn Roy Norbury."
"Burn Shaw Washburn."
"Burn Shemika Kirshenbaum."
"Burn Son Brunson."
"Burn Tad Burandt."
"Burn Tonda Bondurant."
"Burn Tracey Canterbury."
"Burn Ty Brunty."
"Bury Dan Bunyard."
"Bury Len Burnley." []
"Bury Mel Brumley."
"Buy Alton Labounty."
"Buy Ann Bunyan." []
"Buy Eli Bilyeu."
"Buy Hack Huckaby."
"Buy Kell Bulkley."
"Buy Leo Bouley."
"Buy Marge Amburgey."
"Buy Ola Boulay."
"Buy Rae Aubrey."
"Buy Rand Bunyard." []
"Buy Reda Beaudry." []
"Buy Shaw Bushway."
"Buy Slick Cybulski."
"Buy Spaz-Zaps if protesters return." [x]
"Buy the poor-stinks sponsor kit." [x]
"Buy Wren Newbury." []
"Call back Cal Black."
"Call Ben LeBlanc."
"Call Clint of FlintCo." [x]
"Call Events Steven."
"Call Evites Stevie."
"Call Export Pro Tex." [x]
"Can-Do AdCon and Co: Canon Cad-Do."
"Can Mister Miscreant." []
"Can't Like Nice-Talk Late Nick."
"Cast for factors."
"Cite [crap]. Practice."
"Claret cartel arclet: retract a cell."
"Clean Out UnLateCo." []
"Clear up Pa Clure."
"Closet Telcos."
"Co-opt TopCo."
"Coca Nut Account: Act, UNCO!" []
"Collect flat-due default." [x]
"Collect Up PutCellCo."
"Compress MessCorp."
"Conceal Clean-Co Eco-Clan."
"Confuse FunesCo."
"Congratulate Eco-CEO Coe."
"Conk Up PunkCo."
"Conquer QuernCo."
"Conspire. Jot projections." []
"Consult Luc tons." []
"Convert NVertCo Vectron."
"Convince Ceci Vonn Vennicco."
"Cool Off FloofCo."
"Corral Carl or Cal Orr."
"Corrode OrderCo."
"Cosigning, cognising."
"Cover Up U-Perv-Co." []
"Crack on CrankCo." []
"Cram In Mr. Cain-McNair." []
"Cremate McAteer."
"Cross up SpursCo."
"Crush Abel Laubscher."
"Crush Bee Buescher."
"Crush Britney Christenbury."
"Crush Chad Schuchard."
"Crush Inge Scheuring."
"Crush Lee Schueler."
"Crush Nigel Luchsinger."
"Crush Rae Rauscher."
"Crush Terra Carruthers."
"Cull Annie Cullinane."
"Cull Ariel Lucarelli."
"Cull Dario Couillard."
"Cull Eda Caudell."
"Cull Elsa Clausell."
"Cull Enos Counsell."
"Cull Gina Culligan."
"Cull Gooch Colclough."
"Cull Ida Caudill."
"Cull Lew Culwell."
"Cull Macey Mccaulley."
"Cull Marc Mccullar."
"Cull Mina Mullican."
"Cull Mo Collum."
"Cull Nina Cullinan."
"Cull Rae Cuellar."
"Cull Roe Cerullo."
"Cull Thersa Altschuler."
"Cull Toi Cutillo."
"Cull Toni Culliton."
"Curt pity void = PRODUCTIVITY."
"Cut Down WundtCo."
"Cut off TuffCo."
"Cut Out TutuCo."
"Cut Sean, Nutcase." []
"Cut/flay faculty."
"Damn, fire Friedman, Janitor in a Jort."
"De-frock Eckford."
"De-Rank Kendra." []
"Deal with Ald. White." []
"Deal with Thad Weil, Dale Whit." []
"Declare Rec-Lead: Cal Reed." []
"Decrease Ed Cesare." []
"Deem Dent Demented."
"Defer a fad ere feared ad-free."
"Defer Dr. Fee."
"Defer Fred E. Feder. Redef." []
"Deflate Daft Lee."
"Deflate Ted Leaf." []
"Delay/skew weekly ads." []
"Demerits: Redist [']em." []
"Demote [']em. Dote, Emoted." []
"Demote: bag manager?! Garbage man!" [x]
"Demote, snub. Must be done. Mend? Obtuse!"
"DepotCo: Coopted (?!)"
"Deputise Deputies." []
"Designer Ed Singer? Re-signed!"
"Dis Al Dials."
"Dis Alan Saladin." []
"Dis Alona Saladino." []
"Dis Alva Dasilva." []
"Dis Angele Deangelis." []
"Dis Ann Sandin."
"Dis Arlen Sindelar." []
"Dis Belle Debellis."
"Dis Chet Scheidt." []
"Dis Connie Considine."
"Dis Dona Addison." []
"Dis Elva Desilva-Vidales." []
"Dis Eva Davies." []
"Dis Garnet Grinstead." []
"Dis Geno Godines."
"Dis Hong Hodgins."
"Dis Kena Deakins."
"Dis Lan Landis." []
"Dis Lee Seidel." []
"Dis Lelah Dashiell." []
"Dis Leta Tisdale." []
"Dis Mae Demasi." []
"Dis Mona Madison." []
"Dis Monte Edmiston." []
"Dis Neal Daniels." []
"Dis Ned Eddins."
"Dis Nelly Lindsley."
"Dis Noe Edison-Eidson." []
"Dis Norah Hardison." []
"Dis Nova Davison." []
"Dis Nyla Lindsay." []
"Dis Peter Depriest." []
"Dis Rana Sardina." []
"Dis Rina Siniard."
"Dis Ruben Burnside."
"Dis Tamera Armistead." []
"Dis Telma Milstead." []
"Dis Tona DiSanto." []
"Dis Vonda Davidson." []
"Disabuse bad-issue sub-ideas."
"Discharge Chad Greis."
"'Discount a custodian.'"
"Dishearten Eisenhardt." []
"Disturb Stu Bird."
"Ditch Ms. Schmidt."
"DO nix Dixon."
"Dodgy OAs != good days."
"Dog Ed Dodge."
"Don't Aid Ian Todd."
"Dope-[a-word] ad posse aped? SOS."
"Double-cross bold sources."
"Draw Al Alward."
"Draw Allen Wallander."
"Draw Bell Bradwell."
"Draw Bo Boward."
"Draw Don Downard."
"Draw Eboni Boardwine."
"Draw Ed Edward."
"Draw Eda Dewaard."
"Draw Edson Edwardson."
"Draw Engel Greenwald."
"Draw Ennis Niswander."
"Draw Flo Waldorf."
"Draw Gennie Winegarden."
"Draw Gino Winograd."
"Draw Hana Randhawa."
"Draw Hick Hardwick."
"Draw In Darwin."
"Draw Leif Warfield."
"Draw Len Waldner."
"Draw Leung Grunewald."
"Draw Lili Williard."
"Draw Lily Willyard."
"Draw Ling Ringwald."
"Draw Lon Rowland."
"Draw Neil Reinwald."
"Draw Olsen Rosenwald."
"Draw Rod Dorward."
"Dub Bud, Bub DUD."
"Dupe Al Depaul."
"Dupe Ara Drapeau." []
"Dupe Ola Depaulo." []
"Dupe Tana Patnaude."
"Dupe Ty Deputy."
"Earn it. Retain." []
"Elate Teela, Leeta."
"Elongate? Negate Ol['] Eagleton."
"Elston's = net loss."
"Embargo Bergamo." []
"Employ Mo Pyle, Leo Pym." []
"Enamour Morneau."
"Endorse [if player is male]Ron De[else]Doren[end if]e's Son, Reed." []
"Endorse Ned Rose." []
"Enjoin Jonnie."
"Entrain Tiernan."
"Establish Lisabeth's."
"Estrange Negaters." []
"Ethical Lie-Chat."
"Extort Rex Ott."
"Feast on No-Feats Stefano."
"Finance Inn Cafe." []
"Find gun funding."
"Finesse Sin-Fees." []
"Fire Ali Alfieri."
"Fire Allan Farinella." []
"Fire Ann Fineran."
"Fire Arlene Lafreniere."
"Fire Dan Defrain." []
"Fire Del Fiedler." []
"Fire Dengel Greenfield." []
"Fire DeWalt Waterfield." []
"Fire Dina Frediani."
"Fire Ed Friede-Feider." []
"Fire Elrod Delfierro."
"Fire Esch Schiefer."
"Fire Goon Forgione." []
"Fire Gus Figures."
"Fire Hilda Hairfield."
"Fire if-er. Refi."
"Fire Jen Jenifer."
"Fire Ling Frieling." []
"Fire Lola Fiorella-Fariello."
"Fire Lord Reliford." []
"Fire Luis Fusilier."
"Fire Lyda Rayfield."
"Fire Mace Facemire."
"Fire Madonna Manfredonia."
"Fire Mark Freimark."
"Fire Meng Emfinger."
"Fire Moll Fillmore." []
"Fire Mona Finamore."
"Fire Ned Frieden." []
"Fire Nolton Florentino." []
"Fire Sina Serafini."
"Fire someone over Garage B garbage." [x]
"Fire Son Frieson."
"Fire Sona Serafino." []
"Fire Stan Stanifer."
"Fire Sultan Saintfleur." []
"Fire Syed Seyfried."
"Fire Tito Fioretti." []
"Fire Tova Favorite." []
"Fire Tran Ferranti."
"Fire Wen Winfree."
"Fire Zona Fiorenza." []
"Firstly, rift, sly. Stir. Fly."
"Fix a ton of taxin[']."
"Fixer X: Fire."
"Flag Anna Flanagan."
"Flag Dorn Langford."
"Flag Kerin Garfinkel." []
"Flag Moen Fogleman."
"Flag Nina Flanigan."
"Flag Rand Landgraf."
"Flag Reid Garfield." []
"Flag Renee Greenleaf."
"Flag Roe Laforge." []
"Flag Wong Wolfgang." []
"Flag Worm Wolfgram."
"Fling Wade's design flaw."
"Flog a slob, goofballs, Olaf's Blog."
"Floor Rolf-o or Flo."
"Focus on SoFunCo."
"Force RefCo Coercer Off."
"Foster fad tradeoffs."
"Fred I. Freid: if Red, Fired!" []
"Fry Ada Fayard."
"Fry Alan Flanary." []
"Fry Delia Rayfield." []
"Fry Dora Rayford."
"Fry Eli Friley."
"Fry Gale Flygare."
"Fry Gato Fogarty." []
"Fry Heintz Fitzhenry."
"Fry Ida Friday." []
"Fry Lea Farley." []
"Fry Leann Flannery." []
"Fry Leo Florey."
"Fry Letha Flaherty." []
"Fry Lowe Wolfrey." []
"Fry Maren Ferryman."
"Fry Neal Flanery." []
"Fry Noe Forney."
"Fry Tera Raftery." []
"Fry Thea Faherty."
"Gag Bab, gab-bag."
"Gall Adrian Gandarilla."
"Gall Arie Allgaier." []
"Gall Audie Delaguila." []
"Gall Ben Bagnell."
"Gall Cain Calligan."
"Gall Chet Gatchell."
"Gall Dan Galland."
"Gall Dean Langdale."
"Gall Deann Langeland."
"Gall Dora Gallardo." []
"Gall Eden Delangel."
"Gall Elvin Glanville."
"Gall Erica Callegari." []
"Gall Erin Allinger-Gilleran." []
"Gall Ernie Langelier." []
"Gall Ervin Granville." []
"Gall Esta Steagall."
"Gall Gina Galligan."
"Gall Hana Gallahan."
"Gall Ian Gallina."
"Gall Iona Galliano."
"Gall Jenise Jeangilles."
"Gall Joie Jagiello."
"Gall Lin Langill."
"Gall Mei Millage." []
"Gall Min Gillman."
"Gall Mona Magallon."
"Gall Nat Gallant." []
"Gall Neal Langella."
"Gall Neil Langille." []
"Gall Noe Agnello-Angello." []
"Gall O'Neil Angelillo."
"Gall Rae Allegra." []
"Gall Reda Gardella."
"Gall Rey Gallery."
"Gall Rhea Gallaher."
"Gall Roni Granillo." []
"Gall Sina Langlais."
"Gall Tennie Gallentine."
"Gall Tina Gallatin."
"Gall Ute Legault."
"Gall Winford Wallingford."
"Gall Winton Wallington."
"Gank Kang."
"Gaslight Hal Tiggs." []
"Gaslight Tal Higgs." []
"Get a tie on! Negotiate!"
"Get Hines Seething."
"Get so-so stooges, toss ego."
"Get soil so legit to Giles." []
"Give Short Oversight." []
"Go paste Potages Gestapo."
"'Grab. Brag. Brag. Grab.'"
"Gut-diss, Disgust Sid Stug." []
"Hammer Mr. Mahe."
"Haste sux, exhausts."
"Haste to hot seat. Oh, taste."
"Have Ron Han Over." []
"Hint here then hire."
"Hire Ed Heider."
"Hire Eda Heredia."
"Hire Elsa Aleshire."
"Hire Jame Jeremiah."
"Hire Les Heisler." []
"Hire Maud Muirhead."
"Hire Rand Reinhard."
"Hire Sand Sheridan." []
"Hire Sy Shirey."
"Honor Ron Ho."
"Hurt Abe Haubert."
"Hurt Adelson Southerland." []
"Hurt Bonilla Halliburton." []
"Hurt Byrnes Huntsberry."
"Hurt Caleb Culbreath." []
"Hurt Carma Macarthur." []
"Hurt Cesar Caruthers."
"Hurt Clem Mutchler."
"Hurt Eck Kutcher."
"Hurt Enos Southern." []
"Hurt Gale Laughter."
"Hurt Gene Guenther."
"Hurt Glen Hultgren."
"Hurt Marc Mcarthur." []
"Hurt Schoen Hutcherson."
"Hurt Segal Slaughter." []
"Hurt Shay Hayhurst." []
"Hype Ace Peachey."
"Hype Brent Penberthy."
"Hype Les Shepley."
"Hype Lis Shipley." []
"Hype Perl Pelphrey."
"Hype Sal Shapley."
"Hype Stan Stephany." []
"ID rascal radicals."
"IDEAS. I.e. ADS." []
"(Illegible.) But sly. Subtly." [x]
"Impress [if player is male]Mr. Sipes[else]Ms. Pires[end if]."
"Improve MORE, VIP!"
"Ink Cost: Stick on SkintCo." []
"Irk Glen Klinger-Kringle, Gil Kern."
"Isolate East Oil."
"Josh Ann Johanns."
"Josh Iona Hinojosa."
"Keep out Pete Kuo." []
"KO Rob Brook."
"Land Alec Candella."
"Land Asa Saldana."
"Land Ash Sandahl."
"Land Asha Lashanda."
"Land Bo Blando."
"Land Bree Breeland."
"Land Buck Backlund."
"Land Cara Calandra."
"Land Cari Cardinal."
"Land Carl Crandall."
"Land Celine Clendaniel."
"Land Cher Chandler."
"Land Clare Callander."
"Land Cora Calandro."
"Land Devera Landaverde."
"Land Earl Nardella."
"Land Ed Deland."
"Land Eli Daniell."
"Land Elma Allemand."
"Land Elsa Lansdale."
"Land Elvia Villaneda."
"Land Ely Yandell."
"Land Eric Calderin."
"Land Erica Cardinale."
"Land Erma Alderman."
"Land Eryn Nylander."
"Land Esta Eastland."
"Land Evan Vandalen."
"Land Flo Lofland."
"Land Gale Langdale."
"Land Gema Magdalen."
"Land Geri Aldinger."
"Land Gil Gilland."
"Land Ha Handal."
"Land Herma Halderman."
"Land Homer Holderman."
"Land Hugo Hoaglund."
"Land Iona Andolina."
"Land Isa Saladin."
"Land Kera Lakendra."
"Land Kris Slinkard."
"Land Lea Lalande."
"Land Lee Allende."
"Land Leoma Lamendola."
"Land Les Sandell."
"Land Lewis Willadsen."
"Land Lorie Nardiello."
"Land Love Loveland-Loveland."
"Land Mae Adelman."
"Land Maren Randleman."
"Land Mary Maryland."
"Land Maura Marulanda."
"Land Mei Idleman."
"Land Meier Ermelinda."
"Land Mel Melland."
"Land Min Lindman."
"Land Mina Lindaman."
"Land Mo Dolman."
"Land Moe Mendola."
"Land Mose Smaldone."
"Land Noe Donelan."
"Land Omega Magdaleno."
"Land Omer Molander."
"Land Ona Andalon."
"Land Owens Lansdowne."
"Land Rees Selander."
"Land Ren Lennard."
"Land Rico Alcindor."
"Land Rio Orlandi."
"Land Rob Borland."
"Land Rod Darnold."
"Land Rose Alderson."
"Land Rosia Rosalinda."
"Land Rosie Leonardis."
"Land Rubi Brunilda."
"Land Sal Sandall."
"Land Santa Stanaland."
"Land Scot Scotland."
"Land Soo Soldano."
"Land Soon Donalson."
"Land Sun Naslund."
"Land Tami Maitland."
"Land Theo Odenthal."
"Land Usha Lashunda."
"Land Val Vandall."
"Land Vi Davlin."
"Land Yee Delaney."
"Land Yen Neyland."
"Layoff Alf Foy." []
"Let bums stumble."
"Lied about? Be outlaid?! Bailed out."
"Lobby for weirdos['] dowries."
"Locate Cole at LateCo Ace Lot."
"Lock in LinkCo."
"Lock out KloutCo."
"Log more leg room."
"Look ahead. Hook a deal."
"Lose Albert Ballestero."
"Lose Alvin Sevillano."
"Lose Andre Rosendale."
"Lose Bert Stroebel."
"Lose Brandt Balderston."
"Lose Brant Albertson."
"Lose Bree Ebersole."
"Lose Brent Bertelson."
"Lose Candi Scialdone."
"Lose Cari Cerasoli."
"Lose Carl Calleros."
"Lose Carmen Colmenares."
"Lose Cher Loescher."
"Lose Chin Nicholes."
"Lose Clair Caroselli."
"Lose Clara Carosella."
"Lose Colt Costello."
"Lose Cyr Crosley."
"Lose Dan Adelson."
"Lose Dan'l Lonsdale."
"Lose Dara Delarosa."
"Lose Darci Decarolis."
"Lose Darin Leonardis."
"Lose Deb Bledsoe-Bedsole."
"Lose Diann Danielson."
"Lose Donn Donelson."
"Lose Doris Delosrios."
"Lose Elli Loiselle."
"Lose Ernest Rosensteel."
"Lose Friend Rosenfield."
"Lose Gena Eagleson."
"Lose Ian Eliason."
"Lose Ida Dalesio."
"Lose Irvin Livernois."
"Lose Isa Alessio."
"Lose Ivan Lievanos."
"Lose Kim Moleski."
"Lose King Gilkeson."
"Lose Kym Molesky."
"Lose Lin Ellison."
"Lose Link Kellison."
"Lose Lyn Ellyson."
"Lose Mana Salamone."
"Lose Mark Marsolek."
"Lose Meta Altemose."
"Lose Mila Masiello."
"Lose Min Limones."
"Lose Mona Salomone."
"Lose Ned Edelson."
"Lose Pam Pomales."
"Lose Pan Napoles."
"Lose Rand Alderson."
"Lose Rhett Hostetler."
"Lose Riva Olivares-Oliveras."
"Lose Rod Dolores."
"Lose Sandra Alessandro."
"Lose Sang Gonsales."
"Lose Su Soules."
"Lose Tess Stoessel."
"Lose Thor Osterloh."
"Lose Val Ovalles."
"Lose Vern Leverson."
"Lose Von Novosel."
"Low prank? Plan! Work!"
"Mail Liam a Mil." []
"Make Linda kinda lame."
"Malign Al Ming-Gilman."
"Mar a nice American." []
"Mar Abel Marable."
"Mar Ada Madara."
"Mar Agnus Sugarman."
"Mar Al Lamar."
"Mar Alden Alderman." []
"Mar Alec Maracle." []
"Mar Alica Calamari."
"Mar Andy Maynard." []
"Mar Angelo Melaragno."
"Mar Anna Maranan."
"Mar Anson Sanroman."
"Mar Arnett Ratterman."
"Mar Asa Samara."
"Mar Ash Sharma." []
"Mar Bart Bartram."
"Mar Beau Rambeau."
"Mar Bee Beamer."
"Mar Ben Rebman."
"Mar Billie Mirabelli."
"Mar Blue Baumler."
"Mar Bo Rambo-Bomar."
"Mar Bond Brodman."
"Mar Bryce Mcbrayer."
"Mar Buster Burmaster."
"Mar Cain Macnair." []
"Mar Cala Lamarca."
"Mar Chante Catherman."
"Mar Chi Marchi-Hamric-Marich."
"Mar Codi Dimarco." []
"Mar Cody Carmody." []
"Mar Cole Marcelo." []
"Mar Dale Delamar."
"Mar Dan Armand." []
"Mar Dana Maranda."
"Mar Dean Aderman." []
"Mar Dee Meader-Madere-Maeder-Deamer."
"Mar Del Delmar."
"Mar Deon Medrano-Dameron-Dearmon." []
"Mar Dina Miranda." []
"Mar Dinah Hardiman." []
"Mar Dion Mirando-Rimando-Morandi." []
"Mar Dione Demarino." []
"Mar Dionna Mandarino." []
"Mar Don Dorman." []
"Mar Dona Armando-Marando." []
"Mar Donn Normand-Nordman." []
"Mar Dylan Maryland."
"Mar Earl Lamarre."
"Mar Ed Mader." []
"Mar Eden Deerman." []
"Mar Edson Soderman." []
"Mar Elden Melander."
"Mar Eldon Moreland-Molander." []
"Mar Elia Laramie." []
"Mar Ella Marella-Ramella."
"Mar Ellen Ellerman."
"Mar Elli Mirella."
"Mar Ellis Miralles."
"Mar Elsa Ramales." []
"Mar Elvin Liverman." []
"Mar Enos Roseman." []
"Mar Erin Mariner."
"Mar Ernesto Monserrate." []
"Mar Estell Masteller."
"Mar Ethyl Matherly." []
"Mar Etta Mattera-Armetta." []
"Mar Ettie Mariette."
"Mar Fidel Armfield." []
"Mar Flo Folmar-Marolf." []
"Mar Gant Gartman."
"Mar Gay Magyar."
"Mar Genaro Garramone."
"Mar Genie Germaine."
"Mar Genna Angerman."
"Mar Geri Armiger." []
"Mar Gilda Madrigal." []
"Mar Glen Almgren."
"Mar Greta Margaret." []
"Mar Hana Rahaman."
"Mar Handy Hardyman."
"Mar Hans Sharman."
"Mar Henson Hermanson."
"Mar Hines Shireman."
"Mar Hong Grohman."
"Mar Ian Marina."
"Mar Ike Markie."
"Mar Ilene Eilerman." []
"Mar Ines Reisman-Marines-Erisman." []
"Mar Inge Germain." []
"Mar Inger Merrigan." []
"Mar Iola Almario."
"Mar Iona Mariano." []
"Mar Ione Romaine." []
"Mar Jae Jarema."
"Mar Jan Jarman."
"Mar Jason Monjaras."
"Mar Jeanie Jeanmarie."
"Mar Jen Jerman."
"Mar Jo Major."
"Mar Joi Armijo."
"Mar Joie Majorie."
"Mar Jon Jarmon."
"Mar Karina Markarian."
"Mar Kathe Hatmaker."
"Mar Ken Kerman."
"Mar Kera Ramaker."
"Mar Kyle Markley." []
"Mar Lance Maclaren." []
"Mar Lanita Lamartina."
"Mar Latonia Altamirano."
"Mar Lea Melara."
"Mar Lee LaMere."
"Mar Len Lerman."
"Mar Leo Morale."
"Mar Leon Monreal." []
"Mar Leona Molenaar." []
"Mar Leora Laramore." []
"Mar Leota Altomare." []
"Mar Les Lamers-Amsler."
"Mar Leslie Marseille." []
"Mar Lev Marvel."
"Mar Lew Walmer." []
"Mar Lila Mallari." []
"Mar Lionel Romanelli." []
"Mar Lon Molnar." []
"Mar Lore Larmore."
"Mar Loree Morreale."
"Mar Loren Monrreal."
"Mar Lorie Larimore-Lairmore."
"Mar Lorrie Larrimore."
"Mar Lou Lamour."
"Mar Lyle Mallery."
"Mar Mel Rammel."
"Mar Mila Mamaril."
"Mar Nat Artman."
"Mar Ned Redman-Menard."
"Mar Neil Lierman." []
"Mar Nick Rickman." []
"Mar Nicole Marcelino." []
"Mar Nicolle Marcellino." []
"Mar Niki Minarik." []
"Mar Noe Marone-Ramone." []
"Mar Odell Delmoral." []
"Mar Ok Marko-Komar."
"Mar Ola Lamora-Alomar."
"Mar Olin Molinar." []
"Mar Opal Palomar."
"Mar Oren Marrone."
"Mar Peg Pegram."
"Mar Peter Parmeter." []
"Mar Ree Reamer."
"Mar Reyes Ramseyer."
"Mar Roe Morera."
"Mar Ruby Marbury."
"Mar Sabina Barsamian."
"Mar Sade Dearmas." []
"Mar Sadie Demarais." []
"Mar Saran Ramsaran."
"Mar Seth Mathers." []
"Mar Shane Shearman."
"Mar Shanice Marchesani."
"Mar Shon Horsman."
"Mar Sid Mardis-Simard."
"Mar Silas Marsalis."
"Mar Sina Samarin."
"Mar Son Ransom-Romans-Marson-Rosman-Ramson." []
"Mar Stan Starman." []
"Mar Stone Sarmento." []
"Mar Stones Masterson." []
"Mar Sue Mauser-Semrau." []
"Mar Sun Mansur."
"Mar Tama Tammara."
"Mar Tena Armenta."
"Mar Terese Estremera."
"Mar Teri Martire."
"Mar Tess Masters."
"Mar Tien Armenti." []
"Mar Tina Martina-Martian." []
"Mar Tito Marotti."
"Mar Toi Morita."
"Mar Tomaso Matamoros."
"Mar Toni Martino-Mitrano."
"Mar Tonia Taormina." []
"Mar Toshia Tamashiro."
"Mar Trisha Arrasmith." []
"Mar Vanda Vardaman."
"Mar Von Vroman."
"Mar Wes Wasmer-Wamser."
"Mar Zack Marczak."
"Mar Zita Maritza."
"Mar Zoe Rozema."
"Mar Zona Marzano."
"Meet Dr. O. Ted Rome, Demoter."
"Meeting: get [']em in, get mine."
"Memo: Cut Commute."
"Milo's Limos: moil, lissom."
"Miss Don Simonds."
"Miss Rene Meissner."
"Moot Karl's LookSmart Talkrooms."
"Nag Al Galan." []
"Nag Amy Gayman."
"Nag Ash Hagans."
"Nag Bert Bangert."
"Nag Bill Balling."
"Nag Bo Bogan." []
"Nag Brice Brigance." []
"Nag Cari Garnica."
"Nag Carin Carignan."
"Nag Carri Carrigan."
"Nag Chi Chiang."
"Nag Dara Gandara." []
"Nag Dee Deegan."
"Nag Delsie Deangelis." []
"Nag Deon Donegan."
"Nag Dora Granado." []
"Nag Doreen Degennaro." []
"Nag Dorine Digennaro."
"Nag Eli Eaglin."
"Nag Elli Gallien." []
"Nag Else Angeles."
"Nag Elvin Langevin."
"Nag Errol Loranger."
"Nag Eura Garneau."
"Nag. File. Finagle.."
"Nag Geri Gagnier."
"Nag Gerri Grainger."
"Nag Herma Hagerman." []
"Nag Hiram Ingraham." []
"Nag Hue Haugen."
"Nag Hulda Haugland." []
"Nag Inell Nelligan." []
"Nag Iola Galiano."
"Nag Kay Kanagy."
"Nag Kerri Kerrigan."
"Nag Korey Kornegay."
"Nag Lee Neagle." []
"Nag Leo Angelo." []
"Nag Leta Galante." []
"Nag Levi Lavigne."
"Nag Li Laing."
"Nag Lili Gillian." []
"Nag Lin Anglin."
"Nag Lina Lanigan."
"Nag Linn Lanning."
"Nag Lise Gelinas-Sinegal." []
"Nag Lore Lagrone."
"Nag Loren Lonergan." []
"Nag Lou Angulo."
"Nag Lyle Langley." []
"Nag Man Mangan."
"Nag Marta Matranga."
"Nag Marth Grantham."
"Nag Mel Gelman."
"Nag Meri Germain." []
"Nag Mills Smalling."
"Nag Mona Mangano."
"Nag Moss Gossman."
"Nag Ned Degnan."
"Nag Olga Galgano."
"Nag Olmeda Magdaleno." []
"Nag Ora Aragon-Arango."
"Nag Rae Reagan."
"Nag Red Grande." []
"Nag Reid Dearing-Reading."
"Nag Reo Orange." []
"Nag Rey Graney-Garney."
"Nag Rob Brogan." []
"Nag Robert Bontrager." []
"Nag Rod Dorgan."
"Nag Rosy Grayson." []
"Nag Rowe Wagoner."
"Nag Roy Gaynor." []
"Nag Rubi Bugarin." []
"Nag Ruth Hartung."
"Nag Samella Magallanes."
"Nag Saul Lagunas."
"Nag Su Angus." []
"Nag Sui Suniga."
"Nag Tara Granata."
"Nag Tia Gaitan."
"Nag Tish Hasting." []
"Nag Tom Montag."
"Nag Tora Tarango."
"Nag Torres Garretson." []
"Nag Tresa Sargeant." []
"Nag Val Galvan."
"Nag Vi Gavin."
"Nag VIP Paving.."
"Nag Weyer Greenway."
"Nag Will Walling." []
"Nag Yael Galyean."
"'Name Sy my sane yes-man.'" []
"Neg Al Lange." []
"Neg Ali Eaglin." []
"Neg Almeda Magdalene."
"Neg Alvin Langevin." []
"Neg Ara Reagan." []
"Neg Art Garten." []
"Neg Astrid Grinstead." []
"Neg Aura Garneau." []
"Neg Bart Bangert." []
"Neg Bo Bogen."
"Neg Bristol Gilbertson." []
"Neg Carlo Longacre."
"Neg Dan Degnan." []
"Neg Delisa Deangelis." []
"Neg Dori Doering." []
"Neg Dorian Digennaro." []
"Neg Eda Deegan." []
"Neg Elsa Angeles." []
"Neg Erica Carnegie." []
"Neg Ha Hagen." []
"Neg Ira Gainer." []
"Neg Irma Germain." []
"Neg Irwin Wininger."
"Neg Karri Kerrigan." []
"Neg Kati Keating."
"Neg Keli Keeling."
"Neg Lea Neagle." []
"Neg Les Engels."
"Neg Lila Gallien." []
"Neg Lisa Gelinas-Sinegal." []
"Neg Lora Lagrone." []
"Neg Lori Olinger." []
"Neg Lorna Lonergan." []
"Neg Lu Leung."
"Neg Lyda Gladney."
"Neg Lyla Langley." []
"Neg Man Engman."
"Neg Marc Mcgrane."
"Neg Maren Greenman."
"Neg Mary Germany." []
"Neg Mel Mengel."
"Neg Miss Messing." []
"Neg Odis Godines." []
"Neg Piper Eppinger."
"Neg Ray Garney." []
"Neg Reid Deering-Edinger." []
"Neg Rhea Henegar."
"Neg Rhoda Hagedorn." []
"Neg Rob Borgen-Bogner."
"Neg Rod Gorden."
"Neg Rolf Lofgren."
"Neg Rose Greeson." []
"Neg Roy Gorney."
"Neg Rubi Breunig." []
"Neg Rubin Bruening." []
"Neg Ruth Gunther." []
"Neg Sam Manges."
"Neg Seth Hentges."
"Neg Sid Dinges."
"Neg Talbert Greenblatt."
"Neg Terra Gaertner." []
"Neg Twyla Gwaltney."
"Neg Walter Greenwalt." []
"Neg Will Welling." []
"Neg Yun Nguyen."
"Negate ol['] Eagleton. Elongate glee a ton." []
"Next Day: Deny Tax."
"Nice-job BenjiCo, Joe B Inc." []
"Nip Matt Pittman."
"Nix Hope Phoenix."
"Nix Mae Maxine." []
"Nix test tent six."
"No Sub-Bonus."
"No to Mr. Ron Tom, To Norm Morton."
"'Once up, pounce.'"
"Only half? Nah, folly."
"Oust Brenner Stoneburner." []
"Oust Codi Custodio."
"Oust dire outsider." []
"Oust Handler Southerland." []
"Oust Len Uselton." []
"Oust Minh Humiston."
"Oust Rico Courtois."
"Out Andre Tondreau."
"Out Arce Croteau."
"Out Barnhill Halliburton." []
"Out Chet Touchet."
"Out Cris Turcios."
"Out Dan'l Daulton." []
"Out Faber Beaufort."
"Out Fern Fortune." []
"Out Fran Fortuna." []
"Out Hy Tuohy."
"Out Laureen Letourneau."
"Out Megan Montague." []
"Out Mei Ouimet."
"Out Minna Mountain." []
"Out Myrl Moultry."
"Out Ninfa Fountain." []
"Out-Plan Al Upton."
"Out-pwn Uptown."
"Out Reid Rideout."
"Out Shon Houston."
"Pack tie, take pic."
"Pass on Spanos." []
"Patronise Petrosian."
"Pester Peters, Streep."
"Pick on PinkCo, cop kin."
"Ping Victor at TrivCo."
"Plan new sugared ad surge."
"Play Les Lapsley."
"Play Mel Lampley."
"Plot lax poll tax."
"Poach Mr. Camphor."
"Pocket KeptCo."
"Polite = top lie to pile." []
"POS SOP: P.S. Oops!"
"Postpone Pop Stone, top peons: open spot." []
"Pot Nat Patton."
"Pre-filing pilfering."
"'Pressure reps? Sure!'"
"Prioritise priorities."
"Promote feel-raw welfare-free law." [x]
"Promote moper to more-top Metro-Op." []
"Prove Cider Overpriced."
"Provoke Poor Kev."
"Put Mr. Trump..."
"Pwn a pawn."
"Rattle Tatler." []
"Re-add dread. Caress scares."
"Re-auth Huerta."
"Re-dock OK-Cred Ed Rock."
"Re-stun unrest."
"Read [i]This Org So Right[r], by Sig Roth."
"Ream/Nag Manager."
"Rec Clean Canceler Clarence."
"Rec Tim's Metrics." []
"Recoup PureCo."
"Redact Traced CD Rate."
"Redo staff tradeoffs." []
"Regroup or purge." []
"Reject Jr. E-tec."
"Remind Dim Ren."
"Reminds: Mr. Denis, Ms. Rendi, Mrs. Nied, Dr. Nimes."
"Remiss misers, sirs? Me?"
"Replace Lee Carp, Creep Al, PC Earle, Carl. Eep!"
"Reprog. Org-Rep Groper."
"Results of the paperboy pay probe." [x]
"Retain Terina Artein." []
"Revenge Ev Green."
"Revoke Keevor. (Ever OK?)"
"Rid Ken 'Red Ink' Kinder." [p]
"Rip Al April." []
"Rip Aron Parrino." []
"Rip Art Artrip."
"Rip Ash Parish."
"Rip Chet Pitcher."
"Rip Dame Dampier." []
"Rip Dan Pinard." []
"Rip Earle Lapierre."
"Rip Ed Pride." []
"Rip Ellen Pellerin." []
"Rip Elma Palmeri." []
"Rip Enos Pierson."
"Rip Ester St. Pierre-Priester."
"Rip Gaye Gariepy."
"Rip Gena Pinegar." []
"Rip Glen Pringle." []
"Rip Ione Pineiro."
"Rip Isa Parisi."
"Rip Kenton Pinkerton."
"Rip Maile Palmieri." []
"Rip Ned Pinder."
"Rip Noe Perino." []
"Rip Oda Parodi."
"Rip Pepe, Peppier Preppie.."
"Rip Rae Rapier."
"Rip Renate Trepanier."
"Rip Rene Perrine."
"Rip Steed DePriest." []
"Rip Tamela Palmatier." []
"Rip Tana Partain-Trapani." []
"Rip Tena Painter." []
"Rip Theo Pothier."
"Rip Van Parvin."
"Rip Zora Pizarro."
"Rise again, gain raise."
"Robo-call Carl Lobo."
"Roil Alba Labriola."
"Roil Alden Nardiello." []
"Roil Alpern Parrinello." []
"Roil Alvin Villarino."
"Roil Avena Valeriano."
"Roil Ben Oberlin." []
"Roil Bev Boliver."
"Roil Carl Carrillo."
"Roil Case Cerasoli." []
"Roil Celsa Caroselli." []
"Roil Chet Clothier."
"Roil Claud Couillard."
"Roil Cleta Tallerico." []
"Roil Dan Rinaldo-Orlandi-Dolinar." []
"Roil Dean Leonardi-Andreoli." []
"Roil Dona Ardolino." []
"Roil Ed Delrio."
"Roil Ely O'Reilly." []
"Roil Ena Loraine."
"Roil Erma Larimore." []
"Roil Eva Alveiro." []
"Roil Evia Oliveira."
"Roil Fenton Florentino." []
"Roil Fred Reliford." []
"Roil Gema Magloire."
"Roil Giunta Rutigliano."
"Roil Glen Ollinger." []
"Roil Ian Liriano."
"Roil Isabel Bellisario."
"Roil Iva Viloria."
"Roil Ives Silverio."
"Roil Jamal Jaramillo."
"Roil Lang Granillo." []
"Roil Leach Chiarello." []
"Roil Leif Fiorelli."
"Roil Leman Marinello." []
"Roil Les Roselli-Ellisor." []
"Roil Levi Riviello."
"Roil Linden Rondinelli." []
"Roil Lori."
"Roil Malone Romaniello." []
"Roil Marc Morrical."
"Roil Mclean Marcellino." []
"Roil Meg Gilmore." []
"Roil Mel Morelli-Morelli." []
"Roil Melvin Vermillion-Vermillion."
"Roil Meta Latimore." []
"Roil Pasquale Pasquariello."
"Roil Rena Lorraine." []
"Roil Sanda Rosalinda."
"Roil Sol Rosillo."
"Roil Son Rolison."
"Roil Soo Solorio."
"Roil Sue Soulier." []
"Roil Tad Altidor." []
"Roil Tom Molitor."
"Roil Una Laurino."
"Routine to inure or unite."
"Rub Off Bo Ruff."
"Ruin Al Laurin."
"Ruin Amado Mouradian."
"Ruin Amos Mansouri."
"Ruin Bao Rubiano."
"Ruin Bell Brunelli." []
"Ruin Bo Rubino."
"Ruin Dale Lindauer." []
"Ruin Deb Burdine-Debruin."
"Ruin Dick Rudnicki."
"Ruin Echo Icenhour."
"Ruin Elsa Saulnier."
"Ruin Geri Guerrini."
"Ruin Ida Arduini."
"Ruin Jo, Junior."
"Ruin Misha Nishimura."
"Ruin Ola Laurino." []
"Ruin Tam Maturin."
"Sack Jon Jackson."
"Sack Tut Attucks."
"Sample Inge Spiegelman."
"Sample Ty Stampley."
"Scam Alana Salamanca."
"Scam Bo Bascom."
"Scam Boren Branscome." []
"Scam Heflin Fleischman."
"Scam Herb Chambers." []
"Scam Leila Escamilla."
"Scam Linde Mcdaniels." []
"Scam Lira Mariscal." []
"Scam Nicola Maniscalco."
"Scam Ora Marasco."
"Scam Rae Maresca." []
"Scam Rena Creasman." []
"Scam Rene Cremeans." []
"Scam Rhee Marchese."
"Scam Shen Chamness."
"Scam Trish Christmas."
"Scoop Ara Caporaso."
"Scoop Artis Cortopassi."
"Scoop Lili Posillico."
"Scoop up US Pop Co."
"Scorn Al Carlson."
"Scorn Anita Scarantino."
"Scorn Asia Cassarino."
"Scorn Blue Culberson."
"Scorn Erik Rickerson."
"Scorn Etta Catterson."
"Scorn Eve Converse."
"Scorn Fae Scarfone."
"Scorn Hal Charlson."
"Scorn Hee Schoener."
"Scorn Ida Scardino."
"Scorn Ike Erickson."
"Scorn Letha Charleston."
"Scorn Lis Crosslin."
"Scorn Louie Cornelious."
"Scorn Mac Mccarson."
"Scorn Maia Marsicano."
"Scorn Nat Cranston."
"Scorn Pia Scarpino."
"Scorn Sal Carlsson."
"Scorn Serna Rosencrans."
"Scorn Si Crossin."
"Scorn Tena Connatser."
"Scorn Tera Contreras."
"Scorn Tia Nicastro."
"Scorn Tinisha Christianson."
"Scorn Tisa Croissant."
"Secure private VIP rate." [x]
"See Dr. Drees." []
"Sell Amy Smalley." []
"Sell Aron Ornellas." []
"Sell Ash Hassell."
"Sell Cari Carlisle." []
"Sell Cher Scheller."
"Sell Dan Sandell." []
"Sell Debi DeBellis." []
"Sell Dirk Driskell."
"Sell Ewa Seawell."
"Sell Iva Sevilla."
"Sell Joni Jellison."
"Sell Kam Maskell."
"Sell Kim Miskell."
"Sell Kina Kinsella."
"Sell Mia Maselli." []
"Sell Rich Schiller."
"Sell Rio Roselli." []
"Sell Sigman Massengill."
"Sell Stan Stansell."
"Sell Tera Estrella."
"Sell Toni Elliston." []
"Sell Ty Stelly."
"Sell Wilt Stilwell."
"Send all and sell." []
"Send Lee Needles." []
"Shadow Ad Show. (How sad!)"
"Shake down Hank Dowes." []
"Shun Bad Husband Dan Bush/Bud Nash." []
"Shut off Stu Hoff."
"Sidestep Despites."
"Sign Adele Deangelis." []
"Sign Alla Langlais." []
"Sign Allain Langlinais."
"Sign Bill Billings."
"Sign Bo Gibson." []
"Sign Bob Gibbons."
"Sign Bree Isenberg."
"Sign Ceola Cangelosi."
"Sign Daron Grandison." []
"Sign Dedra Sandridge." []
"Sign Detra Grinstead." []
"Sign Doe Godines." []
"Sign Ebert Steinberg."
"Sign Ed Dinges." []
"Sign Edda Sandidge."
"Sign Elton Singleton." []
"Sign Ely Singley."
"Sign Gil Liggins."
"Sign Helton Shingleton." []
"Sign Kiser Kissinger."
"Sign Kyle Kingsley."
"Sign Lan Lansing."
"Sign Lea Gelinas-Sinegal." []
"Sign Lew Swingle."
"Sign Lola Langlois."
"Sign Ly Glynis."
"Sign Ma Sigman."
"Sign Marte St. Germain." []
"Sign Marth Stringham."
"Sign Mina Maginnis."
"Sign Mo Sigmon."
"Sign Nell Snelling."
"Sign Ogg Goggins."
"Sign Raisa Ingrassia."
"Sign Reba Basinger."
"Sign Rothwell Ellingsworth." []
"Sign See Genesis." []
"Sign Shera Hassinger." []
"Sign Sol Glisson."
"Sign Ty Yingst." []
"SimplyCo Olympics? Copy, Slim."
"Sink/Tire Kirstein."
"Skin Jen Jenkins." []
"Slam Al Llamas." []
"Slam Alice Escamilla." []
"Slam Angela Magallanes." []
"Slam Ara Marsala."
"Slam Argento Mastrangelo." []
"Slam Arie Marisela." []
"Slam Bertha Halberstam." []
"Slam Boren Rosenbalm." []
"Slam Bree Belmares."
"Slam Breton Lambertson."
"Slam Cari Mariscal-Mariscal." []
"Slam Chang Mcglashan."
"Slam Cher Chalmers-Chalmers." []
"Slam Chet Stelmach."
"Slam Chi Michals."
"Slam Chloe Moschella." []
"Slam Corene Colmenares."
"Slam Dann Landsman."
"Slam Dante Stadelman."
"Slam Deann Landesman."
"Slam Dee Ledesma."
"Slam Deon Smaldone."
"Slam Don Salmond."
"Slam Earl Marsella."
"Slam Ed Delmas."
"Slam Edith Delashmit." []
"Slam Eli Maselli." []
"Slam Eliot Tomaselli."
"Slam Ely Smalley." []
"Slam Ervin Silverman."
"Slam Evon Monsalve."
"Slam Gaines Massingale." []
"Slam Genie Geiselman." []
"Slam Ike Maleski."
"Slam Inge Seligman." []
"Slam Karey Slaymaker." []
"Slam Latrice Macallister." []
"Slam Lea Masella-Salmela." []
"Slam Len Mansell."
"Slam Lin Sillman."
"Slam Lina Mansilla."
"Slam Ling Smalling." []
"Slam Linh Hillsman-Minshall."
"Slam Link Skillman."
"Slam Lise Mellissa."
"Slam Lou Salloum."
"Slam Lue Musella."
"Slam Luigi Guilliams."
"Slam Niki Malinski."
"Slam Penni Spielmann." []
"Slam Pink Lampkins."
"Slam Rand Marsland."
"Slam Risa Marsalis." []
"Slam Rob Lambros."
"Slam Roe Morales." []
"Slam Roth Ahlstrom."
"Slam Sang Glassman."
"Slam Sean Sleasman."
"Slam Shane Hasselman."
"Slam Son Salmons."
"Slam Stan Saltsman."
"Slam Sue Samuels."
"Slam Tera Lamaster." []
"Slam Tod Molstad." []
"Slam Trice Mcalister." []
"Slam Worth Wahlstrom." []
"Slander Ava Vanarsdale." []
"Slander Bo Balderson." []
"Slander Ling Slingerland."
"Slander Oda Dalesandro." []
"Slander Thu Sutherland."
"Slime Al Maselli." []
"Slime Ann Salminen."
"Slime Chana Aeschliman." []
"Slime Chia Michaelis."
"Slime Earl Marseille." []
"Slime Ester Lesmeister." []
"Slime Gena Geiselman." []
"Slime Lon Milleson."
"Slime Ola Masiello." []
"Slime Olin Simonelli."
"Slime Tad Milstead." []
"Slime Thad Delashmit." []
"Slime Ty Smitley."
"Slime Una Suleiman."
"Smash Shams."
"Smoke Arch Schomaker."
"Smoke Ira Kisamore."
"Smoke Lin Mikelson." []
"Smoke Link Mikkelson." []
"Smoke Rhea Shoemaker." []
"So vets veto? Votes stove!"
"Sponsor Madcap Ad Camp."
"Spur. Be Superb."
"Stagier triages."
"Startle Statler."
"Stay, do today's toy ads."
"Steamroll Martello's."
"Stop [n-t] Patteson."
"Stop Ara Spataro."
"Stop Catt Tapscott."
"Stop Ciarlo Policastro."
"Stop Earl Portales." []
"Stop Eli Pistole."
"Stop Erik Petroski."
"Stop Fred Stepford."
"Stop Her Stopher."
"Stop Ira Poitras." []
"Stop Kinn Pinkston."
"Stop Lon Polston."
"Stop Lore Lopresto." []
"Stop Ly Sypolt."
"Stop Mae Postema."
"Stop Marek Osterkamp." []
"Stop Min Timpson."
"Stop Mink Tompkins."
"Stop Nina Spinnato."
"Stop Ola Apostol."
"Stop Rae Pastore." []
"Stop Rahn Sharpton."
"Stop Rana Pastrano."
"Stop Reina Petrosian." []
"Stop Ro Stroop." []
"Stop Roe Stroope."
"Stop Sara Trapasso."
"Stop Sera Peatross."
"Stop Shery Poythress."
"Stop Treanor Paternostro."
"Stop Trena Patterson." []
"Streamline Learn Times."
"StudyCo: CUSTODY."
"Stun Del Lunsted."
"Subdue/sue Bud."
"Subvert, bust Rev. Buster V. Tubvers."
"Sue bar abuser." []
"Sue Marley, Use Mr. Yale."
"Synergise re-yessing synergies."
"Tack on TankCo."
"Tag Ana Nagata."
"Tag Aron Tarango." []
"Tag Burt Garbutt."
"Tag Delma Talmadge."
"Tag Desire Eastridge." []
"Tag Elma Talmage."
"Tag Eura Argueta."
"Tag Herb Gebhart."
"Tag Herr Gerhart."
"Tag Ian Gaitan." []
"Tag Larita Tartaglia."
"Tag Lennie Galentine."
"Tag Leon Gleaton." []
"Tag Lin Gatlin."
"Tag Ling Gatling."
"Tag Lu Gault."
"Tag Marie Armitage." []
"Tag Marna Matranga." []
"Tag Neal Galante." []
"Tag Rana Granata." []
"Tag Rob Bogart." []
"Tag Roe Ortega." []
"Tag Ron Garton."
"Tag Rosa Astorga."
"Tag Rush Shugart."
"Tag Shin Hasting." []
"Tag Snider Grinstead." []
"Tag Son Gaston-Gatson-Sontag." []
"Tag Sonia Santiago." []
"Tag Soo Agosto."
"Tag Tess Gassett."
"Tag Trish Straight."
"Tag Yan Gaytan."
"Tip Bates Baptiste."
"Tip Cher Pitcher." []
"Tip Dara Partida."
"Tip Dorie Dipietro."
"Tip Edgar Patridge." []
"Tip Gerard Partridge." []
"Tip Keren Peterkin."
"Tip Leo Polite." []
"Tip Leona Lapointe." []
"Tip Lola Patillo."
"Tip Lon Lipton."
"Tip Luc Cutlip."
"Tip Man Pitman."
"Tip Nola Lapoint." []
"Tip Ora Poitra." []
"Tip Oren Pointer." []
"Tip Rana Partain-Trapani." []
"Tip Rena Painter." []
"Tip Roe Prieto." []
"Tip Rollo Portillo."
"Tip Rosa Poitras." []
"Tip Santo Pattison."
"Tip Shon Shipton."
"Tip Slade Plaisted." []
"Tire Adams Armistead." []
"Tire Al Altier." []
"Tire Alf Telfair." []
"Tire Alfaro Taliaferro." []
"Tire Ali Altieri."
"Tire Ann Tiernan." []
"Tire Ara Arrieta."
"Tire Arch Reichart." []
"Tire Ash Sherita." []
"Tire Ashli St. Hilaire."
"Tire Barnes Barrientes." []
"Tire Bell Billeter."
"Tire Bella Laliberte."
"Tire Ben Neibert."
"Tire Benson Borenstein."
"Tire Bill Billiter."
"Tire Brenna Barrentine."
"Tire Cal Latrice."
"Tire Cap Patrice." []
"Tire Chan Cathrine."
"Tire Chana Catharine."
"Tire Chet Teichert."
"Tire Chong Creighton." []
"Tire Deb Deibert."
"Tire Dick Dietrick."
"Tire Ed Deiter."
"Tire Ella Telleria."
"Tire Emery Reitmeyer."
"Tire Ennis Reinstein."
"Tire Ensign Steininger." []
"Tire Fran Ferranti." []
"Tire Gail Taglieri."
"Tire Hal Raithel." []
"Tire Hans Isenhart." []
"Tire Hawk Whitaker."
"Tire Ira Iriarte."
"Tire Joan Tinajero."
"Tire Joni Tijerino."
"Tire Lan Lantier." []
"Tire Len Leitner." []
"Tire Mandi Demartini." []
"Tire Marco Cromartie." []
"Tire Mash Hiemstra."
"Tire Mason Sarmiento." []
"Tire Meda Demetria."
"Tire Min Termini." []
"Tire Moon Monteiro."
"Tire Moss Morisset."
"Tire Nat Tainter." []
"Tire Ned Neidert."
"Tire Pa Pitera."
"Tire Palma Palmatier." []
"Tire Pat Pieratt."
"Tire Pope Rippetoe." []
"Tire Rena Renteria." []
"Tire Rob Roberti."
"Tire Ross Rossiter."
"Tire Rossana Santarsiero."
"Tire Sal Lasiter." []
"Tire Sam St. Marie.." []
"Tire Scot Corsetti."
"Tire Shane Eisenhart." []
"Tire Shaw Wisehart." []
"Tire Shona Hortensia."
"Tire Sol Storlie."
"Tire Star Traister."
"Tire Su Uresti."
"Tire Taft Fertitta." []
"Tire Talbot Bartoletti."
"Tire Tama Marietta." []
"Tire Tanner Interrante." []
"Tire Thor Herriott."
"Tire Tom Moretti." []
"Tire Tonda Andreotti." []
"Tire Verna Tavernier."
"Tire Vi Viteri."
"Tire Von Trevino." []
"Tire Wes Siewert-Seiwert." []
"Tire Wm. Witmer."
"Tire Zack Trzeciak."
"To Alf: Alt of Lo-Fat." []
"To N.Y. Co & O'Conty not-coy tycoon."
"Tolerate to relate."
"Traduce Decatur Curated." []
"Transfer Fran Rest."
"Trap Chae Capehart." []
"Trap Devon Davenport." []
"Trap Ernie Trepanier." []
"Trap Ian Partain-Trapani." []
"Trap Ida Partida." []
"Trap Lea Peralta." []
"Trap Leo Laporte."
"Trap Les Stapler-Plaster." []
"Trap Maile Palmatier." []
"Trap Mel Lampert." []
"Trap Sana Pastrana."
"Trap Shon Sharpton." []
"Trap Stone Patterson." []
"Trap/ail partial liar Pat."
"'Treat yon no-treaty, tony-rate attorney.'"
"Trip Ada Partida." []
"Trip Ana Partain." []
"Trip Edgar Partridge." []
"Trip Elyse Priestley." []
"Trip Lee Peltier." []
"Trip Les Spitler."
"Trip Noe Pointer." []
"Trip Renae Trepanier." []
"Trip Tad Pittard."
"Try out Ruy Ott."
"Tug aside gaudiest gut-ideas."
"Uff, torn? Turn off Ton-Ruff Tuff Ron." []
"Un-Block Col. Bunk, Lon Buck."
"Un-rate Nauert."
"Unblock BlunkCo." []
"Underbids? Disburden."
"Unfriend, fire Dunn."
"Upshot: Push to, Uh, Tops."
"Use Pat Up East." []
"Use turf futures."
"Vet Alan Valenta."
"Vet Ali Vitale."
"Vet Aline Valiente."
"Vet Alvin Vanvliet."
"Vet Anson Vanstone." []
"Vet Arnall Vantrella."
"Vet Aron Vetrano."
"Vet Carl Calvert."
"Vet Ester Everetts."
"Vet Gina Vigeant."
"Vet Greta Gravette."
"Vet Ida Devita."
"Vet Ilona Violante." []
"Vet Levan VanVleet."
"Vet Lina Levitan." []
"Vet Linnea Valentine."
"Vet Lita Leavitt." []
"Vet Liz Levitz."
"Vet Loren Leverton."
"Vet Lorena Leaverton."
"Vet Lori Toliver."
"Vet Nasser Servantes."
"Vet Neal Valente."
"Vet Nina Vantine."
"Vet Nola Volante."
"Vet Nona Vannote."
"Vet Noor Overton." []
"Vet Oren Everton." []
"Vet Padron Davenport." []
"Vet Peter Prevette."
"Vet Petra Prevatte." []
"Vet Ranae Navarete."
"Vet Renata Navarette."
"Vet Rita Averitt."
"Vet Rosala Salvatore." []
"Vet Rosi Restivo." []
"Vet Rosia Travieso." []
"Vet Sal Vestal." []
"Vet Sara Tavares."
"Vet Seger Versteeg."
"Vet Sen. Steven."
"Vet Si Tevis."
"Vet Tequila Valiquette."
"Vet Teri Everitt."
"Vex Ari Xavier."
"Vex Rueda Deveraux."
"Vine St.: Invest."
"A vivid ad via David, Avid Diva." []
"Void Sue: Devious."
"Vote duping: don't give up."
"WantCo: Act NOW."
"Ware sly lawyers!"
"Whack Cid Chadwick."
"Whack Erma Marchewka."
"Whack Guia Kawaguchi."
"Whack Miers Wickersham."
"Whack Saito Stachowiak."
"Whack Sen. Schwanke."
"Whack Sid Shadwick."
"Whack Su Sawchuk."
"Whack Thor Hackworth."
"Whack Tien Whitenack."
"A whiner. New hair. Hire? Naw."
"Wrest, Strew."
"Yes, cull Sculley."

table of DIVORCES articles [xxv2]
blurb
"[if player is male]Lawrence Li[else]Cari Newell[end if]'s Wine Cellars" [p]
"Aerologists['] astrologies."
"Aging an['] you: Young again?"
"Alfreda's Real Fads."
"All-Best Ballets."
"Art Cly's Crystal." []
"Babblier, Bribable, I Blabber."
"Babs on Nabobs."
"Bad Style Slated by Lady Best."
"Basinger Sabering." []
"Bein['] Raw Wine Bar Webinar." []
"Bits-O-Obits."
"Bleaching-Change Lib."
"Bloggin['] Big Long Bling: GO!"
"Bluer St. Bustler Butlers."
"(Bribe A) Barbie Babier."
"Brie Bier"
"Broadway's awards! Boy!"
"Cafes in Fascine."
"Calm-Site Climates." []
"Cape Hart Race Path." []
"Charts O['] Hot Cars." []
"Cigars [']N Racings."
"Costy Tyco's."
"Couples Close Up."
"Coy Fans of Cyans so Fancy."
"Cragin Racing." []
"Debutante, Be Attuned!"
"DeCastro's coatdress."
"Delphia's Helipads."
"Diets['] edits."
"Dig posh godship."
"Do I need? O, Indeed!"
"Domestic Stim-Deco." []
"Dragonish Hoardings."
"Drives to Divert so: I'd Strove."
"Ego-Trip: Grope It." []
"Elan Lane." []
"Elegances: See, Glance."
"Elite Sort Lotteries."
"Elitest, I settle." []
"Eloquent Queen Lot."
"Elsha's lashes hassle." []
"Enid Roff, Friend of Fineford." []
"Enrage a Green."
"Envy Row: Very Now."
"Esthete-Teethes."
"Eva's Hot Have-Tos."
"Factor us four cats['] fur coats."
"Far Riser Farrier's Ferraris."
"Fashion of Shani."
"Fast Cars as Crafts."
"Fear Until Ultra-Fine." []
"Few-Needs News Feed."
"Fiances Face Sin."
"Fifi-Coco's Coifs-Foci."
"Fine Car Fancier." []
"Flo Got to Golf."
"For Autos So Far Out."
"Games for Ego Farms."
"Gaudiest Guest-Aid." []
"Gaudiest Suite, Gad." []
"Geothermal Gamer Hotel."
"Glam Note: Gloat, Men! Go Mental." []
"Goal: Mr. Glamor."
"Golf Carts, Logcrafts."
"Golf-Sun Fun-Slog."
"Goon Ted's good nest."
"Got Some Gems Too."
"Grand Sire Drearings."
"Greed, Fur: Drug Free."
"Greed-Sin Designer [if player is male]Sid Green[else]Seri Deng[end if]." []
"Gush: fine Feng Shui."
"Gussied I'd Guess." []
"He Fires Heifers." []
"Heiress Sherise." []
"Heros['] Moil Heirlooms."
"Hi, best be THIS." []
"His want: What's IN!" []
"Hollywood's Lowly Hoods."
"Host Ben the Snob."
"A Host Has To." []
"Hot Perks: The Pork's Posh Trek."
"Hot, want that now!"
"Hut fer the fur."
"I Hit At Tahiti."
"I Master a Maserati."
"I'm-All-Set Meal List."
"Improve-on-Promo Vine."
"In-Touch Count, Hi." []
"Income Dump Compendium." []
"Inside Sets['] Sensitised Tidinesses."
"Interest'n Internets."
"Iseult: Le Suit."
"King is Skiing!"
"A Kitchen's in the Sack."
"Kruschke Chukkers."
"LA Mag: A Glam-Amalg."
"Lefrancois Falconries." []
"Lemon accent concealment."
"LLC: a Call."
"Lord Raab's Labradors."
"Lou Pecor's Super Cool Pool Cures."
"Love-Mart: Mo['] Travel to Marvel!"
"Lucrative Alive Curt." []
"Mad Spoilt Diplomats."
"Maddison Diamonds."
"Man-Glee Melange."
"Marc Lee's Meal Recs."
"Mega-Plus Plumages."
"Mink So Smokin[']."
"More-Gusto Guest Room."
"Most elite mistletoe."
"My neon jet enjoyment."
"My, opera: pay more."
"Nixed Index."
"O Prince Poncier."
"Oho, Gent On the Go." []
"Ol['] Ferg Folger, Golfer."
"Opulent Letup? NO."
"Orient so, sortie on snootier."
"Osseins Session."
"Ostentatious, Toniest Autos."
"Ostracising Organicists."
"Overpriced Divorce Rep Pedro Cervi." []
"Patronage or Pageant."
"Peaseland Esplanade." []
"Pernods: Spend, or Respond."
"A pet? Peat? Tape? Pate!"
"Pets to Top Set."
"Piloto's Poloist Topsoil." []
"Pony rides: yes, drop in!" []
"Poorness Snoopers."
"Porsche Porches."
"Posh dinner endorphins."
"PoshAids Dish Soap."
"Pride: Sin? Inspired!."
"A Prop-Val Approval."
"Pruett's putters sputter."
"Puerta's pasture: rates up!" []
"Put a manor paramount."
"Rapt tipsy party tips."
"Rave Us, Saveur: Suaver Vera-Su."
"Ray Loos: so royal orals, yo!"
"Relisted Deliters." []
"Remapping pampering."
"Repubs: Superb! (Pure BS!)" []
"A rich cult, Ultra-chic."
"The Rich-Hitcher."
"Rich pet pitcher Chet: RIP." []
"Riches Fans['] Franchises."
"Ritzier Terrizi."
"Rovinest Investor."
"RPMs, MSRP."
"Rude Gov Dr. Vogue." []
"Saintfleur ultrafines." []
"Scarcest-Cars Sect."
"Seal skin, sane silk."
"Second-Dens Co."
"Sheep of posh fee."
"Showin['] Who's in: Wish on."
"Sir Ted's Dress-It Strides."
"Sisterly Styliser Lis Strey."
"Sly heir Shirley."
"So afraid? Do safari!"
"So-Forced Food Recs." []
"So Friendly Sold Finery."
"Society's Cosy Ties."
"Solo-profit portfolios."
"Solstice Costlies."
"Spend, See Deepness."
"Spend Short: Posh Trends."
"Spendiest Tepidness."
"Starred Traders."
"Stir crazy? Ritzy cars!"
"Su Sharp's Rush-Spas."
"Suni Tice's Nice Suits."
"Super-Rich Curer-Ship Price Rush."
"SUV Ego Vogues."
"Swankest New Tasks."
"Ten-Squab Banquets."
"Tex Thaler's Tax Shelter."
"Ties Site."
"Tiny Poem: Pony time! Money pit!"
"To flag at golf? Go flat."
"Tompkins Top Minks: Skimp Not." []
"Tons-Wealth Talent Show."
"Top-Class Costs, Pal."
"Top Menu: Put Me On!"
"The top opteth."
"Toss pain into spas."
"Trend Fief: Different, Deft, Finer."
"Tropico Portico."
"Turf-lease ultra-fees: true/false."
"Ultra-Ease Laureates."
"Ultra-Fine Retail Fun." []
"Ultra smooth moolah trust." []
"Un-Idlest: Unlisted? Insulted!"
"Un-thin?! Nuthin[']!"
"Unfurled-Fund Lure." []
"Vain Coast Vacations." []
"Vainest in a Vest."
"Vapid VIP Ad."
"Varasci Caviars."
"Very fun fur envy."
"Vestal Valets." []
"Vi, a Top VIP Tao."
"Vitreous voitures."
"Voguiest Give-Outs."
"Waistlines, A-List Wines."
"Wanty Tawny Wyant."
"Wardrobe raw? Bored? Bader Row!"
"Whiten it: When?" []
"Who's That/What's Hot."
"Wickers Ski Crew."
"Wipers-Outs['] Power Suits."
"Yeah, best by the sea." []
"Yo, Pan a Pony."
"You least eat lousy."
"Your Flux of Luxury."

table of iffy advice [xxv3]
blurb
"Ad month? Hot [d-word]!"
"Ad-shy = shady."
"Adroitly dilatory idolatry: ail? Do try." []
"AFL/CIO? Co-fail!"
"All spent? Let's plan."
"Am Close = LOSE, MAC!"
"Ardent: a trend!" []
"Be [']round. Rebound." []
"Beamy maybe by me? Yea, BAM."
"Beggar bagger gab. Erg."
"Big Tory Bigotry? Bit gory. Grit, boy."
"Bones worn? Brown-nose!"
"Bore [']em? Be more!"
"Bore, or be." []
"Bosses obsess."
"Brightest, right bets."
"Bud, to doubt, but do."
"Business bins['] uses. Busses-in."
"Bust buts: Bub's tuts."
"'Confused? Focus!' - Ned."
"Cope lab: Placebo? Able, cop!"
"Cost-free = scot-free."
"Default flat due? Proper repo PR."
"Derail a idler."
"Deuced? Deduce!"
"'DOER WON.' Worn ode."
"Earning: in range!"
"Eff Eco-Coffee!" []
"Egotist? Got ties?"
"F Softer Efforts!" []
"Facin['] to info? ACT."
"Feel = be feeble."
"Frowny? Fry NOW!"
"Go fret on it? No, forget it."
"Got funded? Don't fudge!"
"Got mere? Get more!"
"Got Narcs? Congrats!"
"Groan over a governor or grave? No."
"Hated? Buts? Tut, bashed buttheads."
"Have cries. Search, vie, achievers."
"'I can'ts?! ANTICS!"
"I persuade! Super idea!"
"'I respect receipts:' rec spite, cite reps."
"Idling bus? Buildings!"
"If at a fit: FIAT."
"If shy, fishy!"
"In the NOW, whine not." []
"Industry runs tidy. [']S un-dirty."
"It? Deed it. Diet-tied."
"Less drugged, less grudged."
"Let soul sell out. Outsell -- Lout Les."
"Lifters? Trifles stifler!"
"Loaf it to fail, ail oft."
"A loner's loaners learn so."
"Loot begging, bootlegging: bilge to gong."
"Mark now, man. Work. Know. ARM." []
"Minutely untimely: le mutiny!"
"Monetised not? Demise!"
"Nag, sly, slangy."
"Negativism?! TIMESAVING!"
"Nicest = INSECT."
"No INV? Innov!"
"Noper-prone? Preen on, pro!"
"Nopers person? None prospers."
"Not a stud? Stand out! Do a stunt!"
"Note greed: get [']er done."
"Obj.: JOB."
"Oh-wells hew LOLs. (S. Howell)."
"Oil expert? Explore it, exploiter!"
"Oiliness lionises!"
"On guilt: lug it? No!"
"Once right: HECTORING." []
"Outsource Courteous."
"Persuasivity? Rue passivity."
"Plan it Pliant!"
"Produce pure OCD!"
"Raucous ego = courageous!" []
"Routine: Rue it? No." []
"Rue Even Revenue? Eu, Never!"
"Scrambling Brings Calm."
"Setup tip: step it up!"
"Skint = STINK!"
"Smart wits twist arms."
"Soho? Shoo!"
"Some bemoan. Some beam on."
"Sportif tips for profits." []
"Stop? Nope. Postpone." []
"Stunk, doc? Don't suck!"
"Stupidity? I tip: study!"
"A swindle! Sane? Wild? Win deals!"
"Tarry, I? Rarity!"
"Those pricy hypocrites['] ropy ethics." []
"To get in, get on it!" []
"Too smug? Mo['] gusto!"
"Trust?! STRUT!"
"When? Not then. Now." []
"Whoot! How to log a goal."
"Whyin[']? Whiny!"
"The wit: whet it!"
"You either UPHOLD or HOLD UP the economy!" [x]
"You're never too aliterate to retaliate." [x]

table of gritty dialogue [xxv4]
blurb
"'*Sob* gin!' / 'Gibson!'" []
"'[d-word-u]! Elf Feldman fled, man.'"
"'A-ok, mob? KABOOM!'"
"'Aargh! Graah! Hagar!'"
"'Ab push bash up? Buh, sap!'"
"'Ace, hi!' 'Ah...ice! I ache!'"
"'Ach, conk Hancock.'"
"'Ach so! A cosh! Chaos!'"
"'The acid, it ached. Hide, cat!'"
"'Ack, do it to a DICK.'"
"'Ack, mind? Dick, man!' / 'Mad, Nick?'" []
"'Ack! Ow! Wacko!'"
"'Acrimony, Mac. Irony. Corny, am I?'" []
"'Ad hominem? Mind a home, monied ham!'"
"'Admire? Idea, Mr.: Raid [']em!'" [] [p]
"'Affinity? Tiffany, I...'"
"'Age-flab, fleabag!'"
"'Agree, Ragee!'" []
"'Ah, [d-t] had to do tha...' / 'Oh, DAT?'"
"'Ah! A dime! I'm ahead!'"
"'Ah-ah-AH! Hahahahahaha!'"
"'Ah, dupes! Heads up!'" []
"'Ah, Flo. Fo['] Hal? Oh, Alf.'"
"'Ah, Sid! A dish?' / 'I dash!'" []
"'Ah, ted hated Death...'" []
"'Ah, Wes Hawes! He was...'"
"'Ah, wit! What I hit? Aw.'" []
"'Aha, Ed, ahead!'"
"'Aha, tot-dope!' / 'Potato head!'"
"'Ahem, it's shame, it...'" []
"'Ahem, Kit. TAKE HIM.'"
"'Ahem, Ma!' / 'Eh?'"
"'Ahem, son. No shame?'" []
"'Ahem...Mr Hammer? Harm [']em!'" []
"'Ahh, Ed. He had da...ehh?'"
"'Ahmed had me. He mad!'" []
"'Ahoy!' / 'Oh, ya. Ha. Yo!'"
"'Aid cut? Ay. Audacity!'"
"'Ail, Fatty? Fatality!'"
"'Aim west! Waste [']im!' / 'Me? It was...'" []
"'Air hockey? Yeah, I rock.'"
"'Al, I ail!'" []
"'Alf's in! Finals!'"
"'Alibi? I bail.'"
"'Alibis, not libations!'"
"'Alive, OK, go, give a look.'"
"'Allo, Lola!' / 'Ol['] Al!'"
"'Alphonse, phone Sal.'"
"'Am I one? Anomie!'"
"'Ambush! Ha, bums, bash [']um!'"
"'Amigo! Go!' / 'I am!'"
"'And bestow beatdowns to bad news.'" []
"'And GIT, Nat. Dig?' / 'Dang it!'"
"'And I'm admin! Man, I'd--[d-word], I...'" []
"'Andrew?' / 'Naw, Dre.'" []
"'The angry gentry? HA!'"
"'Anonymous? Man, son, you annoy us mo['].'"
"'Any Bus? A sub?' / 'Nyaa.'"
"'Any posh phony's a spy? Ah, no.'"
"'Any weed, Dewayne?' / 'Aw, needy?'"
"'Apathy, Pat?' / 'Yah.'" []
"'APB: Gil's Big Pals!'"
"'Ape us? PAUSE!'" []
"'Arg! Hood!' / 'Road hog!'"
"'Argue Mo[']? A Morgue.'" []
"'Arrrested, dearest.'" []
"'As to new at Owen's--no sweat.'" []
"'Ashton has not tons, ha!'" []
"'Ask up, eh? Ha, pukes!'" []
"'Aspirin! ... Rain sip!'" []
"'Assume Seamus sues: Ma amuses.'"
"'At large, Al? Great!'"
"'At Mike! Take [']im! Make it!'"
"'At THIS, that is...'" []
"'Atoning? Giant no!'" []
"'Aw, beer, Reba? Ew!'"
"'Aw, Ike, I...' / 'Weak!'"
"'Aw, it...WAIT!'"
"'Aw! Shot? So what?'"
"'Aw, then. Eh, want new hat?'"
"'Away, thug!' / 'What a guy!'"
"'BACK door! Bad crook!'"
"'Back, still? BLACKLIST!'" []
"'Back us! [']S a buck!'"
"'Bad G! ... D-bag!'"
"'Bad g's? D-bags!'"
"'Bad leg? Beg, lad.'"
"'Bad loss, boss lad.'"
"'Bad men sty? Stand by me.'"
"'Bag THIS, big hats!' / 'Bah, gits!'"
"'Ballet? Be tall!'"
"'Bam! Re-bar [']em!'" []
"'Bam! Shun bum Hans.'" []
"'Band, pal? Bad plan.'"
"'Bane, ma!' / 'Be a man.'"
"'Bash Ed, BS-head. He's bad.'"
"'Be arty? Betray, ye brat!'" []
"'Be done, Bo!' / 'Need...one bed...'" []
"'The bear BEAT HER!' / 'Breathe.'"
"'Beat, Don? Don't be a...'" []
"'Beat down? We not bad!'" []
"'Beat Ed? Debate.'"
"'Beef tins? Benefits be finest!'"
"'Beehive vibe. Eeh.'"
"'Been shot? Be honest.'" []
"'Bend to Deb? NOT!'" []
"'Bet on Ben to not be.'"
"'Bid them debt? HIM?'"
"'Bids? Dibs? BS, I'd...'"
"'Big arm? Grab[']im!'"
"'Big gulp, pig!' / 'Glub!'"
"'Big man, I'm...' / BANG!"
"'Big mouth bigot, hum!'"
"'Big score, bro! E-cigs!'"
"'Big Snob Gibbons?! Sobbing?!'" []
"'Bigfoot? Go to FBI.'" []
"'Bigoted bite, dog!'"
"'Biker Ed be IRKED!'"
"'Bile? Gad, big deal! Be glad I...'" []
"'A bite? I...' / 'Beat it, [a-b]!'"
"'Block ads? Black sod.'"
"'The blow! Belt!' / 'Who?'" []
"'Bo Ewing?' / 'Beg, Wino! Begin...OW!'"
"'Bo! Pal! Bap ol['] Pablo! Bop Al!'" []
"'Bo's guild? Og builds Bug-Idols.'"
"'Bo's...SOB!' / 'So's Bob!'"
"'Bob, any baby?' / 'No.'" []
"'Body-Odor Roddy? Boo!'"
"'Bold hag!' / 'Bald hog!'"
"'Bolt, hicks! This block...' / 'Thick slob!'"
"'Bombard Brad, mob!'"
"'Bongos? Go, snob.'"
"'Bonk Cal Black?' / 'No. Back, Lon!'"
"'Boo, jeer, bore, Joe!'"
"'Book Ma.' / Kaboom! Bam-o! / 'OK.'" []
"'Boor Inn? Robin! No!'"
"'Bop Ron? No prob!'"
"'Botulism? Must boil! Lo, submit!'"
"'Bowels be slow, slob? Ew!'"
"'Bows, NOW!' / 'Wow, snob!'"
"'Bray not, rant boy!'"
"'Breakdown! Debark now!'" []
"'A brick's back, sir! Sick? Bar!'"
"'Bring Mo, Big Norm.'"
"'Bruno! Bo! Run!'" []
"'BS weed, dweebs!'"
"'Bug ME for...? Forge, bum!'"
"'Bum set? Must be. Bust [']em!'"
"'Bungles? Slug Ben!'"
"'A burger, bug?' / 'Rare.'"
"'Burial, eh, blue-hair?'"
"'The bus be shut. Eh? BUST!'"
"'Bus fare?' / 'Sure!' / 'Fab!'"
"'Bust [']im!' / 'Submit!'" []
"'But looky! Too bulky!'"
"'But our rub-out...'"
"'But...' / 'Go to bug Bogut!'"
"'Cackle mob? We welcome back!'"
"'Cake? Sly, Lackeys!'"
"'Calamity? Calm it, ya...!'" []
"'Call it. I'll act.'"
"'Can HE con? No chance!'"
"'Can Mo Macon con Ma?' / 'No, Mac.'"
"'Can't you count? Ay!'"
"'Cat, Ron Cantor can rot!'" []
"'Catastrophe spectator? Ah!'" []
"'Cede-pact? ACCEPTED!'"
"'Cede, son? No, one second...'"
"'Cepeda's escaped! Eep, cads!'"
"'Chased here? Searched, eh? Hard cheese!'"
"'Chat? I'd--cad, hit a ditch!'" []
"'Chat, or torch a hot car?'" []
"'Chess? No, she cons!'"
"'Choke, bald blockhead!'" []
"'Chokiest Thickoes!'"
"'Chow time! Come!' / 'With woe, Mitch!'" [see why 1st 4 words vs next 4 not flagged]
"'Chow yet, chew toy?'"
"'Class, men! Calmness!'"
"'Clot's done. Stone cold.'" []
"'Clout! Do! Out cold, clot duo!'"
"'Co-ship... Hi, cops!'"
"'Coinage ace? Go in!'"
"'Cold! Ed's scolded!'" []
"'A cold, weak deal.' / 'Wacko.'"
"'Columbo! Cool!' / 'Bum!'"
"'Come on, Moe! Con!'" []
"'Command? Mm, can do.'" []
"'Comrades! More cads!'" []
"'The con? CHET? NO!!!'" []
"'Conk Ed?' / 'No, deck Ken, Doc.'"
"'Conk it, Nick, to tick on!'"
"'Cons died? Nice odds!' / 'Snide, Doc.'"
"'Cool it. Co-toil.'"
"'Cough! A gaucho!'"
"'Coughers!' / 'Grouches!'" []
"'Could Luc do...' / 'U CLOD.'"
"'Couple KIDS is locked up!'"
"'Court thus? Ouch! Trust!'"
"'Crank! Bad bankcard!'"
"'Cream-a-camera era, Mac!'" []
"'Crooks ROCK so!'"
"'A crown car now, raw con?'"
"'Cry wolf? Fly, crow!'" []
"'Cull it? Oh, chill out.'"
"'Curt, Gus! Cut rugs!' / 'Guts, cur!'"
"'D'oh! Lew howled!'"
"'Da SOB! So bad. Sad, Bo.'" []
"'Dad! Sue! A dude's DEAD!' / 'Us?'"
"'Dad works? Dorkwads!'"
"'Dammit.' / 'Mad, Tim?'"
"'Damn, D-Man!'"
"'Dan's Beer Brand. See! Seen drab, A Bender's...'" []
"'Dang, it's angst! I'd...'"
"'Dang rap!' / 'Grandpa!'"
"'Daniel nailed denial.'" []
"'Dark room. Mark door.'"
"'Dat so, toads? Sad to...'" []
"'Dat wuss was DUST!'"
"'Dead, hick!' / '[dick-u]head!'"
"'Deadly lady, Ed!'"
"'A death? Me? Meathead!'"
"'Debauchery curbed?' / 'Yeah.'"
"'A def hat...fathead!'" []
"'Def, if sops pissed-off.'"
"'Defeat fate, Ed!'"
"'Deft Dale felt dead. Deflated.'"
"'Defuser? Refused!'"
"'Defy [']em. Feed MY...'"
"'Del wins? SWINDLE!'"
"'Denotate. DETONATE!'"
"'Deputy Ted?' / 'Yup.'" []
"'Did Leo lie? Odd!'"
"'Didact!' / 'Addict!'"
"'Die, Edi Eid!'"
"'Die, Nick!' / 'Nice kid.'"
"'Died, Did [']e? Ed, I'd...'"
"'Diet, Nev? Evident.'" []
"'Dino! Odin! Dion! I'd no...'" []
"'Dirk Irk'd KID R.?!'"
"'Dirt po['] tip, Rod!' / 'Drop it.'" []
"'A dis, bro? So rabid!'"
"'Dis Work? Skid Row!'"
"'Dish, men. He minds? Send him...'"
"'Dislike silk? Die!'" []
"'Disobey? Boy DIES!'"
"'Diss at sadist? It's sad.'"
"'Ditmore's mortised!'"
"'Ditto a gem: got it made!'"
"'A dive, youth? You've had it!'"
"'Do luls so dull? Us, doll?'"
"'Do no harm!' / 'Darn homo!' / 'Oh, random!'" []
"'Do rep, Pedro!'" []
"'Do Stew, wet sod.' / 'Stowed.'"
"'Do work, dork!' / 'Ow!'"
"'Doggy do? Dodgy! Go!" [p]
"'Dolt, be bolted!'" []
"'Don, I see ONE side...'" []
"'Don, Two won't do!'"
"'Don...' / 'Go on, dog!'" []
"'Don't care.' / 'Once? ... Drat.'" []
"'Done, Deon?' / 'No, Ed.'" []
"'Done what? Death now!'"
"'The door's so red-hot!'" []
"'Dope-[a-word] pose? Sad.'"
"'Dopy rant. Don't pray, Don. Party!'"
"'Double duty? Bye!' / 'Dud! Lout!'"
"'Douche!' / 'Ouch, Ed!'"
"'Douchebags! Gauche bods! Badges? Ouch!'"
"'Dough? Go, duh! Do! Ugh!'"
"'Dough? Uh, GOD.'" []
"'Down, cats!' / 'Won't!' / 'Cads.'"
"'Down to now, [d-t].' / 'Won't do.'" []
"'Dr. Agee agreed? Gee! Rad!'" []
"'Drat, big dirtbag. Dig, Bart?'"
"'Drown NOW, Dr.!'"
"'Drub R-Dub!'"
"'Druggie? I? Grudge!'"
"'Drugs, gal?' / 'Sluggard!'"
"'Dual app! Applaud!' / 'Laud pap?'"
"'Dues, bro?' / 'Sore, bud?'"
"'Dumb hat!' / THUD! BAM! 'Mud bath!'"
"'Dumb idea, dude. I...' / BAM! / 'Um, baddie!'"
"'Dump ably. Play dumb.'" []
"'Dunk, Cam!' / 'DUCK, MAN!'"
"'East, man.' / 'Namaste.'" []
"'Eat my meaty..'" []
"'Eat this, atheist!' (It's HATE!)"
"'Ebony be yon, Ben. Yo!'"
"'Ed! [crap-u] red cap!'"
"'Ed, ask a desk.'"
"'Ed, get up! Go! ... Pegged out?'"
"'Ed hid, did he?'"
"'Ed, I...' / 'DIE!'" []
"'Ed Kahn's shanked!'"
"'Ed lugs sludge.'"
"'Ed, Mitch? Ditch [']em!'"
"'Ed's date?' / 'Sedated. Deadest.'" []
"'Ed's not...stoned?'" []
"'Ed's rash!' / 'Ssh, dear.'"
"'Eek, son. So keen?'" []
"'E.g. OFF GEOFF.'" []
"'Eh, I told the idol!'"
"'Eh, I'd hide.'"
"'Eh, jort, Jethro?'"
"'Eh, man? Me? Nah.'"
"'Eh, poor Hooper.'"
"'Eh, scat, cheats!'" []
"'Ehh, boot the hobo!'"
"'Ehh, but the hub, Beth!' / 'Uh?'"
"'Elect turd, deter cult.' Cluttered."
"'Elijah, eh? Jail!'"
"'Emo hearts? Horse meat!'" []
"'Enis, no.' / 'One sin. So?' / 'NINE.'"
"'Entirely tiny leer.'"
"Eponym: 'P-Money!' / 'My peon!'"
"'Er, [s-w]! The IRS! Eh, stir!'" []
"'Er, goon? No gore!'" []
"'Er, noise? No siree!'" []
"'Er, pups! Prep us supper!'"
"'Er, rise, sirree!'"
"'Erin, Wes? Newsier Weiners!'"
"'Er...must...must re-muster...'"
"'Ernie! Irene! In [']ere!'" []
"'Err, Gab? Re-brag!'"
"'Escrow? Cowers!'" []
"'Espionage? Go see pain!'" []
"'Even dice.' / 'Evidence?'"
"'Evers veers? Sever.'"
"'Ew. Bill will be...'" []
"'Ew, Olly.' / 'Ow, Lyle!' / 'Yellow? Yo, well.'" []
"'Ew! Tar water!'" []
"'Eww! You choked!' / 'Eww! You hocked!'"
"'Fab toy, fat yob!'"
"'Face [']em, McAfee!'"
"'Fade, guy!' / 'Udge-fay!'"
"'Fail my family? Flay [']im!' / 'I'm-a fly.'" []
"Faint ropy profanity." [p] []
"'Fake it, cur!' / 'Fruitcake!' / 'Irate [f-w]...'" [x]
"'Fan riot info art? Ain't for faint or...'" [p] []
"'Fashion? Oh, naifs! As if, hon!'" []
"'Fat Fred f-farted!'"
"'Fat Rio! Fair to fiat or air oft?'"
"'Fay, I...' / 'A FYI if ya...'"
"'Fed lie? I'd flee, defile.'"
"'Fed?' / 'Ug.' / 'Fu-GED fudge.'"
"'Felt? No. TEFLON.'"
"'Fiat, sir?' / 'It's fair.'"
"'Fibs? Fail. BAILIFFS!'"
"'Fink, do find ok, kind of? IDK.' / 'F No!'"
"'Finker!' / 'Knifer!'"
"'Fischel filches!'"
"'Fish not fo['] hints! Shift on!'"
"'Fit? Haw. What if...'"
"'Flab, def? BAFFLED!'"
"'Flagrant raft, Lang!'"
"'Flap it? Fat lip!'"
"'A flim-flam? I?'"
"'Flu? Aw, awful.'" []
"'Fly? Ug! Fugly!'"
"'Fondle? Enfold?' / 'Lo, fend!' (fled on.)" []
"'Foot. Toof. FOTO!'"
"'Forming gin from...fig, Norm?'"
"'Foties? Softie.'"
"'Free Us!' / 'Refuse!'" []
"'Fry, cats! Cry fast!'"
"'Fur coats? Factor us four cats, curst oaf!'"
"'Fuss! Make fake sums!'"
"'G'wan, gnaw!' / 'Breakfast steak? Barf!'"
"'Gabe! A beg!'"
"'Gad, I dig. I DID gag.'"
"'Gad, Ken. Ganked.'"
"'Gag! Soft!' a bigot moans." [x]
"'Gah, it's a sight.'"
"'Game's up, smug ape!'"
"'Gamed [']em! Gad!'"
"'Gangsta Stan! Gag!'"
"'Gee, dull leg duel!'"
"'Gee, hurt, thug? [']Ere!'" []
"'Geronimo! Ergo, I'm on.'" []
"'Get Bo to beg!'" []
"'Get by? Beg! TY!'"
"'Get it done, Gene.' / 'Ditto.'"
"'Get Lou to glue 'Ole Gut' Goulet.'" [p]
"'Gil's [a-word] is glass!'"
"'Gin, Tad! Dang it!' / 'Dig, Nat.'" []
"'Give bad vibe? Gad, Big Dave!'"
"'Glib sin, sibling!'"
"'Glue [']im, Miguel!'" []
"'Gnome men, go!'"
"'Go, bum. Mug Bo!'"
"'Go die, Diego!'" []
"'Go, dood! Do good!'"
"'Go drill, old girl!'"
"'Go dumb, dog-bum.'"
"'Go, mite!' . 'I got [']em!'"
"'Go? Nah. Oh, nag, Hogan!'"
"'Go raw. Grow a...' / 'Aw, Rog!'"
"'Go soft? So, GTFO.'"
"'Go, Stella!' / 'Lost a leg. Age tolls.'"
"'Go wash, hags!' / 'Ow! Aw, gosh!'"
"'Gob THIS, big-shot!'"
"'Goddam, Mad Dog!'"
"'Gold door? Drool, dog!' / ' Good Lord.'"
"'Gold rush? Gush, lord!'"
"'Gold tie?! Do legit?' / 'Lodge it. I'd let go.'"
"'Golf's out. GUTS, fool!'"
"'Goober? Booger? Go, bore!'"
"'Goons! Go, son!'" []
"'Gord!' / 'R-Dog!'"
"'Gosh! Tut! Gut shot? Ugh! Tots!'"
"'Got any sin?' / 'Not saying.'"
"'Got fire? Go fer it!' / 'I forget.' / 'To grief!'" []
"'Got mine. Tim?! Gone!'"
"'Gouger? Rousse? Grouse, rogues!'" []
"'Gram snort, Strongarm Armstrong?!'"
"'Grant is a string-gnat! Sir.'" []
"'Grief, us? Figures.'" []
"'Growin['], Ma! Am I wrong?'"
"'Grub, clown? Wrong club!'"
"'A guess: use gas?'"
"'Gun hire! I hunger!'"
"'Gunfire!' / 'Un-grief.' / 'Urg, fine.'" []
"'Gunther rung the hurt-gen!'" []
"'Gus, end Ed's gun nudges!'" []
"'Gus, not GUNS to go nuts!'"
"'Guys, no guns, yo!'"
"'Gym? Er, germy.'"
"'Gypsies?' / 'Yes, pigs?'"
"'Ha, cop! Chop a cap, ho!'" []
"'Ha! Ken's shaken!'"
"'Ha! Won't! No!' / 'What?'" []
"'Hag! Not a thong to hang!'" []
"'Hakon!' / 'O, Hank! OK?' / 'Nah.'"
"'Hal lied! Hide ALL, Delilah!'"
"'Halt [']em, Thelma!'" []
"'Halt! Bestow the last bow!'"
"'Halt, dolt! That'll do.'"
"'Hang [']em, Meghan!'" []
"'Hard booze!' 'Zebra-Hood? Hazed Boor? Razed Hobo?' / 'A bozo herd.'"
"'Hard work.' / 'Hark! Word!'"
"'Hardman Dan, harm!' / 'Hand? Arm?'"
"'Hash [']im, Hamish!'"
"'Hasting, Mr? Hamstring! Sting! Harm!'" []
"'Hate crime? Reach time!'"
"'Hate pinups? Unhappiest!'"
"'Haw. Fit? What if?'" []
"'Haw, it's...' / 'What is' / 'Aw [s-w]...'"
"'Haw. Oft fat? How?'"
"'He's ...' / 'It is the...'"
"'He's a cop. Poaches cheapos.'" []
"'He's subtler. Be ruthless!'"
"'Heal Mr. Mahler, Earl!' / 'Hm?'" []
"'Heat, sir? Share it!'" []
"'Hell, is she ill?'"
"'Henri, a hernia?' / 'Eh, I...ran.'" []
"'Her, I'd rid.' / 'Eh? Hired!'"
"'Herm, a harem!'" []
"'Hey! Geared?' / 'Yeh. Agreed.'"
"'Hey, grunt! They rung! Tyner, ugh!'"
"'Hey, gut the guy yet?' / 'Ugh...'" []
"'Hey, kids! Hid keys?'"
"'Hey! Len Henley!'"
"'Hey, Mo! Homey!' / 'Meh...yo.'"
"'Hi, dolt! Hold it!'"
"'Hi! Enter in THERE!'" []
"'Hi. Gift?' / 'I...' / 'Fight!'"
"'Hi, ok...so I shook...'"
"'Hi! Tag it, gah!'" []
"'Hi, Ted. Ed hit Edith. The Id!' / 'The... I'd...'" []
"'Hi, was a wish...? Aw, HIS?'"
"'Hick Ted? Deck, hit the [dick]!'"
"'Hid late? Halt! Die!'"
"'High-end, ehh?' / 'DING!'"
"'Hire ten in there!'" []
"'His old hold is hid. SOL.'"
"'Hit [']em!' / 'Them? I...' / 'I'M the...'" []
"'Hit Al! I...' / 'Halt it, Hal!'"
"'Hit, bro! I throb!' / 'Oh, BRIT!'"
"'Hit kin? I think...'"
"'Hit Meg?! GET HIM!'"
"'Hit, STAT! That's it!'"
"'Hit Wong's Hot Wings!'"
"'Hive of five-oh!'"
"'Ho, beds! Eh, bods be shod.'"
"'Ho, dog!' / 'Oh, god!'"
"'Ho, dunce! Once, duh!' / 'Ouch, Ned!'"
"'Ho, hasted headshot? Hotheads!'"
"'Ho, pet. Hep to the op?'"
"'Ho, Rey!' / 'Eh, Roy, yo, her or...hey...'"
"'Ho, snow? No-show.'"
"'Hodges? He's God!'" []
"'Hoes, Tom! Some, hot!' / 'Shoot [']em!'"
"'Hog tips, posh git?'"
"'Hola, Al!' / 'Oh.'" []
"'Holy [crap]! Arch ploy!'"
"'Holy [crap]! Coy Ralph!'" []
"'Hombre! Bro!' / 'Meh.'" []
"'Homes!' / 'Shmoe.'"
"'Hoo-ook! Oooh, KO!'"
"'Hooded, eh? Dodo.'"
"'Hoods!' / 'Doosh!'"
"'Hope? Junk-puke, John!'"
"'Hopeless sops! Heel!'" []
"'Horny stuff turn-off? Shy.'"
"'Hose [']im, homies!'" []
"'Hostages? Hot gases!'"
"'Hot dog! Got... d'oh!'"
"'Hot dogs, gin...good things!'"
"'Hot teen? No teeth!'"
"'Hotwire it!' / 'Er, how?'"
"'How I--ow, hi!'"
"'How is Mr. Wormish?'"
"'How much is chow? Him? Us?'"
"'How soon?' / 'Now! Shoo!'"
"'How stupid! Duh, it's...' / POW!" []
"'Hug a bum? A Humbug!'"
"'Hug, Ace? Gauche!'"
"'Hug some gumshoe? Ug, homes.'"
"'Hum, chow. How much?'"
"'Hyena Haney!' / 'Nyeah!'"
"'A hyper prey, ah? Eh? Pray!'"
"'I, a sly lout?' / 'It's all you!'"
"'I Bag, Big A!'" []
"'I, bathe? Ah, BE it.'"
"'I can't pee!' / 'Patience.'" []
"'I cut one out.' / 'Nice.'"
"'I dearly, readily...'" []
"'I done no...' / 'DIE!'" []
"'I dose, so DIE!'"
"'I got it.' / 'GO!'"
"'I gouged Douggie.'"
"'I, grift? Frig it!'"
"'I had two. D'oh, wait, do I WHAT?!'"
"'I knew Nik. Ew.'"
"'I led you.' / 'YOU LIED!'"
"'I might hit Mig!'"
"'I mug BOTH!' / 'Big mouth!'" []
"'I, new cat, want Ice!'"
"'I ply, boss. Slips? Boy, possibly.'" []
"'I posted deposit! Stop!' / 'Die!'"
"'I refuse?!' / 'Fire! Sue!'"
"'I scent cad accidents.'" []
"'I see new weenies!'"
"'I shot Toshi! / Oh, sit.'" []
"'I show who is!'"
"'I, softer? To fires of tires!'" []
"'I storm on' / 'Sit, moron.'"
"'I swear I was, er, a wiser...'" []
"'I tamper a permit.'" []
"'I tested. It's teed.'"
"'I told Al, do it all, ill toad!'"
"'I undo my...' / 'YOU MIND?'"
"'I...' / 'Do it, idiot!'"
"'I...' / 'Punk, ink up!'" []
"'I...' / 'Slam [']im, Sal!'" []
"'I'd button it? Not, Bud!'"
"'I'd heed Ed Hide.' ... 'He died?'"
"'I'd of' / 'Fido, do, if...'"
"'I'd pay...' / 'Ya dip.'"
"'I'd say Daisy Day is, Saidy!' / 'Dis! Ya!'" []
"'I'd shot its...' / 'Doh, do this.'" []
"'I'd want to down it at...' / 'Wait! Don't!'"
"'I'm about to, bum! Ai!'"
"'I'm back!' / 'Ick!' / BAM!"
"'I'm BOB, bimbo!'"
"'I'm broke.' / 'Bore, Kim. Rob Mike.'"
"'I'm DAT dim at...?' / 'Admit it! Mad!'"
"'I'm hot!' / 'Hit mo[']!'" []
"'I'm Retold, Oldtimer.'"
"'I'm short, Mr! Hoist!'" []
"'I'm so great!' / 'Amigo, REST.'" []
"'I'm sunk in musk.' / 'Um, sink.'" []
"'I'm tired?! Die trim!'"
"'Ice Ben?' / 'Be nice.'"
"'Ick, dude. I ducked.'"
"'Ick, sure. I...' / 'SUCKER!'"
"'ID us? DUIs? U dis!'"
"'Idea-y?' / 'Yea, I'd...' / 'YA DIE.'"
"'Idle sop! Spoiled slop! Die!'" []
"'I.e. fry if yer fiery!'" []
"'I.e. GUNS, genius!'" []
"'If Les files...' / 'If Les flies...'" []
"'If spoke of Spike, skip, foe!'"
"'If Stan faints, in. Fast.'"
"'If the thief, he fit, I.../HEFT!'" []
"'Ignorant ranting? O, no rating!'" []
"'Ike! Tom! KO time! To Mike!'"
"'Ill gig, Gil!'"
"'Ill, Mike. Milk lie? I kill [']em!'"
"'Impeding! Impinged! Pin [']em, dig?'"
"'In! Hurt! Hit! Run!'" []
"'In, lackeys. Ask nicely!'"
"'In order, or I rend!' / 'Dire, Ron!'" []
"'In summation: ammunition's a must, minion.'"
"'Infirm, Mr.? Fini!'"
"'Info? ACT, faint co-faction!'" []
"'Inside job? Son, I jibed.'"
"Interrogatives. Tergiversation." [p]
"'Into it? No, not I!'"
"'Inward? I'd Warn Darwin.'"
"'Ire? C'mon, no CRIME!'" []
"'Ire, son?' / 'Nosier senior.'"
"'Irk Sy? Risky.'"
"'Is Sam amiss? I'm...' / '[a-word-u].'" []
"'Is the heist set?' / 'Hi, eh, it's...'" []
"'Ish, MORE heroism?'"
"'It here either?'" []
"'It'd--I'm timid!'"
"'It's done? Die, snot!'"
"'It's Fate, Fatties.'"
"'It's mo['] moist, Tim.' / 'So?'" []
"'It's muck! I'm stuck!' / 'Stick [']um!'"
"'It's us, suits!'"
"'Ivy League guy? I leave!'"
"'Jake-o! A joke!'"
"'Jar mo['] or jam, Major?'" []
"'Jeb! Art! Go!' ... 'Great job!'"
"'Jen's out. Joe, stun just one!'" []
"'Jerk! Er, j/k.'"
"'Jerk!' / 'Hoist this joker!'"
"'Jest, bud? Or just bored?'" []
"'Job [']im, Jimbo!'"
"'The joke? Eh, ok.' / 'Jet!'"
"'KC is sick! Icks!'"
"'Keen knee!'"
"'Kelly, I kill ye?' / 'Likely.'"
"'Kent, his skin. The stink, eh?'"
"'Keys? Wham! Why ask me?'"
"'Kid, no din, OK?' / DOINK!" []
"'Kid, real dark lie.'"
"'Kid, run!' / 'I--drunk!'"
"'Kin ye key in?'"
"'Kit's Bung Stunk Big?' / 'Bunk, gits!'"
"'Knee op? Keep on!'"
"'Kneecap Ape-neck.'"
"'Knifed, eh?' / 'He finked.'"
"'Kool-Aids! Soda kilo!'"
"'Lag, fink? Flaking?'"
"'Laid up, pal. DUI.' / 'Ulp!' / 'Aid? Paul, I'd...'"
"'The lam? Halt [']em! Ah, melt!'" []
"'Lame...hit him late?'" []
"'Lament rage? Get real, man.'"
"'Lash Hal's...' / 'Ah, Ssh, all!'"
"'Last straw, stalwarts.'"
"'Laugh, lug? Ha!' / 'Ugh, Al.'"
"'Lay down, lady. NOW!' / 'Go rue, rogue.'"
"'Leap! Cab!' / 'Capable?'"
"'Learn [']em, real men!'" []
"'Lee fibs. Beliefs, Lib. fees.'" [p]
"'Leg welt? Get well!'"
"'Leo, try to rely rotely.'"
"'Leon? Sam? Amos? Len? NO MALES!'"
"'Leprosy? So? ... REPLY!'" []
"'Let's bug Tom.' / 'Get lost, bum.'"
"'Let's do LOTS, Ed! Old set!'" []
"'Let's. Lest...'"
"'Libeler, eh? I'll be here!'"
"'Lift-op! To flip! Flop it.'"
"'Like that? HALT, tike!'" []
"'The limo (hot lime) hit Elmo!'" []
"'Line up! Un-pile!'"
"'Lip, eh?' / 'I...HELP!'" []
"'The lip! It...HELP!'"
"'Liquidated? I'd deal: QUIT!'"
"'LISTEN to me.' / 'Stolen time.'"
"'Lo, Marc?' / 'Clamor Mo['], Carl!'"
"'Lo, the log...' / 'Go to hell!'"
"'Loaded ole dad, do deal.'" []
"'Locked up? Cold, puke. Dope luck.'"
"'LOL, ehh? Oh, hell.'"
"'LOL!' / 'Eh, hello.'"
"'Lone hope: phone Leo!'"
"'Lonely? Yell on!'"
"'Long day.' / 'Any gold?'"
"'Look away. Okay, AWOL.'"
"'Look for...' / 'Floor! KO!'"
"'Looks good. OK, ol['] sod, go.'"
"'Loper, pry properly!'"
"Loud 'Won't! Would not!'"
"'Loud lot!' / 'Too-dull old lout!'"
"'Louses? Us? LOSE!'"
"'Low deal? We all do...ALLOWED!'"
"'Low key? Kyle? Ow!'"
"'Low law! Wow, all wallow.'" []
"'Loyal, eh?' / 'LOL, yeah.'"
"'Loyal?' / 'Ya! LOL.'" []
"'Lunatic-in-a-cult!'"
"'Lymphoma? Hmm, a ploy.'"
"'Ma! Bob! Bo! Bam! A bomb!'"
"'Ma, I... am I MIA? I am. I'm a aim...'" []
"'Ma slid. Lads, I'm dismal.'"
"'Mac Reed CREAMED Marc Dee!'"
"'Machete? Teach me!'" []
"'Macking, G-Man? Ick!'" []
"'Macro-Carom, Marco!'"
"'Mad, eh?' / 'Me? Dah...'" []
"'Mad pain PAID, man!'"
"'Magic road? Card, amigo!'"
"'Main man! I am in...'"
"'Major. Jam or arm OJ?'" []
"'Make em meek, Ma!'"
"'Make fun, me? A funk!'" []
"'Make sit ask time? Mistake. Stake [']im, Meatski.'" []
"'Make up? Puke, Ma!'"
"'Man down? [d-word-u], WON!'"
"'Man, drab armband!'"
"'Man, it'd--[d-word] it!'" []
"'Man, Leo! Mo['] Lean? No, lame! A lemon!'" []
"'Man show, son! WHAM!'" []
"'Mangle [']em, Lang!'" []
"'Mapless samples? Mess, pal.'" []
"'Marcus! A scrum! Um, scar!'"
"'Marty!' / '[dick-u]! Dirty Mack!'"
"'Me, a Dr.? Er, mad dream!'" []
"'Me? No kit. I'm...token.'"
"'Me? Rash? Shamer!'" []
"'Mean rib? Brain [']em.'"
"'Mediocre ride, come!'" []
"'Mel, you bum! You mumble!'"
"'Men! Craig's screaming!'"
"'Men, I've...I'M EVEN!'"
"'Menaces can seem...men, a sec!'"
"'Mention men on it? Not mine!'"
"'Messer-up sprees? Um, mere puss presumes.'"
"'Might pun? THUMPING!'"
"'The Mighty hit the Gym.'"
"'Mikey! Ike! My, I'm key!'"
"'Mind if? ... ' / 'Find [']im!'"
"'Mind law, wild man!'" []
"'Mind lost?' / 'Slim, don't...'"
"'The mint then, Tim?'"
"'Mirth-hit, Mr.?'"
"'Mis-Enter? Termines!'"
"'Misarrange margarines?' / 'Mas angrier, sir manager?'"
"'Miscued! Die, scum!'"
"'Misquotation. ANTI-mosquito.'"
"'Mistrained? Administer mini-treads!'"
"'Miswrote? Wormiest...'"
"'Mo hid. DO HIM.' / 'D'oh! I'm...'"
"'Mo, slice! Lo, sic [']em!' / 'I'm close!'" []
"'Mo['] grass? grams? So gross, Ma!'"
"'Mock us? OK, scum...'"
"'Mocked? Dock [']em.'"
"'Mocks OK MCs? Sock'm!'"
"'A model do? Lame! Deal mo[']!'" []
"'Moist talk? Milk toast!'" []
"'Molest Motels? Lost Me.'" []
"'Momento? Moot, men.'"
"'Money back may beckon?' / 'Maybe.' / CONK!"
"'Money men! Yo!'"
"'Moneybags!' / 'Gamey snob!'"
"'Monist Scum!' / 'Communists!'"
"'Mood-hike!' / 'I'm hooked!'"
"'Mope? Shout! Shoot [']em up!'"
"'More hands!' / 'Harm's done!'"
"'More safe foe-smear: fearsome? Mere oafs!'"
"'Most dens don't MESS.'"
"'Most expect ... except Tom's.'"
"'Move on? Us? Venomous!'"
"'Mr. Defyin['] my friend? Fry [']im, Ned!'" []
"A Mrs. Case Screams 'A massacre!'" []
"'Much set, the scum.'" []
"'My aunt, Nat...' / 'Yum!'"
"'My bid, mug! Big dummy!'"
"'My foot! T/y, mofo!'"
"'My fur! Fry [']um, [']Umfry!'"
"'My half. I flay him!'"
"'My head! Hey!' / 'Mad?'"
"'My, it's Aldo! Slimy toad!'"
"'My mud, dummy!'"
"'My plot? Ply Tom!'"
"'My raise?! Ya miser!'" []
"'My tyres!' / 'Yes, Mr. Ty?'"
"'My unit? Um, tiny mutiny.'"
"'My voice! Ivy, come!' / 'Yo, ME, Vic?'" []
"'Nab me? Man, be...' / 'Ban [']em!'"
"'Nachos, Sancho?' / 'No cash.' / 'Ach, son!'" []
"'A nag, idiot. Do it again.'"
"'Nail KC? Lackin['] a Clink.'"
"'Named, Ed? Man. Amend.'" []
"'Narcs got scorn. TAG!'" []
"'Nate! Tena! A-ten! A net!' / 'Neat!'" []
"'Nattiness? Ha! That's insane!'"
"'Neat wish. Hate wins!'"
"'Needy sot! Stoned, ey?' / 'Not seedy!'"
"'Nervous, Rev.? Us? No!'"
"'New man? Naw, MEN.'"
"'The news?' / 'She went west, hen.'"
"'Nice day. Any dice?'"
"'Nigel Elgin!' / 'Glen, I...'" []
"'No bet, T-Bone!'" []
"'No bums!' / 'Um, snob! Snub mo[']?'" []
"'No buyers, nosy rube! Bury nose!'"
"'No cast to scan--so, can't!'" []
"'No, chumps! C'mon! Push!'"
"'No dice.' / 'Die, con!'" []
"'No. Fate, fat one!'"
"'No GED, Ogden?' / 'Go, Ned.'"
"'No Geist?' / 'It's gone! Set! Go! In!'"
"'No grits, Ned? Grindstone!'" []
"'No Group's Poor: GUNS!'"
"'No, hit it, hon.'"
"'No Hype? Phoney!'"
"'No jobs, B. J.?' / 'Soon.'"
"'No math? A MONTH?! Hot, man!'" []
"'No party? Rap, Tony!'" []
"'No, pigs! Go spin!'" []
"'No police? Nice. Pool.'"
"'No shady hands, yo! Dash yon!'" []
"'No shake, oh sneak!'"
"'No she, son, eh?'" []
"'No soup?' / 'Up soon.'"
"'No toys? Yo, tons!'"
"'No wit to win?' / 'I won't..'" []
"'Nobody nod. Yob.'"
"'Nod, Don!'"
"'The Noid. Doin['] the hit?' / 'Done.'" []
"'Non-biker? Broken in!'"
"'Non-guest? Note: guns!'"
"'Noose? O noes!'"
"'Nope, it's nite-ops.'" []
"'Norm-o!' / 'Moron.' / 'Mr. ONO!'" []
"'Nosy anus annoys us.'"
"'Not a BIG ban I got!'"
"'Not a clue.' / 'CLEAN OUT!'"
"'Not cool, tool! Con!'"
"'Note, Brett: rotten bet. Better not.'"
"'Now, hit! With no 'how' nit!' / 'Hi! Won't!'"
"'Now I'm mad, dim man!' / 'OW!'"
"'Now it won't, I own it!'" []
"'NOW, Lew!' / 'Wow, Len. New low.'"
"'Now on?' / 'No, won!'"
"'Nursed, Ed runs. SUNDER.'"
"'O My God! G-Moody!'"
"'O, toast to a sot.'"
"'O, tons not so, snoot-o-snot!'" []
"'Oaf-guy!' / 'You [fg]!'" [x]
"'Obey Dad!' ... 'Dead boy!'"
"'Obituary? I? You brat! I bray out!'" []
"'Obscurity? Scrub it, yo!'" []
"'Obtruncate Betancourt!'" []
"'Odd rat!' / 'Dotard!'"
"'Officer, if force...'"
"'Oh, [']twas so hawt.' / 'So what?' / 'Was, tho[']!'" []
"'Oh, boys! Shy? Boo!'"
"'Oh, bust us both? But sho[']...' / 'BS, thou!'"
"'Oh? Draw, Howard!' / 'D'oh! Raw!'" []
"'Oh, Gene?' / 'He gone!'"
"'Oh, Nat! Hat on?' / 'Ha, not!'"
"'Oh, Nick! Chokin[']?' / 'No, hick! HI!' / CONK."
"'Oh, oy, Matt! Too mathy!'"
"'Oh, SOB, hobos! O, bosh!'"
"'Oh, wow, who...? OW!'"
"'Ohh, get the hog!'"
"'Oi, spazz! So, pizza?'"
"'Oi, Ted's diet.' / 'So, does it?'"
"'OK, clear a locker.'"
"'Ok, it's up. Skip out.'"
"'OK, Loon. Look on!'"
"'Ok, no, turd. Too drunk.'" []
"'Ok, rig! Go, Rik!' / 'I grok.'"
"'OK, torch hot rock cohort K.'"
"'OK, won't know to tonk. OW!'"
"'Okay, we weak, yo!'"
"'Old bat!' / 'Bad lot!'"
"'The old dolt, eh? He told Ed Loth?'"
"'Old news! Slow, Ned!'" []
"'Old sicko!' / 'Loco kids!'" []
"'On bad credit? No debit card!'"
"'On board?' / 'BOO!' / 'Darn!'"
"'On, bud!' / 'Bound!'" []
"'On edge, Don? Gee!'"
"'On home, men, oho!'"
"'On tap to nap? Not Pa!'" []
"'ONE fix?' / 'Fine, Ox.'"
"'One thug? Toughen!'"
"'One, Two, Owe Not!'"
"'Oo, chats? Cahoots?' / 'Shoo, cat!'"
"'Oof! Die, foodie!'"
"'Ooh, [d-word]! Had no mo['] manhood!'"
"'Ooh, nuts. South on Houston...'" []
"'Open wide.' / 'Dope wine!'"
"'Operas? Po['] ears!'" []
"'Operate, rote ape.'"
"'Or LSD?' / 'Dr. Sol Lords.'"
"'Order, pig!' / 'Porridge!'"
"'An orgy, Yang? Or groany Rog? Any?'" []
"'Ouch, man! On a chum?'" []
"'Our flat, Ralf. OUT!'" []
"'Our visa! Saviour!'"
"'Out, flu! Yes! You left us!'"
"'Out, pig!' / 'I got up!'"
"'Out, Ray!' / 'You RAT!'"
"'Out, schmo! Chums too! So much to...'"
"'Out yon! ... Not you!'"
"'Overpays? Say, PROVE!'"
"'Oversight thrives. Go.'" []
"'Ow, a gay! Go away!'"
"'Ow! Ain't...?' / 'Wait on it now, a...'"
"'Ow, my ears! Easy!' / 'Worm!'" []
"'Ow, no, clod! Cool down!'" []
"'Ow, rat! To WAR!'"
"'Ow, son!' / 'So? Now swoon on, sow!'" []
"'Owners worsen, worsen, worsen.'"
"'Oww, Len! New low!'"
"'Oy, bond nobody? Boy, Don.'" []
"'Oy! Help us, you shlep!'"
"'Pa, shot? Pathos!'" []
"'Pack blade? Backpedal.'"
"'Pah! Cor! ... Oh, [crap].'"
"'Pain? A nip. I nap.'" []
"'The pain!' / 'Ha, inept!'"
"'Pained, Mo? Dopamine!' / '[d-word-u], Opie!'"
"'Pal, if I flap, flip a...'"
"'Pal, pause. Appeal us.' Applause."
"'Pal, use...seal up...' / 'A pulse!'" []
"'Pard, ye prayed?' / 'Yep.' / 'Rad.'"
"'Park out or kaput.'"
"'Past you to pay us?'"
"'Pasture tear-ups? True sap.'" []
"'Pathetic, Cheap tit!'"
"'Paupers! A supper!' / 'Super, Pa!'[paragraph break]Pure sap."
"'Pay, bum!' a bumpy BAM! 'Yup.'"
"'Pay up, ya pup.' / 'Yup, Pa.'"
"'Peanut be beaten up!'"
"'Peanuts! Up antes!' ... 'An upset!'"
"'Pedal!' / 'Plead, pal!' / 'Ed...'"
"'Pee! Eep!'"
"'Peel out?' / 'Up to Lee.'"
"'Penknife? Keep, Finn!'"
"'The pens, Stephen.'"
"'A pension? Inane sop!'"
"'Perk? Ha, phreak! Eh, park!'"
"'Perry, a prayer?' / 'Err, PAY.'"
"'Pesos for spoofers of posers?'"
"'Pet, Ace? ... Cat pee.'"
"'Petard? Depart!!!'"
"'Pheew, ace crime!' / 'Phwee, ice cream!'"
"'Phew, Lon! Help now?' / 'No, whelp!'"
"'Phil set the slip! He split!'"
"'A phone? Ah, nope! Ha, peon!' / 'Heap on!'"
"'A photo? Oo, phat.'"
"'Piss off, spiffos!'"
"'Pits, men! I'm spent!'" []
"'A pity. Pay it!'"
"'Plaid? Al, dip da lip. Pal, I'd...'"
"'Plan four: a flop! Run!'"
"'The plan then, pal!' / 'Help! Nat!'"
"'Plan two? Wan plot. Won't, pal.'"
"'Pleasantry? Learn, patsy! Pay rentals!'" []
"'Pluck, hero? Lock her up!'"
"'Plug the gut! Help!'" []
"'Ply [']im, Limpy!'"
"'Po['] guy, I...' / 'You pig!'"
"'Poachy chap! Oy!'"
"'Pocket a take, cop?!'"
"'Poke fun, foe? Punk!'"
"'Pompous? So?' / 'Mop up.'" []
"'Pond? Um, no, dump.'"
"'Poor baby!' / 'Pray, boob!'"
"'Porn? Ah, harp on.'"
"'A potty? Pay, tot!'"
"'The pound? Nope!' / THUD."
"'Pound up Don!'" []
"'Pounding? Dunno, pig.'"
"'Pout, homes? Shoot [']em up!'"
"'Pout? Sh!' / 'Uh, stop!'" []
"'Pre-locate. Percolate.'"
"'Prepare. Repaper!'"
"'A present! Spare ten!'"
"'Press it! Persist!'" []
"'Press out, spouters!'" []
"'A pretty trap, yet try peat.'"
"'A pro, or Pa?'"
"'Proceed, creep. Do!' Dope rec!"
"'Prodnose's sponsored Ed's pornos. So, respond, nerds!' / 'Oops.'"
"'Prove OK Provoke.'" []
"'Pry, lie, Ripley? I reply!'"
"'PSAs? Pass!'"
"'Psh, Sue pushes. She's up!'"
"'Puerile? Pure lie!'"
"'Pull down. LOL u pwnd!'"
"'Pummel! Lump [']em!' / '[']Elp! Mum!'"
"'Pun? Gah! Hang up.'"
"'Pup, war! Wrap up...'"
"'Purpose? Sure, pop!'"
"'Put me up, Met!' / 'Um, pet...'"
"'Quayle's squealy.'"
"'Question?' / 'Quiet, son!'" []
"'Quit ale. Tequila!'"
"'Race bait? Bacteria!'"
"'Rad? Yer dreary, Dr. Ayer.'" []
"'Radials? Alas, rid.' / 'Sad liar!'"
"'The raid! Hide, Art! Hi, TREAD!'" []
"'Rare hit, Harriet? Ah, trier!'" []
"'Rashly? Har! Sly!'"
"'Ratchet the cart!' / 'Rec That.'" []
"'Ratty try at tarty!'"
"'Ray Best betrays by tears.'" []
"'Ray, know any work?' A wry 'No, [']k?'"
"'Re-inspect? Prescient!'" []
"'Re-nab Abner.'" []
"'Re-toil, Mike! ... More like it!'"
"'Reaved, evader!'" []
"'Rebuilding? Bud, I linger.'"
"'Received, Deceiver!'"
"'Recruiting! Gun it, crier!'"
"'Redhead Dedra, eh?'"
"'Refocus!' / 'Force us!'"
"'Regain her green hair? Eh, angrier.'"
"'Rent AWOL!' / 'Later?' / 'NOW!'" []
"'Reshoot, soother!'" []
"'Respond, son!' / 'Derp!'" []
"'Reswallow, Wallowers!'"
"'Retracing? Cringe, rat!'" []
"'Retraction! Or recant it!'" []
"'Rewire them! Meriwether! Wertheimer!'"
"'Ribcage!' / 'Grab ice!' / 'A big rec!'"
"'Rid ONE dinero. Ride on or dine.'" []
"'Ride, Tim!' / 'I'm tired.' / 'Timider?'" []
"'Rip Me, Mr. Pie? I'm pre-prime!'" []
"'Rise, [d-t]!' / 'So tired!'" []
"'Risk two. It WORKS.'" []
"'Roam, bud!' / 'U mad, bro?'"
"'Rob YOU? OUR boy? Oo, bury!'"
"'Rob!' / 'Bro!'"
"'Robber! ... Err, Bob?'"
"'The rod's shorted! Red hots!'" []
"'Rodent-bug got burned.'"
"'Rolling up?' / 'Groin pull!'"
"'Rory? Son?' / 'Sorry. No.'"
"'Rory won. No worry.'"
"'Rosy! Roy! Yo, sorry!'"
"'Rot, lad!' / 'Old Rat!'"
"'Rote slam. More salt!'"
"'Rough [']em more! Ugh!'"
"'Rub salt? [']S Brutal.'"
"'Rude gag? Gad, urge a grudge.'"
"'Rude ol[']!' / 'LOUDER!'"
"'Rudy, babe! Buy bread!'"
"'Run. See. Ensure!'"
"'[']Ruptin['] turnip! Punt [']ir!'"
"'Russ, Peer Pressure?'" []
"'Russo sours? Ur-SOS!'"
"'Rustbin! Burstin[']! It burns!'"
"'A rut, me? Mature.'" []
"'Sack us? Suckas!'"
"'Sad bit: it's bad.'" []
"'Sad brat!' / 'Bastard!'" []
"'Sad, Tony?' / 'Nosy, Tad! Yo, stand!'" []
"'Said for?' / '[']Fraid so!'" []
"'Saloon's a loss? No.'" []
"'Salty sty, Al, Ty, Sal.'" []
"'Salute us late? U Least!'" []
"'Sam Glen mangles legs, man!'"
"'Same to you! Um, too easy.'"
"'Same woe? Awesome!'" []
"'Sammy, my ma's Ms. May.'"
"'Sarge...' / 'Balks? Break glass!'"
"'Saturnic? Curtains!'" []
"'Say, both shot by a soy bath.'" []
"'Say, Dan, I said ANY...'"
"'Say, Dick! Sick day?'"
"'Say, Papa! Papayas!'"
"'Say, po['] soapy sap! Oy!'"
"'Scallies, Illescas!'"
"'Scar [']em!' / 'Scream!'"
"'Scenario Ace? No, Sir!'"
"'Schmo! Nut!' / 'Snot much?' / 'Tons, chum.'"
"'School is cool? Hiss!'"
"'Scoping pigs? Con!'"
"'Scrub curbs? BS!' / 'Cur!'"
"'Sean, my yes-man!'" []
"'Secured, seducer. See?' / 'Crud.'" []
"'Seedy? Yes, Ed.'"
"'Seen, son? No sense!'"
"'Seitz! Zest!' / 'I...' / 'It's EZ!'" []
"'Set, Al? Les at least...'"
"'Set, Bud? ... BUSTED! Be dust!'" []
"'Sewage was, gee...'"
"'Shadowy days.' / 'How!'"
"'Shake down Hawk's?' / 'Done.'" []
"'Shame, eh, Sam?' / 'Ma, he's...'"
"'Shamed! ... He's mad!'"
"'Shan't!' ... 'Hasn't!'"
"'Shatterer! Set?' / 'Rather.'"
"'Sheet these!'"
"'Shift, pro: Fishport, Shipfort.'"
"'Shoeless?' / 'Eh, less so.'"
"'Shoo, turd! Door: shut!'"
"'Shoo, ya yahoos! So, ahoy!'"
"'Shoot him? I...' / 'Shh. Moot.'"
"'Shoplift ops? Filth!'"
"'Shot host? Tosh!'" []
"'Shoulder-hold? Sure!'"
"'A shout at us? Ho!'" []
"'Shout thous? O, shut!'" []
"'Show up! Push!' / 'Ow!'"
"'Show your face!' / 'Curfew, yahoos!'"
"'Shut down Dunst.' / 'How?'" []
"'Shy? Out. Yo, thus: Shouty!'" []
"'Si, don't...Don, it's not Sid!'"
"'Sick ask! Kick [a-word]!'"
"'Sick splat! Slapstick!'" []
"'Sigh. Clan clashing.'" []
"'Simon. Son, I'm...'" []
"'A simp! Sap [']im!'" []
"'Sink it, Nik, it's...' / 'I stink.'"
"'Sinking? Ink! Sign!'"
"'Siphoned?' / 'Pish. Done.'"
"'Sir, Ban Brains!'"
"'Sir, to riots! O, stir.'" []
"'Sis, cop a Picasso!'"
"'Sis did Sid's ID...'"
"'Sit, Len. Listen. Enlist.'" []
"'Sit, or I sort...'" []
"'Six A.M. Max is...'"
"'Skeevy Kev?' / 'Yes.'" []
"'Skiddoo, dodo-ski!'"
"'Slim, ply my pills!'"
"'Slotted old test. Let's do't.'"
"'Sly mob symbol, my slob!'" []
"'Smack it?' / 'Sit, Mack.'"
"'Smart cow.' / 'Cast, worm!'"
"'Smart to trot, Sam.' ... 'Toast, Mr.'"
"'SMH. Too smooth to mosh?'" []
"'Smit so? It's Mo's to miss.'" []
"'Smoke some k.' / 'Me? S'ok.'"
"'A smoker? Er, OK, Sam.'"
"'Smooth Mo? Shot?'" []
"'Smother THOSE, Mr.'" []
"'Snare it nastier!' / 'Neat, sir!'" []
"'Snob! To Boston!'" []
"'Snoop? My! Spy no mo[']!'"
"'Snooty snot! Yo!'" []
"'Snuck it in...STUCK!'"
"'So, a Mr. or a Ms. Ramos?'" [p] []
"'So, at the hot seat? He TOAST!'" []
"'So, bilge! Ol['] gibes?'"
"'So, dog...goods?' / 'O gods!' / 'Go, sod!'"
"'So go rec Scrooge!'"
"'So, Hack. Cash OK?' / 'A shock!'" []
"'So, honey?' / 'Yes? ... Oh no!'"
"'So, Kent. Tokens sent OK to Ken's?'"
"'So, man, Mason moans No Mas.'" []
"'So, Mike, I smoke em. Is ok?'"
"'So! Neat! Eat, son.' / 'No seat.'" []
"'So nervy?' / 'Very, son.'"
"'So, pal. Opal's ol['] sap?'"
"'So pay us. You pass? Yo['] [a-word] UP!'" []
"'So, permit to simper?' / 'Imposter!'"
"'So, pigs! Gossip?'"
"'So, prank?' / 'No spark.' / 'Rank sop.'"
"'So, rant on, rats!'" []
"'So, Ronny or Sonny?' / 'No, Ryno's.'"
"'So shy, yo!' / 'Ssh!'"
"'So, son. No SOS?'"
"'So, then, Shonte Heston, the son: he's not honest? Eh, tons.'"
"'So thin! / No [s-w]!'"
"'So, um, buy? YOU BUMS!'"
"'So, um, us mo[']?'"
"'So urgent, nurse. Got...'" []
"'So Witty Twits. Oy!'" []
"'So yeah, Yo, he's a...'"
"'Soaking? Go in, ask...'"
"'Socked him? I'm shocked.'"
"'Solid ol['] Sid is Old. Soil'd.'" []
"'Solver Les...oversells.'"
"'Some food? Doom, foes!'"
"'Sordid dis, Rod!'" []
"'Sorest tosser!' Er, sots? Store S?"
"'Sort of soft or...[']s troof!'"
"'Soul? [d-t] sold out!'"
"'Soup's up!' / 'SOS!'"
"'Speakins? Spankies!'"
"'St. Mary, smarty? Try Sam!'" []
"'Stampede!' / 'Pasted [']em!'"
"'Staree! Teaser!'" []
"'Startled? Drat, let's...'"
"'Stash him! Smash! Hit!'"
"'Stat, locals! At all costs! Call toasts!'"
"'Stay! Lou lays out you last.'" []
"'Stay put, taut spy.' / 'Yup. Stat.'"
"'Stealin['] entails elan. It's...salient.'"
"'Stealing? Let's gain!!'" []
"'Step, son! No pests!'"
"'Stink up...? Punk, SIT!'" []
"'Stipend? Tens? Dip, spend it!'"
"'Stomach shot, Mac?'"
"'Stop trying, prying tots!'"
"'Street Smarts Matter. STRESS.'"
"'Stride? It's red, driest. I'd rest.'" []
"'Stu! Deb! BUSTED!'" []
"'Stu, I'm...I must...it's, um, stimu...'" []
"'Sty, men? My nest!'"
"'Su! Cyril! Luis! Cry cursily! Curly is I, sly cur!'"
"'A sub?' / 'Nope, bean soup.'"
"'Sublime lies, bum!'" []
"'Suck bad, tot? Back to dust!'"
"'Suck not! Conk Stu!'"
"'Suckered? Crud. Seek User Deck.'"
"'Sum it.' / 'Must I? It's, um...'" []
"'Sump'm?' / 'Mumps.'"
"'Sundering. Undersign?'"
"'[']Sup, Gina?' / 'Pausing.'" []
"'[']Sup, Reg?' / 'Purges.'"
"'Super macho? Recoup, sham!'"
"'Suppose Pop sues?' / 'Posse up.'"
"'Sure, mooch. Hour's come, our schmoe!'"
"'Sure, only rely on us!'"
"'Survive? Viv? Sure!'"
"'A suspect, me? Must escape!'"
"'Swarthiest sweatshirt!'"
"'Swat the hat, Stew!' / 'That, Wes?' / 'Eh, [t-w]s!'"
"'Swatter Stewart! We start!'" []
"'Swim! Try!' / 'My wrist!'"
"'Swindles? WILDNESS!'"
"'Swollen! Swell? No!'"
"'Take-down KO wanted. Don't...weak!'"
"'Tampers? Stamp [']er!'" []
"'Tan him, hitman!'"
"'Tara! A rat!'"
"'Tarantino? Tarnation!'" []
"'Tasered, dearest? ... Sedater?'"
"'Task, Don?' / 'Don't ask, dank sot!'"
"'Ted! NO!' / 'Noted, Donte.'"
"'Tell it, Little...'"
"'Ten oafs. Not safe.'" []
"'Tend oven? Don't even...'"
"'Tenderiser reinserted!'"
"'Terry, if...' / 'Try fire! Terrify!'" []
"'Tex, narc next car! Rex can't...'"
"'That Ken. The tank!'"
"'That way's WHAT?! Stay!'"
"'That's Fink. Think Fast!'"
"'Them's set. Hm?'"
"'Then Lug the Lung, Glen. HUT!'"
"'Then mob BOTH men!'"
"'Theobald! Hold! Beat!'" []
"'There, Al! The real heel! Rat!'" []
"'They amp empathy. Pay them.' / 'Empty.' / 'HA!'"
"'They ARE teary, eh?'" []
"'They mad! My death!'" []
"'They won? Note why. Won't, hey?'"
"'Thinkers!' / 'Shtinker!'"
"'Thirties? [s-w]tier.'"
"'This hoser, he is short.' / 'Horse [s-w]!'" [x]
"'Thump Ed! Dump the...' / 'Umph, Ted!'" []
"'Thumpin[']! Hunt imp!' / 'Punt him!'"
"'Tiger, a triage!' / 'Great, I...'" []
"'Til this hit list tilts... HI!'"
"'Tim, Hi. Hit [']im!'"
"'Tim, if I'm fit...'"
"'Tim! Sly!' / 'Ty! Slim!'"
"'Tim?' / 'No, I'm not in, Tom.'" []
"'Time card? I'm traced!'"
"'The time. TIE THEM.'"
"'Time to go. Get [']im too!'"
"A timid 'I admit...'"
"'Tino! Toni!' / 'On it!'" []
"'Tintin, innitt?'"
"'A tip, dog: got PAID!'"
"'Tix? If...' / 'Fix it!'"
"'To choke the cook, too? Heck!'"
"'To claim I'M a clot? Toil, Mac!'"
"'To dial a dolt? I...' / 'Do it, Al!'"
"'To it, Tito!'"
"'To jibe, con? Objection!'" []
"'To legs! Let's go!'" []
"'To supply lusty opp? Plots? Yup!'"
"'To unify? Aw, if you want...'"
"'To verify verity of tyro five, I VOTE: FRY.'"
"'To wharf of wrath! Raft!' / 'How? What for?'" []
"'To yank Katy? No.'"
"'Tod, I...' / 'DO IT!'"
"'Told new, Del won't let down.'" []
"'Told on? Not old Dolton!'"
"'Toledo! Looted!'"
"'Tolls? Aw, law lost!'"
"'Tom, coyness costs money!'"
"'Tom, night might not...'"
"'Tom's con men? No comments.'"
"'Tone it down!' / 'Ow! Intend to!'" []
"'Tony! Me! T-Money!'" []
"'Too cold, old coot?'"
"'Too shy? Yo, shot!'"
"'Too sick? OK? Stoic?'"
"'Top road? Oop! Drat!'"
"'Toss Clark? Cross talk!'"
"'A tot, led to... dealt. Totaled.'"
"'Touch mo[']?' / 'Ouch, Tom! Too much!'" []
"'Tough hit, I thought.'"
"'Tough, man? Nag-mouth!'"
"'Tow trucks struck two!'"
"'Traced, son? Not scared? Narcs DOTE!'"
"'Traitors!' / 'Rat Trios!'" []
"'Tramp, neat apartment!'"
"'Treasonous reasons! Out!'"
"'Treasurer! Serrature!'"
"'Treat, minion? TERMINATION!'"
"'Treaty yet, Art?'" []
"'Tribunal? Turn bail!'"
"'Trip down. Won't? DRIP!'"
"'A trophy, Roy? Phat!'" []
"'A trump-up mart? Um, trap!'"
"'Try acid, cat?' / 'I?! Dry.'"
"'Turn on Ron? Nut!'" []
"'A twitch? Aw, titch, watch it! Act with...'" []
"'Ty, cram my cart! Try, mac!'"
"'Ty? No. Tony.'"
"'Ty went. Twenty.'"
"'Typhoid? D'oh! Pity.'"
"'U lost, louts?'" []
"'UFO, Roy? Yo, four for you! Oo, fury!'" []
"'Ugh, bum!' / 'Humbug!'"
"'Ugh, cat. Caught?'"
"'Ugh, neat heat gun.'"
"'Ugh, Tom's mug shot! Hot? SMUG!'" []
"'Uh, Geno? One hug?' / 'Enough! Huge no.'" []
"'Uh, glory?' / 'Roughly.'"
"'Uh, go, Hugo.'" []
"'Uh, got to hug.' / 'Hut! Go!'"
"'Uh, hun? Nuh-uh!'"
"'Uh, I be Hubie.'"
"'Uhh, Og? Hough!' / 'Huh?' / 'Go!' / 'Oh, GUH!'" []
"'Um, a rad maraud?'"
"'Um, a rat! Trauma!'" []
"'Um, die!' / 'I'm due.'"
"'Um, escorts! Customers must score!'" []
"'Um, gots mo['] guts? Must go to mugs.'" []
"'Um, Greg -- mugger!'"
"'Um, JP?' / ' Um, PJ?' / 'JUMP!'"
"'Um, near manure? Rue, man!'"
"'Um, Pop?' / 'Mop up!'"
"'Um, Sal Mauls a slum!'" []
"'Um, then hunt [']em!'"
"'Um, Yo, Mr. So your mom's...'"
"'Umkay?' / 'Yuk, Ma.'"
"'Un-gored? Guerdon!'"
"'Un-tired? Intrude! Under it!'" []
"'Uncle! Pa! Clean up!'" []
"'Underling! A laundering-dealing run!'"
"'Unheroic? Nice Hour!'" []
"'Unwell, sot? Tell us now!' / 'Two sullen...'"
"'Up ahead...aha, dupe!'"
"'Up, cat! Act up!'"
"'Up for no fun? Poor...'"
"'Up my...I...Ow!' / 'You wimp!'"
"'Up, Ron! Pruno!' / 'Urp...no!'"
"'Up this. PUSH IT!'" []
"'Up to...? Pout, po['] put-out!'"
"'Upset, Leo? Sleep out, else pout.'"
"'Uresis issuer!'"
"'Veerin[']? Ren, I've--I never...'" []
"'Video US? Devious!'" []
"'Vie, [d-t]?' / 'I'd vote to dive.'" []
"'Vie, Jon. No jive!'"
"'The vigor: hog it, Erv! Go, thrive!'"
"'Virus, Irv? Us?'"
"'The Vise! Thieves!'"
"'Vital, eh? Halve it.'"
"'Vocation, vain coot?'"
"'Vodka is OK, Davis.'"
"'Voyeur, Rev? YOU?'"
"'Wackos? Sack!' / 'Ow!'" []
"'A wag, yo? Go away!'" []
"'Wait-shy? This way.'" []
"'Wait up! Aw, I put...'"
"'Wake [']im!' / 'Aw, Mike, I'm weak.'"
"'Wake up!' / 'Aw puke.'"
"'Walk? Run, raw lunk!'"
"'Want him, Whitman?' / 'Hm, naw, it...'" []
"'Wanted? Ted? Naw.'"
"'Was Ed Dawes sawed?' / 'Aw, DES!'" []
"'Wash it.' / 'Aw, this?'"
"'Wastrel!' / 'Lawster!'" []
"'Water rat! Ew!'" []
"'Wayne's?' / 'Naw.' / 'Yes.'" []
"'We could duel, COW!'"
"'We hit white.' / 'Hew it.'" []
"'We on?' / 'Ew, NO!'"
"'We're in, Weiner!'" []
"'Wed too? Woot, Ed!'"
"'Weep? OK, we poke.' / POW! / 'Eek!'"
"'Well, Gus? Slug Lew!' / 'Ug...' / 'Swell!'"
"'What a hat, aw!'"
"'What do I...? Ow! Had it!'" []
"'Whee! Eh? Ew!'"
"'Whine when I win, eh?'"
"'Who died? Oh, DID we?'"
"'Who said I shadow?!'"
"'Who stole those? LOW!'"
"'Whodunit? Now, I...' THUD!"
"'Why is?' / 'Why as wishy washy?'"
"'Why not I?' / 'How, Tiny?'"
"'Wicked, Ed! ...Dickweed.'"
"'Widow? Wow, I'd--I'd--oww!'"
"'Widowed? Died? Wow!'"
"'A wimp? I wap [']m.'"
"'Wink, nod. I'd known...' / 'Down, Nik!'"
"'Wire the...' / 'We're hit!'"
"'Wise? Sap? [a-word-u]wipe!'"
"'Wish me luck!' / 'Hick, we slum.'"
"'With-it twit, hi!'"
"'Woe is Wes, oi!'"
"'Women! Me! Now!'" []
"'Won't be bent...OW!'"
"'Won't dis Don's wit? Sit DOWN!'" []
"'Woofing, goof? WIN.'"
"'Woot! Sol Woo Lost! Too slow!'"
"'A word, con--no, COWARD!'"
"'Work is risk. Ow!'"
"'Worm, Mr.!' / 'Ow!'"
"'Worthy, pal? How paltry!'"
"'Wot, two? Wow, tot!'"
"'Wound, hit! Thud, wino!' / 'Whodunit?'" []
"'Wounded NOW, dude?'"
"'Wow, Andy! Way down!' / 'Yow, Dawn!'"
"'WOW!' / 'Ken, we know.'"
"'Wrist OK?' / 'It works.'" []
"'Wuss by a Subway's: Saw--By Us!'"
"'Y'have? Heavy!'"
"'Ya, Ken's Sneaky.'"
"'Ya new, Wayne?' / 'Ey, naw.'"
"'Yah, flaw? Haw! Flay halfway!'"
"'Yahoo, big boy! Ah, I go!'"
"'Yay! Dam[']. Mayday.'"
"'Yea, hi, out! I hate you!'"
"'Yeah, so easy. Oh.'" []
"'Yee-haw, we...yeah!'"
"'Yep, do...' / 'Dopey!'"
"'Yep, louts. You slept!'"
"'Yer top poetry?! Er, typo.' / 'Yep. Rot. Try Poe.'" []
"'Yip, man!' / 'My pain!'"
"'YO [a-word] say so?'"
"'Yo, a plot, ol['] pay to play too!'"
"'Yo, Ann! Annoy any?' / 'NO!'"
"'Yo, bad day, Bo!' / 'Dad, ya booby!'" []
"'Yo, Beth, Bo, they...boy, the...'" []
"'Yo, Bond! ... Nobody?'" []
"'Yo, Buster! Your best!'"
"'Yo, dawg!' / 'Gad! Yow!'"
"'Yo, dog, be...' / 'Goodbye!'" []
"'Yo, dumb mud boy!'"
"'Yo, fawners! News for ya!'"
"'Yo, help!' / 'Eh, ploy!'"
"'Yo, Ken! No key!'"
"'Yo, louse! You lose!'"
"'Yo, man. May...' / 'NO!'" []
"'Yo, Nell? Lonely?' / 'NO, Lyle!'" []
"'Yo, pawn! Pay now!'"
"'Yo! Seen one?' / 'Yes! Eyes on...'"
"'Yo, SOB!' / 'Me?' / 'Yes!' / BOOM!" []
"'Yo, sold out? Told you so!'"
"'Yo, tend, lad. Don't delay.'" []
"'Yo Trish, Horty is history! Shorty, I...'" []
"'Yo, unwise, you swine.'"
"'Yo! VIPS!' / 'Oy! Spiv!'"
"'Yon posh phony, so...' / 'Oh, no, spy!'"
"'You can't count, ya?'" []
"'You chumps copy us, hum?'"
"'You first.' / 'So fruity.'"
"'You late lout, yea.'"
"'You past autopsy payouts?'"
"'You rich or, uh, icy?'"
"'You sign in, Gus! Yo!'" []
"'You snake!' / 'OK, uneasy.'"
"'You yap, you pay.'"
"'You'd like the USSR, Russ.' / 'U SRS?'"
"'You're feminine! You're mine!' / 'Fine!'"
"'Young guy, no!' / 'Young gun, yo!'"
"'Your name? Yo, manure!'"
"'Yow! Uno! You won!'"
"'Yr apt. party? Rap, Ty! Pry at Pa, try!'" [p] []
"'Yum, gonna' / 'YOUNG MAN!'"
"'Yum!' / 'Dino, you mind?'" []
"'Zero hour! Err, uh, zoo!'" []

table of non-skeds [xxv5]
blurb
"Abler Mess Assembler" []
"Achiever E-Archive" []
"AllRite Literal Tallier" []
"Assigner-Or-Organisers"
"Backlogs-Sack Blog"
"Banks-It Task-Bin"
"Best-B-Set"
"Can-Slog Scan-Log"
"Classiest List-Cases"
"Clients-Stencil"
"Cues-for-Refocus" []
"Cures-Held Scheduler"
"Delegating/Get-Dealing Gadget Line"
"A Desk, Asked" []
"Desk of OK Defs"
"Desk-Sked"
"Desk-Yap Keypads"
"A Diligent Leading-It Detailing"
"Dire SOS Dossier" []
"Do-Great Date-Org" []
"Do-Still Old List"
"Doings-Dosing" []
"Done-Logs So Golden"
"Dude-I-Map-Idea Dump"
"Ego-Fill Log File"
"Enum-Menu"
"Evanston Notes-Nav"
"Force-Us Focuser" []
"Freeing-Up Figure-Pen"
"Game Plan Angle Map"
"Global Lab Log"
"Glossy Syslog"
"Golden-End Log" []
"Gordo's Org-Dos"
"Great Menu Augmenter"
"Greensdale's Sane Ledgers"
"GritLabs Brag List"
"Hassler-Slasher" []
"I-Carp-Bold Clipboard"
"I-Plan-Plain"
"I-Segment-Meetings"
"I'd-Surge Guiders"
"Idea-Aide"
"In-My-Desk Mind-Keys"
"Inert Sprawl Plan Writers"
"Know-It-Alls['] Walk-On List"
"Kool-Bits List Book"
"Lame Prank Plan Maker"
"Latest-Risk-Task Lister"
"Lead-Rite Detailer" []
"Least-Dire Detailers"
"Least-Skirt-Task Lister" []
"Let's-Go-On Notes Log"
"Linked Kindle"
"Lipman's PlanSim" []
"List of Filt-So-if-Lost"
"ListUm-Multis"
"Log-Em Golem"
"Mad Tinkers['] Task Minder"
"Month-Parse Smart Phone"
"Mr. Note-Mentor" []
"Need-To-Denote"
"Nest-O-Notes" []
"Net-Doer Denoter"
"NewSkill Ink-Wells"
"Not-Broke Rent-Book"
"Notifys-So-Nifty"
"OK-To-Be-On Notebook"
"OOTD To-Do"
"Optimal-Toil Map"
"Org-This-So-Right" []
"PayLand Play-and-Day Plan"
"Pool/Bank Plan Book"
"Rapid-Bloc Clipboard" []
"Record-the-Order Tech"
"Remind-Minder" []
"Resist-Talk Task Lister" []
"Retailed Detailer" []
"Rise-Sod Dossier" []
"Roster Sorter"
"Sane Rigor Organiser"
"Slog-Logs"
"Smarten-Up Part-Menus"
"Soaringer Organiser" []
"Start-Game Stratagem"
"Stocked Dockets"
"Stoke-Boon Notebooks"
"Stolid Do-List" []
"Strat-Start"
"Streamline-Meaner List" []
"Sup-R-Spur"
"Super-Org-Groupers"
"Sure-Force Refocuser"
"Tabs-OK-KO Taskbook"
"Think-More-Hone-Mr. Kit"
"This Log So Light"
"Thumbnail-Hint Album"
"To-Deck Docket"
"Toil-Proof Portfolio"
"Tries-Siter"
"Truer Goal Regulator"
"Unmeagrest Augmenters"
"Very Staid Adversity-Vets Diary"
"WeSparkCo Workspace"
"Win-Lots-Now List"
"Zero-Ragin['] Organizer"

table of posh dialogue [xxv6]
blurb
"'[d-t]? A Toad!'"
"'[d-word-u] shy, hm, Sandy?'" []
"'[if player is female]Gwennie, win Gene[else]Gene, win Gwennie[end if]!'"
"'Aaron, say...' / 'Sayonara!'"
"'Abrasive vibe, Sara!'"
"'Abstain, Bastian!'" []
"'Ace, note [n-t] Coe once ate acetone.'"
"'Ach, Mrs. Schram!'" []
"'Ack! Bend!' / 'Bad neck, Ned?' / 'Back.'" []
"'Ack, Ty! Tacky!'"
"'Act! Ski!' / 'I stack a stick...'"
"'Ad buy, Dubya?' / 'Ya, bud.'"
"'Ad hoc, cad? Ho!'"
"'Ad hoc? Oh, CAD.'" []
"'Ad-hymn, Andy? HM. Hand my...'"
"'Add Cris?' / 'Discard.'"
"'Add one ad.' / 'Done.' / 'Dead on!'" []
"'Addison, no. Dad is odd.' / 'A sin!'" []
"'Adhere, dear, eh?'"
"'Adjustor! A rod juts!'"
"'Adorable lad? A bore!'"
"'Adults, Lad Stu.'" []
"'Aggi, a gig? I gag, GIGA!'"
"'Ah, a cute chateau!'"
"'Ah, Bud, da hub? Uh, bad.'"
"'Ah, dumb, or bad humor?'" []
"'Ah, got a goth to ... gah!'"
"'Ah, Gus, uh...gas?'"
"'Ah, hi, Ms. Hamish!'" []
"'Ah, Lord Harold!'" []
"'Ah, Marc! A charm cam! Har!'"
"'Ah! Nom! ... No ham? Oh, man!'" []
"'Ah, Peters. Spare the rap sheet!'"
"'Ah, Red! Heard her ad?' / 'Har-de-har, Ed!'"
"'Ah, seen Sheena, Aneesh?' / 'Eh, Sean?'" []
"'Ah, Sim! Is Ham Amish?' / 'His Ma.'" []
"'Ah, son. Shona has no...' / 'So?' / 'Nah.'"
"'Ah, Stew. [']Twas he was the...'"
"'Ah, there, Heather.'" []
"'Ah, tuxes! Taxes, uh, exhaust.'" []
"'Ah. Very, Harvey.'" []
"'Ah, Wyatt, why a tat THAT way?'"
"'Ahem, Sis. Shem is a messiah!'" []
"'Ahh, Ann? Hannah?' / 'Nah.' / 'Nah.'"
"'Ahh, rest-hearths!'"
"'Ahh, Ross. So harsh!'"
"'Ail, eh? Lie! Ha!' / 'I...heal.'"
"'Ain't Mr. Martin trim?' / 'Na.'" []
"'Air hockey? Oh yea, Rick!'" []
"'Ale tap! A plate! Eat, pal!'"
"'Alfy, flay a fly.'"
"'All, rig a grill!' / 'Ill! Arg!'"
"'All right, Garth?' / 'Ill.'" []
"'Ally me lamely?' / 'Yell, mama, yell!'"
"'Alone, bud? Undoable.'"
"'Alpha, pal? Ha!'" []
"'Am so, Amos!'" []
"'Ami in a mini! Man, I... I...!'"
"'Amy, be my...' / '[a-b], maybe.'" []
"'Amy, be...' / 'Maybe, Ma. Bye!'" []
"'Analysis?' / 'Assay nil, Lina says.'"
"'Andrew?' / 'Er, Dawn?'" []
"'Ann, buy a bunny!'" []
"'Anti-police caption? Lie!'"
"'Any itch, Cynthia?' / 'Yachtin[']!'"
"'Any more ramen, yo?' / 'Yea, Norm!'" []
"'Anyhow...' / 'Oh, YAWN!'"
"'April fool? Poor flail! Frail loop!'"
"'Art, pigs! Grasp it!'"
"'Artist or Traitors?'" []
"'As do I. Aid so? Oi, sad!'"
"'As giver, Vi Sager-Gervais is grave.'" []
"'As if EVERY five years...'"
"'As to how? Aw, shoot.'"
"'Ask, don't stand, OK?'" []
"'Ask, LOL.' / 'All's OK?'"
"'Ask.' / 'Is a kiss, Kassi...?'"
"'Askew, we ask...' / '[']S weak!'"
"'Asti is at Tia's.'" []
"'Astoundingly untidy slogan!'"
"'At prick Patrick? Ick! Trap!'" []
"'Autonomy, Ma!' / 'Not you!'"
"'Aw, Fern!' / 'Fawner.'"
"'Aw, may I?' / 'I'm away.'"
"'Ay, Doug's so gaudy.'"
"'Ay, Sid. I'd say Daisy Day is.'" []
"'Ay, that's tasty! Ah!'"
"'Bad Leon!' / 'Bald one, old bean!' ... 'A blonde! Lean bod!'" []
"'Bad palate? Adaptable.'"
"'Bad storm. Most drab.'"
"'Bad tie!' / 'I'd beat...' / 'BAITED!'" []
"'Bagel chips? Bilge, chaps!'"
"'Bah, dang handbag!'"
"'Bah, mite! Beat him!'"
"'Bah, tots! That SOB!'"
"'Ban [d-t]? Not bad!'" []
"'The bar, eh, brat? BREATH!'" []
"'Bay home?' / 'Oh, maybe! Ahem! Boy!'"
"'Bay oft, Fat boy!'" []
"'Be Greeks! Beer kegs!'"
"'Be safe, see? Fab!'"
"'Be WHAT? Bath? Ew!' / 'Aw, Beth!'"
"'The beach, eh?' / 'Betcha!'"
"'Beaten? Be neat! Be a TEN!'" []
"'Beauty's easy, but...'"
"'Beefin['], my! Fine by me.'"
"'A beer snob? Bare bones!'"
"'Beg tent, get bent.'"
"'Beggin[']? Biggen? N/G gibe!'"
"'Behave, Eve!' / 'Bah!'"
"'Bend to debt? No, don't be bent. Do...'" []
"'Berthe et Herb Hebert.' / 'Eh, Bret?'"
"'The best? BS teeth.'"
"'Best not bet TONS.'" []
"'Beth is best. ...Hi! ...She bit!'" []
"'BFA? Fab!'"
"'Bid ten?' / 'In debt, Ed.' / 'Bint.'"
"'Bide? I...' / 'Bed, Debi!'"
"'Biff, BFF?' / 'I...'"
"'Big-[a-word] bag, Sis!'"
"'Big fish? Sigh. Fib.'"
"'The bin Hi bent hit Ben!' / 'Eh, bint.'" []
"'A bin? I ban!'"
"'Bird goo! Big odor! Grodi, Bo!'"
"'A bit rude? But, dear, I... true, I, bad.'"
"'Bizzare? Zz, I bear...'"
"'Bloat, ol['] bat!'"
"'Blockade? Cad-bloke!'"
"'Bloopers? Bore-slop!'"
"'Blown off, BFF? No! Low!'"
"'Blue Lava? Valuable.'"
"'Blue words! Us, lewd, bro!'" []
"'Bluff a flu? Fab!'"
"A blurt: 'Brutal!'" []
"'Boat went. Won't be at...'"
"'Bob, I...' / 'Time to imbibe!'"
"'Bodacious cab? ODIOUS!'"
"'Bonfire? / Fine, bro!'" []
"'Boot my TOM? Boy!'"
"'Boots? My. Tomboys!'" []
"'Bore, lad? Deal, bro.'" []
"'Boredom KILLS bedroom skill.'"
"'Borin['] art! Brain rot!'"
"'Bossin['] snob is bossin[']!'"
"'Botany? Me? Maybe not!'" []
"'Botched bod, Chet!'" []
"'Bother to, Herb? Or Beth? Bert? Oh, bother.'" []
"'Bovine vibe? No!'"
"'Boy, just jot...' / 'BUSY!'"
"'Brag on, bro! Nag! No, grab!'" []
"'Bri, how hi-brow!'"
"'Bribe to be IT, bro!'"
"'Bro, I'll rib, LOL.'"
"'Bro! Pa! A prob!'"
"'Bro! Sad broads.'" []
"'Bro, try us!' / 'Sorry, but...'"
"'A brony barn, yo!'"
"'Bub's rec is... subscribe, scrubbies!'"
"'Bub's torn. Stubborn.'"
"'Bucky's BS...yuck!'"
"'Bud Lowe WOULD be due blow.'"
"'Bud's hole should be blue-shod. Bold hues!'"
"'Budgets, Gus? DEBT?!'"
"'Bug me? Um, BEG!'"
"'Buried ire, bud?' / 'Rube, I'd...'"
"'Burn fat? Ban turf? Brat fun!' / 'But Fran...'"
"'But egad! A budget?'"
"'But I'M it, bum!'"
"'But Ron...' / 'No, Burt!'"
"'But...but...' / 'Tut, Bub!'"
"'The butt? Tut, Beth.'"
"'Buy tea, beauty?' / 'Yea...but...'"
"'By the way, why a byte? Thy way be...'"
"'BYOB's BS. Boy!'"
"'Camp out? Pout, mac. Um, po['] cat.'"
"'Can Ed Dance? Ed Can Dance!'"
"'Can fit? Can't if in fact...F! Can it, Fat Nic?'"
"'Can we do anew, Doc?' / 'Down, Ace.'"
"'Can't I pee?' / 'Patience!' / 'Neat epic.'" []
"'Can't Sue enact us?' / 'Nutcase.'" []
"'Cancerous Accuser! No!'"
"'Cap, hit a pitch at Chip!'" []
"'Caption? Not a pic.'" []
"'Card [']em, Mr. Cade?' / 'Mad rec.'"
"'Cashmere? A schemer!'" []
"Cat-like ice-talk." [p] []
"'Cats, I sac it...' / 'Staci!'" []
"'Ceci! Elli! Lice! LICE!'"
"'Chad? Eeh, a headache.'"
"'Charitable? A real...'" [x]
"'Charity? Ach, I try!'"
"'Chaste, eh? Scat!'" []
"'Chat Chez Chaz, Chet!'"
"'Chavs, Chas?' / 'V.'"
"'Chaz!' / 'Zach!'"
"'Cheap suits? Up, chastise!'"
"'Cheat, use the sauce!' / 'He's acute.'" []
"'Cheese sechee? [']S... eeech.'"
"'Chemistry? Cristy? Meh.'" []
"'Cherries, sir! Cheer!'" []
"'Chip, a chap I cap. Hi!'"
"'Chip Ross? His corp's rich sops.'" []
"'A cigar, Garcia?'"
"'Cigar? None? Ignorance!'"
"'Cigar, pet?' / 'Tip, Grace: price tag!'"
"'Clams? Po['] slop, Mac!' / 'Ol['] scamp!' Mo['] claps."
"'Class! Now!' / '[a-word-u]-clown.'"
"'Claudine's uncle said dunces ail.'"
"'Clean lunch? Null chance!'"
"'Clearly. Call yer cell, Ray.'" []
"'Clever rec, Lev!'"
"'A client! Can I let...?' / 'Clean it.'"
"'Clive's OK. Love sick.'"
"'Co-harp, chap, or... oh [crap]!'" []
"'Co-pay cap? Oy!'" []
"'Cocaine?' / 'Once.' / 'CIA!'"
"'Cold? Pah, old chap!'"
"'Cole can conceal ONCE, Cal!'"
"'Collatin[']? LOL, I can't!'" []
"'A commit? I act, Mom.'"
"'Communist scum! / I'm not!'"
"'Confide, Doc? Fine!'" []
"'A connect on accent, once?' / 'Can't!'"
"'Connie's nice, son!' / 'Connie? Nice? NO!'"
"'Consigned.' / 'Seconding.'"
"'Contrary! Rory can't!'" []
"'Cookin['], eh? No...I choke.'"
"'Cooper's rec? Oops!'"
"'Coquettish?' / 'Quit, Chet! So...'"
"'Cordial? Acrid ol['] liar, Doc!'" []
"'Cork wine? Ew, no, Rick! Nice work!'" []
"Coy howl. 'Cool! Why? Holy cow!'"
"'Coy is so ICY!'"
"'A cramp, ma! [crap-u]!'"
"'A cruise is a cure!'" []
"'Cruise? Meh, music here.'"
"'Cure less recluses.'"
"'Cut-rate care? Tut!'"
"'Cutie...' / 'No, I cut one!'"
"'A cyst! Calm?! CATACLYSM!'"
"'D'oh, it's hot, Sid!' / 'Do this.'" []
"'Dad, go on--and GOOD!'"
"'Dainty? Me? Dynamite!'" []
"'Dan set ten ads at ends. Dane St.'"
"'Dan's pro-pardons? Darn sop!'" []
"'Dance tip?' / 'Pedantic, inept cad!'"
"'Dang bold gold band.'"
"'Darling lad! Grin!'" []
"'Darn, Mo! Random!'" []
"'Darn, Ty. Try, Dan!'"
"'Date Beth? Bad teeth.'"
"'Date HIM? Eh, admit I'm hated.'" []
"'Davide? / Dad, I've...'"
"'DAZZZling, Glinda!' ... zzz..."
"'Deal, git. Get laid.'" []
"'The deal is healed. SIT.'" []
"'Death, eh, Tad?' / 'Ah, Ted. Hated!'" []
"'Debark? Erk, bad!'"
"'Debts? Ay, stay. Bed.'"
"'Debunk Ken, Bud.'"
"'Define feedin[']? Fie, Ned!'"
"'Deft intro, tot-friend. I don't fret.'"
"'Defy lax flex day? Axed! Fly!'"
"'Del Chou? Could he? Clued?' / 'Oh, duh, Cleo!'"
"'Demos? Sod [']em!'"
"'Density? Snide, Ty.'" []
"'Dentistries?' / 'Disinterest.'"
"'Detail it, Dale.'" []
"'Details? A list, Ed.'" []
"'Dever's served!'"
"'Dex, to detox!'"
"'Di! Sam! Maids! I'm sad.'" []
"'Diamond? I do, [d-word]!'" []
"'Dick eats dates? Ick!'"
"'Dignity's dying. It's...'"
"'Dirt po[']? Drop it!'" []
"'Dis den? I'd send Eddins.'" []
"'Discharge riches? Gad!'" []
"'Dish, Art.' / 'It's hard. I'd trash this rad ad shirt...'"
"'Disorg? [']S GRODI!'" []
"'Disown Sid NOW!!!'"
"'Dissent ends. Sit.'"
"'Ditch day? Tidy, Chad!'"
"'Ditched? DID Chet?'"
"'Dive in, Vi! Dine!' / 'Divine!'"
"'Diversion so diviner: son, I drive.'"
"'Divot ahead. Avoid death.'"
"'Do as a sod? A dodo! [a-word-u]!'" []
"'Do no harm? Oh, random! ...Darn homo.'" []
"'Do nothing? Ninth? Good!'"
"'Do plan, pal.' / 'Nod.'" []
"'Do pose so dope? Oops, Ed.'"
"'Do what, Tad? How?'"
"'Do'n it? I don't. Not Di.'"
"'Dog, want Dawn?' / 'Got.'"
"'Dogged, odd egg.'"
"'Doin['] em?' / 'I'm done.' / 'Do mine, dim one!' / 'No, Ed, I'm...'" []
"'Dold pies? Lopsided odd piles.'" []
"'Dollar store? Adore, trolls! Stellar odor!'"
"'Don, do no odd.'"
"'Don, wash and show hands.' / 'Ow!'" []
"'Don't dawdle.' / 'Let down, Dad?'"
"'Don't even vent.' / 'Done.'" []
"'Don't need to.' / 'Noted! Noted!'" []
"'Douches? Us? Chode!'"
"'Dour imp!' / 'I'm proud.'"
"'Dowdiness disendows!'"
"'Down as now-sad Dawson? Wan sod.'"
"'Down to two, Don? Ow, don't!'" []
"'Dr. Lidle drilled!'"
"'Draheim's, semi-hard? Mis-heard!'" []
"'Drew, no wonder Ron wed...'" []
"'Drew, son. Rod's new.' / 'Nerds!' / 'Ow!'" []
"'The drip's derps-hit!'"
"'Drop in? No, drip!'" []
"Dry moan. 'Roy! [d-word-u]!' / 'Raymond!'" []
"'DSL Late? Stalled.'"
"'DudeCorp produced DOPE crud!'"
"'Dudgeists! Disgusted!'"
"'A dumpy pad, yum!' / 'Mad?' / 'Yup.'"
"'DVD A is David's.'"
"'Easier arisee? Revile le reveille!'"
"'Eat bugs.' / 'But sage...'"
"'Eat liver? Relative trial, Eve.'" []
"'Eco-nuts? Contuse!'"
"'Eco-raid? Ciao, Red! ... I [i]do[r] care!'"
"'Ed, Marty! Dry meat made...try?'"
"'Ed now owned? No, wed.'" []
"'Ed Panda aped Dan Deadpan!'"
"'Ed spoons dope, sons.'"
"'Ed's hot to shed the sod.'"
"'Ed's men? Send [']em!'"
"'Edi's Side Dies!'"
"'Eek, halt the leak!'"
"'Eelgrass, Graessle? Largesse!'" []
"'Eep, drat, dear pet.'"
"'E.g. chart the crag? Arg, Chet!'"
"'Egad, Mom! Dommage! Dogma!' / 'Me?'"
"'Egad, sleet, delegates! East ledge!'"
"'Eglantine? Inelegant!'" []
"'Ego, Geo!'"
"'Egos, ay.' / 'Yo, sage, go easy!'" []
"'Eh, Ms. Mesh-Mehs?'"
"'Eh, nattier, Henrietta. A thirteen!'" []
"'Eh, no, li'l hellion.'" []
"'Eh, note the one.'"
"'Eh, Pa? Hep?' / 'A heap!'"
"'Eh? Say? Ah yes, Hayes! Ay, she...'" []
"'Eh, Scott! To techs!'" []
"'Eh, Shar Has Her Rehash!'" []
"'Eh, She's...sheesh.'" []
"'Eh, shill. Hellish!'" []
"'Eh, tents, THEN set the nets.'"
"'Elect-rid? Derelict!'"
"'Eli, an alien!'" []
"'Elite? Brr. Terrible.'" []
"'Elite? Egad, I delegate detail. Gee.'"
"'Elton let on to Len...'" []
"'Email [']im, Lea! Go Chat!' / 'Gotcha!'"
"'Email me, Ali!'"
"'Emerge, Meg, ere...' / 'Erm, gee...'"
"'Emil's SLIME!'" []
"'Enact this.' / 'That's nice.'" []
"'Encore, Corene!'" []
"'Epithets tip sheet? The spite!'"
"'Er, is Ma a miser? I'm ears!' / 'Smear? I?'" []
"'Er, Tony? Try one!'" []
"'Er, wit? Write!'"
"'Er...hi! Her, I HIRE!'"
"'Erm, say, Ramsey, MY EARS!'" []
"'Ern! Ren! Nee-nrr!'" []
"'Err, go, Roger!'" []
"'Err, pie, Pierre?'"
"'Err, US surer?'"
"'Erratic rare tic, Cartier!'" []
"'Er...TURF-furter?'"
"'Ever omit overtime?' / 'Er, motive?'"
"'Ew, adding a wedding? Wang DIED!'"
"'Ew, Chas chews a cashew!'"
"'Ew, dorky keyword.'" []
"'Ew, hater!' / 'Aw, there! Whereat...'" []
"'Ew, kind new kid WINKED?'" []
"'Ew, no, Owen!'" []
"'Ew, smut! Um, Stew, MUST we?'"
"'Exalt, men? Lame! Next!'"
"'Fans of so naff!'"
"'Fat-Anon? Not a fan.'"
"'Fat, Zig? ZAFTIG!'"
"'Fatima, am I fat?'"
"'A fax? [']Sup? Faux pas!'"
"'Feasibly? FAILS! Bye!'"
"'Feast him: meat, fish!'"
"'Fedoras? Sore fad.'"
"'Finance Fan? Nice!'" []
"'Fine, bro! Be in for no fiber!'" []
"'Finkouts! FUN to ski!'"
"'Fire me? I'm free!'"
"'Fish! Fish!' / 'Sshh, Fifi!'"
"'Fit, Ma? I'm fat!'"
"'Fit? Sham. Him: Fats. Ham-fist.'"
"'Flab? Lots? Softball!'"
"'Flamboyant fly boat, man!'"
"'Flat?' / 'True. Aflutter.' / 'Treat flu?'" []
"'Flatterer alert! Fret!'"
"'A flimsy film, say! My, FAILS!'"
"'Flirter!' / 'Trifler!'"
"'Floppy, Pop? Fly!'"
"'Flu also?' / 'All of us.'"
"'Flu-sore. Sue Rolf?' / 'Sure, Flo. Sour elf.'" []
"'A flu? Urgent? UNGRATEFUL!'"
"'Food, son? O, so fond!'"
"'Foodies do so? Fie!'"
"'Football? Lob aloft!'"
"'Forceful offer, Luc!'" []
"'Freaking FAKE grin!'"
"'Freaking FAKE ring!'" []
"'Fresh air? Rife rash rare fish!'" []
"'Freshman! Mash! Nerf!'"
"'A frightfully fraught filly!'"
"'Frugal Ralf? Ug!'" []
"'Fry dat drafty fad try!'" []
"'Fudgin[']? Fun, dig?'"
"'Fun rides! Friend us!'"
"'A fur next? Extra fun!'"
"'Furs? Fie, I suffer!'"
"'Gag! His gig has haggis!'"
"'Gag, Otto. Gotta Go.'"
"'Gambler? Me? Blarg!'"
"'Garth, ice the cigar!'"
"'Gasp! Cake packages!'" []
"'Gay gag, yay!'"
"'Gay slur, Ray? Slug.'"
"'Gee, can Ace neg!'"
"'Gee! Clean elegance!'"
"'Gee, dang, engaged.'"
"'Gee, manic! Nice game!'"
"'Gee! Trips! Prestige!'"
"'Gems? SMEG.'" []
"'Genivere, I...' / 'Revenge!'"
"'Get a room, or go, mate!'"
"'Get hip?! The pig HIT PEG!'"
"'Ghostily, oh, sly git!'"
"'Gigabit? Big A? Git.'"
"'Gil's ma is glam? Slag!' / 'I'm...'"
"'Give a...' / 'I gave.'"
"'Given a trite vinaigrette?' / 'Vintage tier.'" []
"'Given tea?' / 'Negative.'" []
"'Glitch? Tch, Gil.'"
"'Glover! Vogler! Grovel!'"
"'Go alt, Al? Got to lag.'"
"'Go bad, Bo? Gad!'"
"'Go clash! Log cash!' / 'Gosh, Cal!'"
"'Go dance once, gad!' / 'Acne, dog!'"
"'Go dream, Marge. Do.' / 'Gad! More?'"
"'Go finer! Foreign! No grief!'" []
"'Go first or gifts?' / 'Sit, frog.'"
"'Go in, man.' / 'No gamin['] in among...?' Moaning. 'I'm gonna...'" []
"'Go mine, Imogen! / I'm gone.'" []
"'Go past? Pa, gots to gasp!'" []
"'Go private? A veto.' / 'Prig.'"
"'Go public. Glib coup.'"
"'Go racin[']? No cigar!'" []
"'Go to war to grow a...'" []
"'Go up it. Pig out!'" []
"'Goad a dog! Gaga dodo!'" []
"'Godawful Flaw, Doug.'"
"'Gold cup? Gulp, Doc!'"
"'Gone: Paris? Singapore.'" []
"'Good faith? Oh, do a gift.'" []
"'Good grief! Fired? Go! Go!'"
"'Good? HIM? Ohmigod.'"
"'A goon bevy? Bon voyage!'"
"'Gosh, Nick. Shocking hick song.' Conk. Sigh."
"'Gosh, Ted. The dog's ghosted!'" []
"'Gosh, Vin! Shoving!'"
"'Got cake? Go, K.C. Eat.'"
"'Got fired? Get rid of grief, [d-t].'" []
"'Got hurt? Urgh, tot.'"
"'Got land? Not glad? Don't lag!'"
"'Gourmet Urge, Tom?'" []
"'Gouty gut, yo!'"
"'Grandeur? Rear-dung!'" []
"'Granola, Al? Groan!'"
"'Graveyard? A drag, very.'" []
"'Great, I'd grade it.'"
"'Greed is EDGE, Sir.'"
"'Greedy Ken. Geeky Nerd!'"
"'Grim? Nay, I'm angry!'"
"'Grumpy, Mr. G? / Yup.'" []
"'GTHO, goth!'"
"'A guest! Tea, Gus!'"
"'Guises, Gussie? I guess.'" []
"'Gus, set guests!'"
"'Guys, met my guest?'"
"'Gwen, my new gym...'"
"'Gyros? Unh, so hungry!'"
"'Ha! Joke!' / 'Oh, JAKE.'"
"'Ha, pry, harpy!'"
"'Hair wrong? Harrowing!'"
"'Half bad fad? Blah!'"
"'Half mast? Flat sham.'"
"'HALF's flash.'"
"'Handsome? Dan? So meh!'" []
"'Handsome? No. SHAMED!'" []
"'Hangups?' / 'Puns. Gah!'" []
"'Happy?' / 'No, phony, Pa.'"
"'Hard-up? PHRAUD!'"
"'Harping, prig?' / 'Nah.'"
"'Hate Mr. Mather? Meh, Art!'" []
"'Haw, Don had won, and how!'"
"'Hayride? Hi! Ready!'"
"'He'd nag, dang, eh?'"
"'He's ill, Shelli.'" []
"'He's into THIS one?' / 'Honest, I...'" []
"'He's loyal.' / 'Ha, solely?' / 'Say hello.'"
"'He's tart. The star.'" []
"'Headachy?' / 'Yeah, Chad.'"
"'Health farm? Eh, flat harm.'"
"'Hearsay!' / 'Aye. Rash.'"
"'Hearts Haster Tsar, Eh? Ah, rest!'" []
"'Heaviness, VANISH! See?'"
"'Heck, eat the cake.'"
"'Heh, I'm Him. Eh?'"
"'Heidi! Hi!' / 'Die!'"
"'Heifer, HER? Fie!'"
"'Heir? Fudge, a figurehead! Ugh, I feared...'"
"'Heir? HIRE!'" []
"'Heists? She's it!'" []
"'Hentai, a... in the... ETHAN!' / 'I...'"
"'Her Man's Sherman.'" []
"'Her, taming the margin? Amen, right.'" []
"'Hesitance? Hit a scene.'"
"'Hey Al Haley!'" []
"'Hey Lew! Wheely!' / 'Why, Lee?'"
"'Hey, subs, he's busy!' / 'Hussy, be...'"
"'Hi, Capt. A pitch at Chip?'" []
"'Hi, Dan. Nah, I'd hid an...'" []
"'Hi, Dave! I've had Hev-Aid!' / 'Eh, diva.'" []
"'Hi, dear! Ah, dire I heard...'"
"'Hi, demo ok?' / 'I'm hooked.'" []
"'Hi! Fools! Foolish!'"
"'Hi-ho! Ohh, I...'"
"'Hi, Leon. Hole in line, Ho!'"
"'Hi, Mary! My hair...' / 'Hyram, I...' / 'Ray him!'"
"'Hi, Pete. The Pie?' / 'Eh...I...pet...'"
"'Hi, son I...nosh?' / 'Ish, no.'" []
"'Hi, stuck?' / 'Us? Thick...'"
"'Hi, Tank! Think a...' / 'Nah, Kit.'"
"'Hi, totes-hotties!'" []
"'Hi, Wood! How do I...' / 'Whoo, I'd...'"
"'A hick? Ack! ... Hi!'"
"'Hickeys? Yechski!'"
"'Hideous house, Di!'"
"'Him, a demon!' / 'Ad hominem!'"
"'Hire add?' / 'Diehard, I'd heard.'" []
"'Hireable? HERE?! Bail!'"
"'His graft: far sight!'"
"'His pa, as hip? A... pish!'"
"'Hm, a ham! Mm, haha!'"
"'Hm, yes, my, he's meshy.'" []
"'Ho, who's...' / Whoosh / 'Oh, how's...?'"
"'Hobbes be bosh!'"
"'Hog [']em! Go!' / 'Meh.'"
"'Homais? Oi! Sham!'"
"'Home-style? He's motley.'"
"'Hon, as Noah's has no ash on...'" []
"'Hostel! Hotels! Oh, let's...!'"
"'Hot asset? He's toast.'"
"'Hot damn!' / 'Don't ham.'" []
"'Hot darn! ... D'oh! Rant!'"
"'Hot dog? Eek, get hooked!'"
"'Hot flan! Not half flat, hon.'"
"'Hot king, go think!'"
"'How dumb, Bud. Whom?'"
"'How not hot, now!'"
"'How now. Who won?'"
"'How so?' / 'Woosh!'"
"'How still meh? I'll show them!'"
"'Hubert, but her...' / 'The rub: be hurt!'"
"'A hug? Augh!'"
"'A huggy guy. Gah!'"
"'Huh, dud? Duh. DUH!'"
"'Hum more.' / 'Uh, er, Mom?' / 'Humor me.'"
"'Hup, Stu!' / 'Shut up!'"
"'Hush now, huns!' / 'How?'"
"'I be glum! Belgium? Um, bilge!'"
"'I bet on Benoit. No bite?'" []
"'I dare.' A dire 'Er, aid?'" []
"'I? Debt? I'd bet it'd be...'"
"'I educate.' / 'Cute idea.'"
"'I goofed, good. Fie!'"
"'I hang in. Agh!'" []
"'I hatch a hitch.'" []
"'I hate Tia.' / 'Eh?'" []
"'I know, Wright. Working with right kin? Wow!'"
"'I, Manly, Mainly am lyin['].'"
"'I mean ME, Ian!'" []
"'I? Mock Mo[']? Ick!'" []
"'I need to edit one...'" []
"'I once saw winos, Ace.'"
"'I rated a tired 'Rad tie, dear, it...''" [p] []
"'I resent SireNet!' / 'Sit, Rene.'"
"'I save on, as I've no evasion.'" []
"'I set up pie, Stu!'"
"'I, the diva, I've HAD it!'"
"'I, umpteen meetin['] up.'"
"'I'd lost lids to...' / 'Do list!'" []
"'I'd rec Edric.'" []
"'I'm at it, Ma!'"
"'I'm bored' / 'Bromide: bid more.'"
"'I'm dead, Maddie! Em did a...'"
"'I'm home, Mom!' / 'Eh? I...'"
"'I'm IT. Beg. BIG TIME!'" []
"'I'm, like, lie, Kim!'"
"'I'm pro! Primo!'"
"'I'm sad, Sam.' / 'I'd...'" []
"'I'm sleek! Kim Lees likes me!'"
"'I'm sorry. Rori's my...'"
"'I'm sure, Mr. I sue!'" []
"'I'm upset!' / 'Um, spite!'"
"'I'm wet, Tim.' / 'Ew!'"
"'I've...' / 'Tosh. Shove it.'"
"'Icing gone? Nice going!'"
"'ID Lost?' / 'It's Old.'" []
"'Idle, tots? Let's do it!'"
"'I.e. Dad aided Addie.'" []
"'I.e., Dr. Reid, DIRE!'" []
"'I.e. RSVP, vipers!'"
"'I.e. sad aides['] ideas aside, Sadie.'" []
"'If [']twas a swift fist...aw.'"
"'If Sal fails, is Alf fils a...?'"
"'If tons of snit--no fist.'" []
"'Ignorable, Gabriel? No!'"
"'Il povre?' / 'Pro-evil ol['] viper!'"
"'Ill, Pa? A pill?'"
"'Ill? Wes is well!' / 'Swell, I...'"
"'Immoral liar, Mom!'" []
"'Impose? No, Moon pies poison me.'"
"'Impression?' / 'Permission?'"
"'In, ma?' / 'Na, I'm ... a min ... man, I ...'" []
"'Indiscretion? Indirections.'"
"'Indoors odor? SIN!'"
"'Inept recap, apprentice!'"
"'Intimacy? My, I... I can't!'"
"'Into [toti]? Not I!'" []
"'Into drugs? Turgid, son.'"
"'Intro a ration? Not Ari!'"
"'Invest it, Sven!'" []
"'IOU?' / 'Oui.'"
"'iPhone, eh? No IP?'" [p]
"'IQ? Gun, too? Go! No quit!'"
"'IQ un-apt? Piquant quip, Nat!'"
"'Ire task, sir? Take a strike!'" []
"'IRS, sir!'"
"'Is coy Ben nice, boys?'"
"'Is CPR PC, sir?'" []
"'Is he fat? Eat fish!'" []
"'Is meat OK? Make it so.'"
"'Is Tank Atkins a Skint?'"
"'Is Ted Deist?'"
"'Is this on?' / 'To hissin[']!'"
"'Is Wes Weiss...?' / 'Ew, sis!'"
"'Isis, Noel LIONISES oiliness!'" []
"'It causes...' / 'ICU seats?' / 'A cutsies.'"
"'It seems semi-set.'"
"'It's Dan! I stand!'" []
"'It's like, silk tie? Kit LIES!'"
"'It's up! Go, pigs, out!'"
"'It's...' / 'SIT!'"
"'Ivies top?' / 'Positive.'"
"'Jam jar room? MAJOR!'" []
"'Jam out?' / 'Um, a jot.'"
"'Jana, I'm in a jam!'"
"'Jaunty SOS? Just say no!'"
"'Jerkish...' / 'Eh, sir?' / 'J/k.'"
"'J/K, there.' / 'The JERK!'"
"'Joyce is coy, Jesi.' / 'Sic Joey!'"
"'Ken? Hot? Ok, then.'"
"'Ken's a snake!'"
"'Key time yet, Mike?'"
"'Keyed up, Duke?' / 'Yep.'"
"'Kid, cut Sue.' / 'Suckitude.'"
"'Kip, son. Pinkos spin, OK? Skip...' / 'NO!'" []
"'Kiss her.' Shrieks. 'Eh, risks.'"
"'Kite, Rob?' / 'It broke.'"
"'Knead! Danke.'"
"'Know, Al: walk on lawn, OK.'"
"'Know what?' / 'Wow. Thank...'"
"'Kudos? Ok'd? Us?'"
"'L-Dopa? A plod, old Pa.'"
"'Lady Dee? Delayed!'"
"'Lady, son?' / 'Sadly, no.'"
"'Lampton's plan-most plots, man...'"
"'Landless? Sell sand.'"
"'Landmines? Lad, men sin.'"
"'Lapses passel, Pa?' / 'Less.'"
"'Lara wed Al Warde? Raw Deal!'"
"'Lass, vie! I've Sal's valises!'" []
"'Laud Fred? A fuddler! Dreadful.'"
"'Leaving, vile nag!' / 'Lavigne!'" []
"'A leet GIF? Get a life!'"
"'Len's gut lungest.' / 'Glutens.'"
"'Lent? SOS. Net loss. [']S stolen.'" []
"'Leopold's dope? LOLs!'"
"'Les, I'm...Mel is SLIME.' / 'Is Lem?'" []
"'Li'l Bro or Bill? Brill-o!'" []
"'Li'l Wes is well.' / 'I'll sew...'" []
"'Liam! Len! All mine!' / 'Mean! I'll...'" []
"'Libel! I'll be...'"
"'Lick me, Mel!' / 'Ick!'"
"'A lie, Leia!'" []
"'Like waves? Lake views? Weave silk!'"
"'Limo? Moil, Milo.'"
"'Link, Ed?' / 'IDK, Len.'"
"'Linotyped pointedly? Only tepid.'" []
"'Lisa, too, is a tool!'"
"'Literally...' / 'Later, Lily!'"
"'Liz, Pip! Zip-lip!'"
"'Lo, smelt! To smell tolls me!'"
"'Lo, son! Solon Olson!'"
"'[']Lo, team!' / 'Mo! Late to meal!'"
"'Load up, Paul! Do!' / 'Loud, Pa!'"
"'Loafers! So feral!'" []
"'Loathe Theola! Loathe!'" []
"'Log off fo['] Golf!'"
"'Lola, a LOL?'" []
"'Long wail allowing? No, ill wag!'" []
"'Longest legs? NOT!'"
"'Lookies!' / 'OK, I lose.'"
"'Looks OK, Sol.'" []
"'Loonies soil one.'"
"'Lord high...girl? D'ohh!'"
"'Lost dog got sold to Gold's.'"
"'Lost rarest artless rot? Last resort...'"
"'Loud toy? You dolt!'" []
"'Low-bred bowdler!'"
"'Luci, don't!' / 'I couldn't!'"
"'Luckily I'll...YUCK!'"
"'Lump scare? Super calm.'"
"'Lunge, Pa! Angle up a plunge!'" []
"'Lychees, Chelsey? Eech, Sly.'"
"'Ma, Feel Female.'"
"'Ma, he's...' / 'Shame, eh, Sam?'" []
"'Ma, I seen meanies!'" []
"'Ma, opt to Pam.' / 'Apt, Mo.'"
"'Ma, Sad? Mad as Ms. Ada Adams!'" []
"'Mad, Gil? I'm glad!' / 'Dim gal!'"
"'Mad men! Damn [']em!'"
"'Maddie, Ma died!' / 'Dad, me... I...'" []
"'Made it! I tamed a timed...'"
"'Maggie, I...' / 'Gag me!'" []
"'Major mojo, Mr. A jar!'" []
"'Make this hate skim!' / 'I, ahem...' / 'Tsk.'" []
"'Malcolm, call Mom.'"
"'Malik? Kim? Al? A milk?'" []
"'Malodors? Door slam!'"
"'Man! A dire marinade.'" []
"'Man, Brenda's brand names!'" []
"'Man-Toy to Many? Not Amy!'" []
"'Mandy!' / 'My dandy man!'" []
"'The map? Apt? Meh.'" []
"'Marathon? Martha? No!'" []
"'Marcy! My car!' / 'Cry, Ma!'" []
"'Maria! Ew!' / 'I'm aware.'"
"'Mark's wool looks warm.'"
"'Marti, a trim?' / 'Art, I'm...'" []
"'Mass? Try St. Mary's.'" []
"'Mate, I'm weak. Make [']em wait!'"
"'THE MAW, Mathew!' / 'What, me? Aw...THEM!'"
"'Max the tax? Meh.'" []
"'Maxi-tans? At six, man!'"
"'Me, a win? I am new!'"
"'Me? Cigar? Grimace!'" []
"'Me, Doc: MedCo EcoMD!'"
"'Me, exert? Extreme!'" []
"'Me, tithe? ... The time!'" []
"'Me wild? We! Mild!'" []
"'Meal done? Lemonade!'"
"'Mealtime? Me, I'm late.'"
"'Mean, JT! Jet, man!'"
"Mean prod. 'Pardon me.' Name Drop." [p] []
"'Measures?' / 'Reassume same user.'"
"'Mediocre cider? O me!'" []
"'Meek clap. Keep calm.'"
"'Meet [']im? Me time!'"
"'Meetups? Must pee...'" []
"'Meg, I'm ... / Gimme!'"
"'Men, I'd go demoing.' / 'Mendigo.'"
"'Menial? Eli, man, Nail [']em!' / 'I am, Len!'" []
"'A meteor!' / 'More tea?'"
"'Mia, Ted made it! Date [']im!' / 'Tied, Ma!'" []
"'Midterm trimmed, Mr.! Timed!'"
"'Migraines, sir? Enigma.'" []
"'Miladies, idealism!'"
"'Milly? Ill? My.'" []
"'Mini-set! It's mine!'"
"'Minor-Co micro? No, MORONIC!'" []
"'Mint juleps? Let's jump in!'"
"'Miser, sir? Me?'" []
"'Mistraced timecards? Mister CAD!'"
"'Mitch! Max! Match, mix.'"
"'Mix ten!' / 'I'm next!'"
"'Mix up ten?! I'm up next!'"
"'Mm, say, Sammy, my ma's Ms. May.'"
"'Mo Choi? Coo, him? [']I mooch![']'"
"'Mo['] bran, Bro-man!'"
"'Moe's some emo. O Me!'"
"'Mohawks! Ask!' / 'Whom?'"
"'Mold, eh? Hold me!'"
"'Mom, hey! My home!'"
"'Mom, hire him or me!'"
"'Mom! Pop! Mo['] pomp!'"
"'Mon ange, gone, man!' / 'Megan? No!'"
"'Moni's moins Simon.'" []
"'Monitor it, moron!'"
"'Monstrous tumors, son.'" []
"'Montgomery?' / 'Gone. Try Mom.'"
"'More news: mere snow? Worse, men!'"
"'Mousy, eh? My house. You mesh.'" []
"'Mr. Cutie? I'm cuter.'"
"'Mr. Day!' / 'Mardy Dr. May!'"
"'Mr. Kato! Mark! To OKMart!' / 'Rot. KMA.'"
"'Mr. Saudee Measured. Made sure.'" []
"'Ms. Kris. Mr. Sisk.' / 'Smirks.'"
"'Munroe? Um, er, no.'"
"'Must-have muse? Ah, TV!'"
"'Mustache, oh? Sham! Touche!' / 'Mouth, chase so much hate!'"
"'Mutant? Tut, man.'"
"Mutters. 'Rum test, er, mutts.' / 'Trust Me, Mr. Stute.'"
"'My, a ride! I'm ready! Ray! Demi!'"
"'My arse, Ramsey.'" []
"'My bread, Dr.?' / 'Maybe.'" []
"'My case: scam ye? Yes, Mac.'"
"'My dear, I--I'm ready.'" []
"'My dorm, Mom? Dry.'"
"'My goal: log Amy. Glam, yo!'"
"'My group's so grumpy! Romp, guys!'" []
"'My guess: Sue's gym?' / 'Smug yes.'"
"'My legs! Sly, Meg.'"
"'My plan: I play Nim.' / 'Lyin['], Pam!'"
"'My Porsche shop! Mercy!'"
"'My serial mislayer, Mr. Easily-Smearily!'"
"'My shoes! Oh, messy!'" []
"'My son is ON, my sis!'"
"'My, son! Mony's...'"
"'My system sets...' / 'Mess, Ty.'"
"'My wish: Whimsy!' / 'Why, Sim?'"
"'My zit care? Crazy time!'"
"'Myopic, coy imp!'"
"'Nanci, free refinance can refine...'"
"'Naw, Deb's bad news.'" []
"'Naw, Seth. He wants new hats.'" []
"'Naw, sit. I wasn't wastin[']...'"
"'Ned, is Denis snide?'" []
"'Ned, mass madness!'" []
"'Need proof? Ponder, foe.'"
"'New car rec?' / 'Naw.'"
"'New leg, Glen? Ew!'"
"'New OS? Owens-Snowe? Son, we...'"
"'New show? Whew, son!'"
"'Newsroom?' / 'More snow. Worn some.'"
"'Newt did. We didn't!'"
"'Next git texting? Tix, gent.'"
"'Next step: pen texts?' / 'Spent, Tex.'"
"'Nice rack? Care, Nick!'"
"'Nicety, sir: insert icy sincerity!'"
"'Nick, Jo! Jockin['] Jon? Ick!'"
"'NIGEL'S single.' / 'Is Glen?'"
"'No, [d-t]! Do not nod to...o, don't!'"
"'No B's? Snob!'"
"'No baths?' / 'Bah, tons!'"
"'No-brainer, Inaner Rob.'"
"'No bribes? Snobbier...'"
"'No cut, Count!'"
"'No, Drew! Ron wed, Red? Now? Downer.'" []
"'No horse shoe, Ron? Oh, snore!'"
"'No, I'm on [']im, Moni!'" []
"'No mice come in.'" []
"'No pals? So, plan!'"
"'No pearls or panels? Personal.'"
"'No-show? How, son?'" []
"'No spots? Tops, son!'"
"'No trash! Ah, snort! Oh, rants!'" []
"'No white wine, tho['].' / 'Hit Owen, the wino.'" []
"'No wrath, Wharton-Anworth?'"
"'Noisy bums! Son, I'm busy!'"
"'Nominated? Admit none!'"
"'Non-fats fan? TONS!'"
"'Non-odd do'n, Don!'" []
"'Nopalito? Optional.'" []
"'Nor am I, Marion!'" []
"'Nor THY thorny try, hon['].'"
"'Not Ned's tendons!'" []
"'Not set?' / 'Tetons? No test!'" []
"'Not well? Tell, now.'"
"'Notice it once.' / 'Nice to notice.'"
"'Now, Rog?' / 'WRONGO.'" []
"'Nut job!' / 'But Jon!'"
"'NY, kid? Dinky!'"
"'O, bear a bore!'"
"'O Billy! Lil Boy!'"
"'O, lively ville, yo!' / 'I...lovely!'"
"'O Splat! Pa Lost!'" []
"'O, thin! Hit on? ...In! Hot!'" []
"'O, those soothe.' / 'He's too...' / 'She, too.'"
"'Obsolete obese lot!'"
"'Octane, Ace?' / 'Not at once.'"
"'OD, Tex? Detox!'" []
"'Odd boory body odor!'"
"'Odd day, daddy-o!'"
"'Odd log, old dog.'"
"'Offends? Send off!'"
"'Office, Tom? Come off it!'"
"'Oh, a FTW? Of what?'" []
"'Oh, aid Idaho!' / 'Ah, I do!'"
"'Oh and Ha! Don had no Honda.'" []
"'Oh, drat. Hard to do, thar.'" []
"'Oh, Evita, I HAVE to!'"
"'Oh, Gus, Hugo's so...UGH.'"
"'Oh, it's Mr. I'm-Short-Mirth-So.'" []
"'Oh, lad, a hold!'"
"'Oh, MY slur? Sly humor.'"
"'Oh, Nell?' / 'Hell, no!'"
"'Oh, pie, I hope. Eh? Poi?'"
"'Oh, rats. A short sort, ah?'"
"'Oh, repute up to here, eh, pouter?'"
"'Oh, Rita!' / 'Hot air.'"
"'Oh, Tad had to.' / 'D'oh! At...?'" []
"'Oh, this? Hi, tosh!'"
"'Oh, yes. Oy, he's so...' / 'Hey!'" []
"'Oho, dumb bum-hood!'"
"'Oho, say! Yahoos!'" []
"'Oil! Neat! Elation! To a line!'" []
"'Oil? Psh. Polish so, phil. Oh! Slip!'" []
"'Oil stock? Too slick.'"
"'OJ, wine: we join.'"
"'OK, [n-t]'s so taken.'" []
"'OK, deny, donkey!'"
"'Ok, Dr. ... Dork.'"
"'OK it?' / 'Nod.' / 'Too kind.'"
"'Ok, Oz, a kazoo!'"
"'OK, rec, Coker?' / 'Crook Creek.'"
"'Ol['] webs be slow, Bowles!'" []
"'Old age? Go deal.' / 'Ego, lad.'"
"'Old cow!' / 'Low, doc!'"
"'Old town! Now, dolt!'" []
"'Olive loaf vile? Aloof!'"
"'Omit Ken, not Mike.'" []
"'On a hit? Ah, not I!'"
"'On, fellow!' ... 'Lone wolf?'" []
"'On target?' / 'Not great.'"
"'Onanism, I? Insomnia!'" []
"'Onanism? No man is...'" []
"One prim 'Rip [']em? No, I'm prone.'"
"'One room?' / 'No, Romeo!'"
"'One thing...' / 'Neigh not!'" []
"'Oo, guest goes out!'"
"'Ooh, ah, plus hula hoops?'"
"'Ooh, cries! Choosier coo, heirs!'"
"'Ooh, Meg?' / 'Go home, hog Moe!'"
"'Ooh, Pat! A photo!'"
"'Oop, Del, ol['] dope!' / 'Poe, old poodle!'"
"'Open house? Hope on, Sue.'"
"'Or gowns? So wrong! Grow, son!'"
"'Or Night? Right On!'" []
"'Or TV ops, provost...'"
"'Other recs, Rochester?'" []
"'Our boy? YOU, bro!'"
"'Our go, sir? Rigorous!'"
"'Our Igor's Rigorous!'" []
"'Ow, mind! I'm down!'" []
"'Ow, not by Town, Boy.'"
"'Owe? Woe!'"
"'Owners, dis rowdiness.'"
"'Oy, a rude one! You are done!'"
"'Oy, a wag? Go away!'" []
"'Oy, Bill's silly, Bo!'" []
"'Oy, for froyo!'"
"'Oy. Sad.' / 'Do say.'"
"'Pa, I fart!' / 'Parfait!'"
"'Pa, if I fap...' / 'Ai! Pf!'"
"'Pa, she...' / 'Phase, eh, sap?'"
"'Pack it in? Panic? Kit, a nitpick.'"
"'Pah! Cold, old chap.'"
"'Paid for prof aid? Oaf! Drip!'"
"'Pam? Not top, man.'"
"'Parakeet? Keep a rat!'" []
"'Paralyzed ad rep? LAZY!'"
"'Parchesi? Cheap, sir!'" []
"'Patchiest. [']S pathetic.'"
"'Pathology? A goth ploy!'"
"'Patsy or sport, ya?' / 'Oy, prats!'"
"'Pause, Sue.' / 'PA!'" []
"'Pay Red per day?' / 'Yep.' / 'Rad.'" []
"'Pay slid? Dip, a Sly Display.'"
"'Payouts up to, say...'" []
"'Pedal cab? Bad place!'"
"'Peg's no sponge.'"
"'Pet, Ike? Keep it.'"
"'Peter, Dad departed.'" []
"'PG, sir!' / 'Prigs!'"
"'Phil, set his pelt!' / 'Shlep it!'" []
"'Photo op? Hot!'" []
"'Picayune!' / 'Ayup.' / 'Nice.'" []
"'A pickle?' / 'Ick! Pale!'" []
"'Pie, Ace?' / 'A piece.'"
"'Pie, OK? I poke Po['] Ike.'"
"'Pig, fetch a cheap gift!'"
"'Pig? Great! Get a grip!'"
"'Pinch a chap in an...Chip! Pain! Ch!'"
"'Pink Floyd? Dinky flop!'"
"'Pinko? Kip? NO!'"
"'Pip Erd ripped Dr. Pepi!'"
"'Pix, Neal. Explain.'"
"'Plan yet? Penalty!'" []
"'Plaudits! Sit up, lad!'"
"'Play a joke? Peak joy, Al.'"
"'Play dumb amply, bud.'" []
"'Play safe!' / ' Safely, Pa!' / 'False yap.'"
"'Playtime empty? Ail? Lame? Pity.'"
"'Plus, pie piles up.'"
"'Plus the help, uh, slept, Stu.' / 'Hup! Let's...'"
"'Poofy fop! Yo!'"
"'Pop in on Pip!'"
"'Pop music comp is UP!'"
"'Pop's oral proposal? Poor, pals!'"
"'Posher tone? Nope. Others.'" []
"'Post mine! ... NEPOTISM.'" []
"'Pre-edit. Tepider.'"
"'Precede Creep Ed? Cred? Eep.'"
"'Prickly Ply, Rick!'"
"'Pride, man. Damn ripe and prime!'"
"'Prigs! Not sporting!'"
"'Princess, go!' / 'Processing...'"
"'Prob not trop bon.'"
"'Probe us? Sober up! Sop! Rube!'"
"'Probity? Pity, bro.'"
"'A problem.' / 'Ample, bro.'" []
"'Promo, Mr.? Poo!'"
"'Property tax export? PARTY!'"
"'Prove it. Overtip.'"
"'Puberty's Burst? Yep.'"
"'Pudgiest? Ug, spited, e. g. stupid.'" [p]
"'Pundom? Yes, son. D-U-M. Yep.'" []
"'Punish his pun!'" []
"'Push, push!' / 'Shush, pup!'"
"'Pushy?' / 'Yup.' / 'Sh!'"
"'Put Don DuPont up?' / 'Don't!'"
"'A putt? Tut, pa!'"
"'Quanti-quaint!'"
"'Quantify.' A tiny FUQ."
"'Queer. TED'S requested?'"
"'Quite odd. I'd quoted...' / 'Ed, do quit!'"
"'Rad slo-mo door slam!'" []
"'Rah! Ned Harden... eh? Darn. Ah, nerd.'" []
"'Rank, eh? Harken! Hanker!'"
"'Raps? Tut, Upstart!' / 'Pa, trust...'" []
"'Rare dis, dear sir!'" []
"'Rats, Ted started!' / 'Rest, Tad.'"
"'Raw tie.' / 'Wear it, waiter!'" []
"'Read this!' / 'Shared it!'"
"'Read, Tony! Tread yon!' / 'Not ready!'" []
"'Reading? Dang, I, er...'" []
"'Ready, deary?' / 'Yea, Dr.'"
"'Rec, sis?' / 'Esric's Crises.'" []
"'Recaf? Farce!'" []
"'Red Bob Robbed Dr. Bebo Dobber!'"
"'A red read! Dear!'"
"'Redist.? I'd rest, Sir Ted.'" []
"'Regular real rug? Urrg, Lea.'"
"'Reminded indeed, Mr.!'"
"'Resave-averse as ever?'" []
"'Retrophilia? Horripilate!'"
"'Reviled? Deliver. I'd revel.'" []
"'Rhabdo? Oh, drab.'"
"'Ride-cams? I'm scared.'"
"'Ride it!' / 'I tried!'"
"'Rilke liker? Reek! Irk! Ill!'"
"'Rob! Ada! Dara! Bo! Aboard!'"
"'Robot, eh? Herb too? The boor!'"
"'Rod's fault, artful sod? Loud farts!'" []
"'Roll Tide!' / 'Die, troll!'"
"'Rory's Sorry.'"
"'Rot, Ty. TRY to!'"
"'Rouge-sheen greenhouse. Generous, eh?'"
"'Roundtable? Not durable, urbane dolt.'" []
"'Rube is busier. Rib Sue!'"
"'Rude bod, dude-bro!'"
"'Rufe Kosta freaks out Kera Foust.'" []
"'Rug sale. Lag?' / 'Sure!'" []
"'A rum, yes, Mary Sue?' / 'Yum, Resa!'" []
"'Rush it. His rut is THRU!'" []
"'Rut, Mo? To rum!' / 'Um, rot!'" []
"'Ruth's in! Run this hunt, sir!'"
"'Rutner-Turner? Err, nut.'"
"'Ry, Fab? Barfy, By far!' / 'Fry, Ab!'"
"'Sac, eh? Chase aches!'" []
"'Sad. I see. See, said disease is eased...'"
"'Saddo odd as Dad...so...'"
"'Sadist at Sid's? It's sad.'" []
"'Sal! Tim! I'm last!' / 'Milt, as...'" []
"'Salmond's Mossland? [d-word-u] loss!'"
"'Sam or Roma's? Or Ma's?'" []
"'Sandwich! Chad Wins!'"
"'Sarah's as rash. Harass...'"
"'Sardonic? Acrid, son? So rancid? No, sir! Cad!'" []
"'Saw Watts. [']Twas...' / SWAT!"
"'Say, be by sea, [a-b]?' / 'Yay, Bess!'"
"'Say! Tasty!' / 'Stay, stay!'" []
"'Say tons so nasty to Nyssa? Son, STAY!'" []
"'A scalp, Pascal!'"
"'Scams lose some class. Mass close.'"
"'Scheine? He's nice.'"
"'Schmoose. Smooches?'"
"'Scoundrel unscolder!'"
"'Scry it, Cristy!'"
"'See, Hirsch cherishes Cheshires!'"
"'See, pro? Repose so, peer.'"
"'See, Tom? Emotes seem to meet so.'"
"'See, um, ... ' / 'Sue me!'"
"'Seen both? Be honest!'"
"'Seen my yes men?'" []
"'Seen oafs? A sense of...one's safe.'"
"'Selective, else...evict!'"
"'Semi-hot? Shite, Mo!'" []
"'Senor Disk, son, risked dorkiness.'"
"'Senorita's assertion notarises SO nastier.'"
"'Set to?' / 'Totes.'"
"'Shades, I said she is sad, eh?'"
"'Share, cad? Hard case!'" []
"'Sharing, eh? Rehashing!'"
"'She's not hotness!'" []
"'She's not Seth's. No.'" []
"'Shep, i've... ' / 'Pish, Eve! His Veep...'"
"'A shorn Hans or Ron has no rash.'" []
"'SHOULD it? Dish, lout!'"
"'Show [']Em Who's Me?' / 'We mosh, Ms. Howe.'"
"'The shrub burst, ehh? Thus, Herb?' / 'Shh. Brute.'"
"'Sibyl, so bossily!'" []
"'Sick, er peon! Nose picker!'"
"'Sid! Toi! Otis! Di! I... sod it, idiots!'" []
"'Sid's rest disserts distress.'"
"'Side note...' / 'I don't see...'"
"'Sigh at a sight, ah, gits?'" []
"'Sigh. Mended hidden gems.'"
"'Sir, need deniers? I'd sneer.'" []
"'Sis DID dis Sid!'" []
"'Sis, dismal dismissal.'"
"'Ski, eh? Hikes shiek?'"
"'Skilled, kid? Sell!'"
"'Skyrail, Al? Risky!'"
"'A slip-up? Sail, pup!'"
"'Sly, Pop? Sloppy.'" []
"'Smirkiest mis-strike! Kismet, sir!'"
"'Smit, Pa?' / 'Pam, sit. I'm past...'"
"'Snap! Sit, Pissant!'"
"'A sneer, Arsene?' / 'Er, Sean?'" []
"'Snide-O Edison is DONE.'" []
"'Snow day dawns, oy!'"
"'Snub Rick: sick burn? Bunk, Cris!'"
"'So, a trek? Or skate?'" []
"'So ample? Lame, sop.'"
"'So, any?' / 'Ya.' / 'Son! Say no! Ay! SON!'" []
"'So, Audry! Our day's dour, say.'"
"'So, Billy!' /'Lo, Sibyl!' / 'Oy, bills.'" []
"'So bore THEM, bothersome!'"
"'So, brat? To bars or bats?'"
"'So broke bores, OK?'" []
"'So bummed Moe's dumb.'"
"'So? Candy?' / 'Nosy cad.'"
"'So, chap, the cheap shot hath scope.'" []
"'So cheap? Posh, Ace!'"
"'So, cured, Doc?' / 'Sure.'"
"'So, Darin is rad, no?'" []
"'So, Dick?' / 'I'd sock DiskCo.' / 'Ick. Sod.'"
"'So, dolt! Do lots?' / 'Old sot!'"
"'So, Etta, to eats!'" []
"'So, Herby!' / 'Hey, bros!'" []
"'So huggy? Gosh, guy!'"
"'So, Hugh, go!' / 'Hush.'"
"'So, Ida, do as I...' / 'Adios!'"
"'So, ingrate. Teasing or nastier? Go! Aegis: torn!'" []
"'So, Mikey!' / 'Yikes, Mo!'"
"'So mum, Su? Mom?'"
"'So, Rod! Odors!'"
"'So sticky! Icky! Toss!'"
"'So, Uncle, clone us!' / 'No clues. Un-close. Counsel?'"
"'So, wind is down now, Sid.'"
"'So, with it? Show This. Ow! How's it...'" []
"'So, y'all. All soy?' / 'Say, LOL.'" []
"'So yer on Rooney's? Yes or no, son...or ye...'" []
"'So you're a caviler! You're so cavalier!'"
"'Some dude doused me!'"
"'Some PR, Mopers! Mo['] reps!'"
"'Some tonic? Nice, Smoot.'"
"'Son, is Sis...? No!'"
"'Son, pissy synopsis!'"
"'Son, tuck, unstock. Suck not!'" []
"'Son's big. Bossing.'"
"'Soon, Perry?' / 'Nope, sorry.' / 'Ornery sop!'"
"'Soon, pet. One stop.'"
"'Sore, chap? A Porsche!'"
"'Sore, nut?' / 'Not sure.'"
"'Sort at tarots so tart? Art-sot!'" []
"'SOS, Al!' / 'Lasso a loss as SOL.'" []
"'Sot? No, not so! Son, to...'" []
"'Soup, [d-t]?' / 'Stood up too, Spud?'"
"'Soup by pubs? Oy!'"
"'Soy-plum so lumpy? Yum, slop! Ply us mo[']!'"
"'Soybeans? Boney ass!'"
"'Soylent? No style!'" []
"'Spam-a-tron, so rampant!'"
"'Spaz Chet? Chez Pat's.'"
"'A speech, Peaches!' / 'Eh, space.'" []
"'Spoil'd? Eh? POLISHED! Hide, slop!'" []
"'Sponsor pros, son.'" []
"'Sport? Pah! Pop trash!'"
"'Spumoni, son?' / 'I'm up!'"
"'Spy Al plays sly, Pa.'" []
"'St. Hope's set, posh? The sops!'" []
"'Stan, be absent!'" []
"'Stan Nast Tans Ants.' / 'Stats, Ann?'" []
"'Start smarm? Smart. SMART.'" []
"'Stay put, Patty Su!'" []
"'Stay?' / 'Ooh, too ashy.'"
"'Steady, Ted. Say!' / 'Yes, Tad?'"
"'Stilo?' / 'I lost it, Sol.'" []
"'Stinkeyes sent? Yikes!'"
"'Stint an instant!'"
"'A stock? TaskCo!'"
"Stoniest snotties." [p]
"'Stop, Cathie! So pathetic to pastiche.'"
"'Stop her, eh, sport?' / 'Pothers!'" []
"'Stripes persist. Press it, sir! Step!'" []
"'Stu, my musty, um, sty!'"
"'Su's age? A guess?'"
"'Subscriber bribes? Curs!'"
"'Such brats! Trash-cubs!'"
"'Suck it!' / 'Ick, Stu!'"
"'A sulk, Klaus? Ask Lu.'" []
"'Sulky? Boo! Look busy!'"
"'Summer? Mm, sure.'" []
"'Summon Mum, son!'"
"'Sunroof? For us? No.'"
"'[']Sup, pet?' / 'Pep, Stu! Step up!'"
"'[']Sup Tom? / Um, stop.'"
"'Suppose Pop sues?' / 'Supe-sop!'" []
"'Sure into routines.' / 'True, son, I...'"
"'Sure may, Mary Sue!'" []
"'Surrogate, ours? GREAT!'"
"'Swank do, eh? SHAKEDOWN!'" []
"'Syndee?' / 'Yes, Ned?'"
"'T. Watson Wants to not swat at Wont's. Now, stat! No Twats!'"
"'Ta-dah! Da hat!'"
"'Tact is static.'"
"'Tad Hodes? Shot dead?'"
"'Tad, I'm' / 'Ma, it'd' / 'Admit it, mad!'" []
"'Tad! Wes! Ted was wasted. Wade St.'" []
"'Take [']im, make it! Ta, Mike!'" []
"'Tame liar material.'"
"'Tango? I? No gait!'" []
"'Tank is a skint.'" []
"'Tanked, Bro? Don't break...'"
"'Taunted, Dean? Tut!'"
"'Taxes reaped. Exasperated.'"
"'Taxis at six!' / 'Uh, rider, hurried?'"
"'Tea, Mr. Marte?'" []
"'Tea, Tom?' / 'To meat, Matteo!'"
"'Team player? Tame parley!'"
"'Tears? Rates a Rest!'" []
"'Teary, Pat? TEA PARTY!'" []
"'Ted ails.' / 'Sit, deal details.'" []
"'Ted, Pare red tape!'" []
"'Ted, son. St. Deon Doesn't...'" []
"'Ted's SO tossed!'"
"'Tee up OK?' / 'Keep out!'"
"'Telethons? Let's not, eh?'"
"'Ten-ply? Plenty.'"
"'Tend urge, rude gent? Get under!'"
"'Tent, yo?' 'Note, Ty: not yet!'" []
"'Terri, ew! Rewrite!'"
"'Test it. Bah, that bites.'" []
"'Tex, I... / EXIT!'"
"'Text MINE next time!'"
"'Textins[']? Sit next!'" []
"'TGIF'n? F'n git!'"
"'Tha feds shafted...' / 'He's daft!'"
"'That, I'd hit, Tad.'"
"'That so, tots? HA!'"
"'Thayer, is thy raise this year?'" []
"'A theft, eh, Taft?'"
"'Thesis: Bums miss the bus.'"
"'Thorne hot, Ren?' / 'Not her.'" []
"'Those Ethos? So the...he's to?'" []
"'Thoughtful? Golf? Uhh, tut.'"
"'Thug, ho?' / 'Uh, goth.'"
"'Thwait!' / 'Ah, twit, thaw it!'"
"'Thy gal's Ghastly!'"
"'Tiger?' / 'Dad, tired! Gad!' / 'Did great.'"
"'Tim, Alf! I'm flat at film.'"
"'Tim, learn Nim!' / 'Later.'"
"'Timmy's smit, my!'"
"'Tin Bo Tobin-Binot? Bi? NOT!'"
"'Tina, do No Donation!'"
"'Tip, Grace?' / 'Price tag! Act! Gripe!'" []
"'Tip, Wes: spew it!' / 'I swept pits. Ew.'"
"'Tired, eh? The ride.'" []
"'Tiresome emote, sir!'" []
"'[']Tis rum. Truism.'"
"'Tits lie.' / 'Elitist!'" []
"'To an end? Not Dean!' / 'Done, Nat.'"
"'To bike? OK, I bet.'"
"'To census, countess!'"
"'To Chip: chop it!'"
"'To Dirk: Rot, Kid. OK it, Dr.?'"
"'To ideas, toadies!'" []
"'To rides! So tired? Do rites! Or diets!'" []
"'Toasted! Go, good taste!'"
"'Tofu, hick?' / 'Oh, [f-w] it!'" [x]
"'Tofu? No, too fun.'"
"'Tofu year? After you!'" []
"'Tom, I...' / 'I'm to Omit it, Mo.'"
"'Tony, so snooty, oy!' / 'Tons!'" []
"'Too busy to buy, so, OUT, boys!' / 'Boy, to us?'"
"'Too crude, Doc! Outre!'"
"'Too pushy?' / 'Yup.' / 'Shoot.'"
"'Top art? Rot, Pat!'" []
"'Top, son. Spot on! No stop!'"
"'Torn ACL: act lorn? Not Carl.'"
"'Toss-up? Stop us!'"
"'Tourism rims out.'"
"'Touted duetto ode? Tut!'"
"'Toy ten? Not yet!'" []
"'Tracy, I've veracity!'" []
"'Tradesmen need marts.'" []
"'Translate. Start, Neal.' / 'Later, Stan.'"
"'Trapped? Prep, Tad.'" []
"'Trickery trek? I cry...'"
"'Triste's trite.' / 'Rest it.'"
"'Troops nigh? Poor things!'"
"'True, Simon?' 'I'm not sure.'"
"'True, son. Not sure? Rue tons.'" []
"'A true, uh, hauteur!'"
"'Tut, dear, rude tat!' / 'True dat! [']Tude, Art!'"
"'Tut! Lie, to let it out?'"
"'Tut, sis! It's stu!'"
"'Ty! Half-fly hat!'"
"'Ty, I'd tidy it. D'y...'"
"'U sack us? Ack, sucka!'"
"'Uck! Bald? Bad luck!'" []
"'Ug, Al's a slug.' / 'Ug, Sal.'"
"'Ug! Do Doug?!'" []
"'Ug! Say a guy's gay? Us?'" []
"'Ug! Wild Ludwig!'"
"'Ugg, Steve is suggestive!'"
"'Ugh, LEAD, Ed. Laugh, huge lad.'"
"'Ugh, trip, upright pig Ruth!'"
"'Ugly [']do, old guy!' / 'Go, duly!'"
"'Uh, Bess? He's sub-bushes.'"
"'Uh, Brant?' / 'Ha, burnt!'"
"'Uh, Count? / Uncouth nut! Ouch!'"
"'...uh, covers over such vouchers.'" [p]
"'Uh, Meg? Hug me!' / 'Hm...eug.'"
"'Uh, Mrs. Shrum?'"
"'Uh, pet? Put up the...' / 'Eh?'"
"'Uh, tennis in the sun?'"
"'Uh, toil's loutish.' / 'Tosh, Lui!'"
"'Uhgh, Hugh. Ughh.'"
"'Uhh, do...' / 'Oh, duh!'"
"'Um, beth? The bum...meh.' / 'But...'"
"'Um, chap? A chump?' / 'Much, Pa. Pam Chu...'" []
"'Um, inept pun time? Put mine...'"
"'Um, pal? A lump!'"
"'Um, soy! Yum, so mousy.'"
"'Um thatch that much?'"
"'Unbred! Burden!' / 'Burned!'" []
"'Unworthy to run? Why? Oh, wry nut!'" []
"'Up a tree?' 'Eep! A rut!'" []
"'Up, toast! Stout, Pa!'"
"'Updike? I puked!'"
"'Upgraded, prude? Gad!'"
"'Uppity?' / 'Yup. Tip?'"
"'Upside, Norm?' / 'Unpromised.'"
"'Urinate taurine!'"
"'Us? Ace cause!'" []
"'Veal, Vela?' / 'VAL!' / 'Leave!'" []
"'Vegan? I ail. LIVE again!'" []
"'Vegan? I gave in.'" []
"'Venal, Levan. Venal.'"
"'Very low, love? Wry.'"
"'VIP? No? Po['] Vin.'"
"'VP does dev-ops.'"
"'Wail, Stu! Wus!' / '[']Til a LAWSUIT!'"
"'Wan fop! Pawn of...'" []
"'Wanna, Ann? Aw.'"
"'Want! Do!' / 'Dawn, to...' / 'Now, Tad!'" []
"'Want now?' / 'Won't. Naw.'"
"'Want sex?' / 'Tax news was next!'"
"'Way hot hat, yow!'" []
"'Way too big? Yow! A bigot!'"
"'We can go once. Wag.'" []
"'We hire where I wire, eh?'" []
"'We know Ken!' / 'Wow!'" []
"'We... lost ol['] Stew.'" []
"'We won? Eww, no.'"
"'Wealth is lies.' / 'WHAT?!'"
"'Wes, Lea saw Lee...' / 'Weasel!'"
"'What if?' / 'Haf-wit!'" []
"'What news? Whew, Stan!'"
"'What's hot? How's that?' / 'Aw, shh, tot!'" []
"'When does...who needs Ed now he's...?'"
"'Who bet HotWeb?' / 'We, both!'" []
"'Who farted? Wade forth!'"
"'Who's going? Gong show!' / 'I!'"
"'Who's in?' / 'Wish on!'"
"'Who's on? No show? How, son?'"
"'Whoah, how?' / 'Ah!'"
"'Why I eat a whey? It... HEY! WAIT!'"
"'Wild oats, Waldo? Sit!'"
"'Wild tot!' / 'Old twit!'"
"'Wily, Red? Weirdly.'"
"'Wimp out?' / 'I'm up TWO!'"
"'Winds. Go dowsing?'" []
"'Wine, bro? Brownie?' / 'No, I...' / 'Brew? Brie now?'"
"'Wink at Kit? Naw, Watkin.'"
"'Winston won't Sin, On, twins!'"
"'Wise guy, eh? Weigh ye us!'"
"'Wit snafu! Was unfit!' / 'Naw, Stu, if it was fun...'"
"'With Meg, we might wig them!'"
"'Wonton? No, won't. Not now.'"
"'Woo yeah! Ahoy! ... Woe!'"
"'Woot, Rolf! Floor two!'"
"'Woozy, Oz?' / 'Yow!'"
"'WORDAGE, dowager!'"
"'Wordiness dies. SWORN.'" []
"'Workin['] Ink Row now, Rik?'"
"'Working, Rog?' / ' Wink.'"
"'Worn? OK, No work.'"
"'Wow, ardent toward new? Water down...'"
"'Wow, these! How sweet!'"
"'Y'mind, Mindy?'"
"'Ya bored, dear boy?'"
"'Ya, it's' / 'Say it!' / 'I stay.'"
"'Ya thawt that way? Why? Ta-ta!'" []
"'Yasmine, I...yes, man!'"
"'Ye dull one. You'll need...'"
"'Ye mask keys, Ma? My sake?'"
"'Yeah, rid hair dye.'" []
"'Yeah, V. Heavy.'" []
"'Yell at all yet?' / 'Ay.' / 'Tell.'" []
"'Yells about ballet. Yo, us? Absolutely!'" []
"'Yes, Alan. Analyse.'"
"'Yes, buds. Debussy.'"
"'Yes, Mr. Myers.'"
"'Yes, Ms. Symes?' / 'Messy.'"
"'Yet all yell at a telly lately.' / 'Ay, tell.'" []
"'Yet...I'd die. T/Y, edity deity!'" []
"'Yield, team. Meet daily.'"
"'Yo, ask it. It's okay.'" []
"'Yo, ask Kay so.'"
"'Yo, Bec! Be coy!'" []
"'Yo, Beth, the boy...hot...' / 'Bye!'" []
"'Yo, bloke, look!' / 'Bye.'"
"'Yo, bread, dear boy!'" []
"'Yo, chaps, a psycho!'"
"'Yo, chomp, my pooch!'"
"'Yo, dog!' / 'Goody!'"
"'Yo Herm! My hero!' / 'Roy? Meh.'"
"'Yo, I...thus is youth!'"
"'Yo, nudge Ed Young.' / 'Done, guy.'"
"'Yo, sport. Too-spry try.' / 'Oops.'" []
"'Yo, Tad!' / 'Ay, [d-t]!' / 'Today!'"
"'Yoga? Aw, go away!'" []
"'Yoga? Odd. Yo, Go, Dad!' / 'Good day.'"
"'You need help.' / 'Elude, phoney!'"
"'You SMOKE, Moose? Yuk!'"
"'Young man, um, nag yon!'"
"'Yuck, a bore...YOU'RE BACK?!'"
"'Zit? Scary!' / 'It's crazy.'"

table of posse bosses [xxv7]
blurb
"[a-word-u]hat Shasta" []
"[a-word-u]hole Sal Shoe" []
"[crap-u] Kid Pickard" []
"[crap-u]-Kind Pinckard" []
"[d-word-u]-Why Wyndham" []
"[d-word-u]ed Dedman" []
"[dick-u] Elsie Siedlecki"
"[dick-u] Fern Fendrick"
"[dick-u] Ian Kincaid" []
"[dick-u] Karon Kondracki"
"[dick-u] Leo Dolecki"
"[dick-u] Rae Radecki" []
"[dick-u] Teri Dietrick" []
"[dick-u] Therese Ketcherside" []
"[dick-u] Wes Sedwick"
"[if player is male]Barry 'Bud'[else]Drab Ruby[end if] Bradbury"
"[if player is male]Sham Reg[else]Rash Meg[end if] Gresham"
"[t-w] Watt"
"A-OK Tad Dakota AKA Tod" []
"Abe 'Legs' Beagles"
"Abe 'Nah' Bahena"
"Abel 'Ranch' Labranche"
"Aborter Roberta" []
"Abrupt Pub-Rat Pa Burt"
"Abused Bad Sue"
"Ace 'Gun' Gaunce"
"Ace Lord DeCarlo" []
"Ace Rogue Oceguera"
"'Achoo' Ochoa"
"Acne Lord Calderon" []
"Actorly Cal Troy" []
"Addled Ed Ladd"
"Adler 'Fibs' Brasfield"
"Adorned Denardo" []
"Adorner Reardon" []
"Adulating Daignault"
"Afflicter Ratcliffe"
"AIGH Haig"
"Al 'Hands' Sandahl-Ashland"
"Al 'Legs' Slagle"
"Al 'Ski' Kalis"
"Alan 'Fang' Flanagan" []
"Alarmed Delamar" []
"Albany Ana Bly"
"Albert 'Gun' Altenburg"
"Alden 'Fib' Banfield" []
"Alderman [if player is male]Mel Randa[else]Erma Land[end if]" []
"Aldo 'Sneer' Rosendale" []
"Alec 'Ski' Cieslak-Lasecki"
"Ali 'Gun' Gaulin"
"Ali 'Plod' Padillo"
"Alina 'Plod' Palladino"
"All-Drab Ballard"
"All-Harms Marshall"
"All-Narc'd Crandall"
"All-Set Stella"
"All-Tripe Petralli" []
"Alleged-Legal Ed"
"Allen 'Ski' Kinsella"
"Allogenic Collegian [if player is male]Eli Colgan[else]Lila Gonce[end if]"
"Alma 'Gun' Mangual"
"Almighty May Light" []
"Alone Leona 'No Ale' O'Neal" [p] []
"Alta 'Legs' Steagall"
"Amaya 'Ski' Yamasaki"
"Amber 'Gun' Guberman"
"Amber 'Nah' Haberman" []
"Amie 'Zits' Zemaitis"
"Amoral Alomar" []
"Amy 'Nah' Hayman"
"Ana 'Ranch' Carnahan"
"Andre 'Ski' Iskander"
"Andree 'Legs' Greenslade"
"Angel 'Ski' Keasling"
"Animated [if player is male]Adam Tien[else]Mia Dante[end if]"
"Animator Ramonita" []
"Ann 'Nah' Hannan"
"Annoyer Ronayne" []
"Anthemic Teichman" []
"Anton 'Fib' Bonfanti"
"Anton 'Ski' Atkinson"
"Any-Hat Nat Hay"
"Any-Musk Manusky"
"April 'Gun' Pulgarin"
"April 'Ski' Pilarski"
"Ara 'Gun' Uranga"
"Ara 'Legs' Lagares"
"Ara 'Mo['] Aroma' Amaro" [p]
"Arch 'Legs' Schlager"
"Arm-Twist Tim Straw"
"Arm-Twister [if player is male]Master Wirt[else]Star Witmer[end if]"
"Armed Mr. Ade" []
"Arms Dealer [if player is male]Darrel Ames[else]Lara DeMers[end if]"
"Aron 'Specs' Casperson"
"Arsey Ayers" []
"Arsonist Tina Ross"
"Art 'Legs' Galster"
"Art 'Nah' Trahan"
"Art 'Ski' Triska"
"Art 'Sneer' Santerre"
"Art Lover Val Torre"
"Artless Eden Latendresse"
"Artless Pa Lastrapes"
"Asa 'Ski' Sasaki"
"ASBO Sabo (a SOB)" []
"Ash 'Nah' Shahan"
"Asha 'Gun' Sahagun"
"Ashli 'Legs' Hillegass"
"Astonishing Tina Hissong"
"Astronomer Monterrosa"
"At-Large Art Gale" []
"Athletic Cal Hiett" []
"Auditor-Toad Rui"
"Aunt Carlee Laracuente"
"Aunt Gia Antigua"
"Aunt Gilda Daignault"
"Aunt Gilma Manigault"
"Aunt Mimi Tumminia"
"Aunt Molina Lamountain"
"Aunt Pham Hauptman"
"Aunt Ro Turano"
"Aunt Safi Faustina"
"Aunt Sherie Steinhauer"
"Aunt Sherise Steinhauser"
"Aunt Zina Nunziata"
"Aura 'Ski' Sakurai"
"Ava 'Legs' Salvage"
"Average Erv Gaea"
"Avoidant [d-t] Viana"
"Avoider [if player is male]Dave Rio[else]Ida Rove[end if]"
"Back-Door Brad Cook" []
"Back-Room Boor Mack" []
"Bad-at-Math Ahmad Batt"
"Bad-Breath [if player is male]Thad Baber[else]Baba Herdt[end if]"
"Bad-Eyes Dee Bays"
"Bad Guy Bud Gay"
"Bad-Heart Beathard"
"Bad-Joke-Bod Jake"
"Bad-Joke Jed Bako" []
"Bad Lu Abdul" []
"Bad-Neck Dan Beck" []
"Bad Sol So Bald"
"Bad Taste Beast Tad"
"Bad-Teeth [if player is male]Ted Bathe[else]Dee Bhatt[end if]" []
"Bad Tipper Debi Trapp"
"Bad Yob Bob Day" []
"Baffling Biff Lang"
"Bag Boy Bob Gay"
"Bahler's Herbals"
"Baiter [ta] Erb" []
"Bald Ali Badilla"
"Bald Earl Beardall"
"Bald Eli Dibella"
"Bald Ellis Blaisdell"
"Bald Lee Debella"
"Bald Len Belland-Bendall"
"Bald Leo Bedolla" []
"Bald Les Blasdel"
"Bald Lon Bolland"
"Bald Nestor Balderston" []
"Bald Old Dad Boll" []
"Bald Oren Rabenold" []
"Bald Rene Breeland"
"Bald Rey Bradley" []
"Bald Reyes Beardsley" []
"Bald Roy Bolyard"
"Balding Badling Glib Dan" []
"Balistreri Irritables"
"Balker Kabler"
"Ballestero Tolerables" []
"Ballsy [if player is male]Sal Bly[else]Sally B[end if]" []
"Baloney-Boy Neal" []
"Baltimore [if player is male]Emil Tabor[else]Elma Brito[end if]" []
"Bam-Now Bowman"
"Banal Laban Alban"
"Bane Lord Bolander" []
"Banged-Up Gabe Pund"
"Bankrupt Punk Bart" []
"Bao 'Ski' Kosiba"
"Bar Kid Drabik"
"Barb 'Clunk' Blackburn"
"Barger Garber" []
"Bari 'Gun' Bugarin"
"Bari 'Legs' Balsiger"
"Barky Rybka Rybak"
"Baron Alec Barcelona"
"Baron Cara Carbonara"
"Baron Cora Carbonaro"
"Baron Del Rabenold"
"Baron Ed Broaden"
"Baron Em Oberman"
"Baron Giles Gabrielson"
"Baron Hans Brosnahan"
"Baron Lecy Clayborne"
"Baron Les Alberson"
"Baron Lu Lubrano"
"Baron Ma Boarman"
"Baron Muse Rosenbaum"
"Baron Nabor" []
"Baron Ned Darbonne"
"Baron Reid Berardino"
"Baron Sam Sambrano"
"Baron Su Ausborn"
"Baron Ty O'Bryant-Brayton"
"Baroness Bess Roan"
"Baronet Boatner" []
"Base Mr. Barmes"
"Base-Stain Sebastian"
"Bashful Alf Bush"
"Bastard Barstad" []
"Battler Blatter"
"Be-Illin['] Bellini"
"Be-Lucky Buckley"
"Beagler Laberge"
"Bear-Hug Baugher" []
"Bearded Bad Reed" []
"Bearish Abisher"
"Beast Arn Abrantes" []
"Beast Sonia Sebastiano" []
"Beastly Stabley" []
"Beastly Ty Bales" []
"Beau 'Ranch' Brancheau"
"Becki 'Ranch' Rickenbach"
"Been-Legal Ballengee"
"Beer-Swigs Weissberg"
"Bein[']-Sly Lisenby" []
"Beldin's Bindles"
"Belen 'Ski' Senkbeil"
"Belgian Big Neal"
"Belia 'Sneer' Siebenaler"
"Belier Lieber"
"Bellicose [if player is male]Bill Escoe[else]Ilse Coble[end if]" []
"Bellies Belisle"
"Benched Deb Chen"
"Bend-All Belland" []
"Bent-Dice Benedict"
"Bent Dr. Berndt"
"Berating-Binge Art Brigante"
"Berdine Bendier Breedin[']"
"Berquist Briquets"
"Bert 'Gun' Bungert"
"Bestial Ableist Eli Bast" []
"Better-Count Bettencourt"
"Bickery Rick Bey-Brickey"
"Big Ben Ebbing"
"Big Body Bo Digby"
"Big-Boned Ed Gibbon"
"Big Boss Bob Giss"
"Big Brain Rina Gibb"
"Big Bully Bub Gilly"
"Big-Cigar Gib Craig"
"Big Gib"
"Big Hearted [if player is male]Ted Bagheri[else]Edith Gaber[end if]"
"Big Lean Gabe Lin" []
"Big Leo Loebig"
"Big Lin's Sibling" []
"Big Ma Gambi"
"Big Mel Gimbel"
"Big Mouth Tim Bough" []
"Big Mr. Dean Bridgeman"
"Big Ms. Elana Blasingame"
"Big Nose Sig Bone"
"Big Rat Bartig"
"Big Ron Gibron" []
"Big Tough Tobi Hugg"
"Bigot Hart Boatright"
"Bigot Kuhn Bouknight"
"Bigot Wrenn Brewington"
"Bilge Tot Gottlieb"
"Bily Nerd Brindley"
"Binger Ingber"
"Birdlike Kilbride"
"Black-Eyed Clyde Beak"
"Blades Sebald"
"Blaguer Glauber" []
"Blander Lad Bren"
"Blank Cheat Kaltenbach"
"Blesser Bessler"
"Blind Ma Lambdin"
"Blind Mart Milbrandt"
"Blind Ogre Olberding" []
"Blind Retha Hildebrant" []
"Blind Rey Brindley" []
"Blind Treva Vanderbilt"
"Blithe Beth Li"
"Bloated [d-t] Abel" []
"Bloated [if player is male]Bo Delta[else]Deb Alto[end if]" []
"Bloated Dolt [a-b]" []
"Blobby Bob Bly"
"Blooey O'Boyle" []
"Blotter Ol['] Brett Tolbert"
"Blow-Mad Wambold"
"Bluffing Biff Lung"
"Bo 'Nah' Hoban-Bohan"
"Bob Helt the Blob" []
"Bodgy Godby"
"Bogus Nutter Stoutenburg"
"Bogus Ren Burgeson" []
"Bold Bold Blob Dold"
"Bold Haired Hard Boiled [if player is male]Harold Bide[else]Diedra Bohl[end if]"
"Bold Lad Oddball Al B. Dold" []
"Bold-Mar Lombard"
"Boldy Loyd B. Dolby"
"Bolthead Theobald" []
"Bone-Dry Ren Boyd"
"Bonier Rob Nei"
"Bony Al Boylan-Boylan-Baylon"
"Bony Art Brayton" []
"Bony Carl Clayborn"
"Bony Clare Clayborne" []
"Bony Ed Boyden" []
"Bony Liska Yablonski" []
"Bony Tula Labounty" []
"Bony Wes Owensby"
"Boodler Robledo" []
"Boozer Rebozo"
"Boozing Biz-Goon Oz Gobin"
"Boozy Boy Oz"
"Borat 'Ski' Bartosik"
"Bored Adah Broadhead"
"Bored Ann Darbonne"
"Bored Arlen Oberlander" []
"Bored Lan Bolander" []
"Bored Rick Broderick" []
"Borg Fred Bergdorf"
"Boris 'Nah' Harbison"
"Borneo Oberon" []
"Boss Adrien Bedrossian"
"Boss Arch Rossbach"
"Boss Earlie Labossiere" []
"Boss Ellie Boisselle"
"Boss Karim Samborski"
"Boss Karol Alsbrooks"
"Boss Man Snob Sam"
"Boss Millie Bellissimo"
"Boss Miura Ambrosius"
"Boss Nettie Bissonette"
"Boss Reina Soberanis" []
"Boss Renae Soberanes"
"Boss Rhea Boshears"
"Bossier [if player is male]Bo Reiss[else]Bess Rio[end if]"
"Bossy SOB Sy"
"Botcher Obrecht"
"Bowlin['] Wilbon"
"Boxin['] Bo Nix"
"Boy-Band Don-Baby"
"Brad 'Gun' Bungard"
"Brahman Branham"
"Braider Berardi"
"Brain Dead [if player is male]Ian Bedard[else]Ada Binder[end if]"
"'Brains' Mel Silberman"
"'Brains' Oleg Gabrielson"
"Brat Bart Tabb-Tarr"
"Brat Mel Lambert" []
"Bree 'Gun' Buenger"
"Bribe-O Robbie" []
"Bribee Bieber"
"Briller Birrell"
"Bro Lew Bowler-Wrobel" []
"Brock 'Nah' Hornback"
"Broker Bo Kerr"
"Brown Line Ben Rowlin"
"Brutal Brat Lu" []
"Bucker Rubeck"
"Bug Boy Bob Guy"
"Bugbear Burbage" []
"Bulkier Rik Blue"
"Bull-Neck Bucknell"
"Bulldozer [if player is male]Ozell Burd[else]Luz Dobler[end if]"
"Bullish Bill Hsu"
"Bully Coia Coulibaly"
"Bully Lu Bly"
"Bullying-Gun Billy"
"Bum Anna Baumann"
"Bum Arn Barnum"
"Bum Brian Birnbaum"
"Bum Chan Buchman"
"Bum Eaton Beaumont"
"Bum Garey Amburgey" []
"Bum Hagan Baughman"
"Bum Hans Bushman" []
"Bum Opal Palumbo" []
"Bum Regena Greenbaum"
"Bum Rosena Rosenbaum" []
"Bum Susan Nussbaum"
"Bum Teresia Baumeister"
"Burned Bud-Ren Dubner" []
"Burt 'Nah' Rathbun" []
"Burton 'Sneer' Stoneburner" []
"Bushgoat Stobaugh" []
"Busy Rae Seabury"
"Busy-Work Ruby Skow"
"Butcher Bert Chu"
"Buttery Brute Ty"
"Buttery Tut Byer"
"Byzantine Benny Zita"
"Cajoled Cad Joel"
"Cake/Tart Attacker Kat Trace"
"Callous Sheri Louischarles"
"Callous Sol Luca" []
"Calm Archie Carmichael" []
"Calm Bo Balcom"
"Calm Cyr Mcclary"
"Calm Denis Mcdaniels" []
"Calm Doug Mcdougal"
"Calm Elias Escamilla" []
"Calm Enid Mcdaniel" []
"Calm Gould Mcdougall"
"Calm Ira Marcial"
"Calm King Glickman"
"Calm Lina Mancilla"
"Calm Lon Collman"
"Calm Loria Camarillo"
"Calm Lucey Mccaulley"
"Calm Lyn Mcnally" []
"Calm Mo Malcom"
"Calm Nell Mclellan"
"Calm Noe Coleman" []
"Calm Orel Marcello" []
"Calm Red Mcardle" []
"Calm Rhea Lamarche" []
"Calm Risa Mariscal" []
"Calm Slick Mccaskill"
"Calm Trena Marcantel" []
"Cancerous Oscar Cuen" []
"Caner Crean" []
"Canonizer Canzoneri"
"Capable Pa Caleb" []
"Capri 'Ski' Pisarcik"
"Car Kid Radick"
"Care-Poor Pecoraro"
"Carlee 'Ski' Kilcrease"
"Carroty Rat Cory" []
"Cash-[']Em McShea"
"Cate 'Nah' Ancheta"
"Cavalier Calaveri"
"Cecila 'Gun' Angelucci"
"Cedary Darcey" []
"Celano's Seconal" []
"Cerebral Carl Eber"
"Chain Smoker [if player is male]Nick Ashmore[else]Rose Hickman[end if]"
"Chairman [if player is male]Mara Chin[else]Ric Haman[end if]"
"Chancery Cary Chen"
"Chas 'Frat' Ashcraft"
"Chased Ed Cash"
"Cheap-Rug [if player is male]Cap Huger[else]Peg Rauch[end if]"
"Cheat Burl Culbreath" []
"Cheat Ira Iracheta"
"Cheat Karl Thalacker"
"Cheat Koch Heathcock"
"Cheat Kyra Thackeray" []
"Cheat Lina Chatelain" []
"Cheat Lou Latouche" []
"Cheat Ly Atchley"
"Cheat Marion Chiaramonte" []
"Cheat Min Teichman" []
"Cheat Raul Archuleta" []
"Cheat Sabra Bastarache"
"Cheat Sue Eustache" []
"Cheat Theo Heathcote"
"Cheat Wink Whitenack" []
"Chen 'Zits' Nitzsche" []
"Chevron Vern Cho"
"Chew-Legs Schwegel"
"Chief Rider Friederich" []
"Chiseler Chris Lee"
"Chiselled Dechellis"
"Chortling Clint Groh"
"Chris 'Gun' Schuring"
"Chubster Schubert" []
"Chun 'Ski' Huckins"
"Churlish Lush Rich"
"CIA-[a-word] Caissa Isaacs" [x]
"Cider Edric Redic" []
"Cigar Man Ragin['] Mac"
"Cigar Nut Traci Ung" []
"Civil Alan Villicana"
"Clan-Herd Chandler" []
"Clear VIP Percival" []
"Clearin['] Carline" []
"Cleta 'Ski' Kastelic-Eastlick"
"'Clink' KC Lin"
"Clodpole Dell Coop"
"Clouter Coulter"
"Cloying Long Icy Gino Cly" []
"Clued Ed Luc" []
"Coddled Cold Edd"
"Coe 'Ranch' Cochrane"
"Coercive Eric Cove"
"Cogniser/Co-Signer Rescigno"
"Coiner [if player is male]Enrico[else]Corine[end if] Cerino"
"Cokin['] Nicko"
"Cold Ariane Candelario" []
"Cold Bad Bold Cad Doc Bald"
"Cold Beth Bechtold"
"Cold Earl Cardello" []
"Cold Eli Cedillo" []
"Cold Em McLeod"
"Cold Fae Defalco"
"Cold Fife Coffield"
"Cold Fish Flo Disch"
"Cold Frith Litchford"
"Cold Gil Cogdill"
"Cold Ira Dicarlo" []
"Cold Isa Salcido"
"Cold Liar Cardillo" []
"Cold Loris Odriscoll"
"Cold Man Calm Don"
"Cold Manda Macdonald"
"Cold Ola Collado"
"Cold Rae Decarlo" []
"Cold Rena Calderon" []
"Cold Renae Calderone" []
"Cold Roni Coldiron" []
"Cold Stan Scotland"
"Cold Su Duclos"
"Cold Sweat Scot Ewald"
"Cold Thea Deloatch" []
"Collared Cardello" []
"Colonel Loco Len"
"Colonel Lon Cole"
"Color-Blind [if player is male]Bill Cordon[else]Doll Corbin[end if]"
"Comatose Ace Smoot"
"Comfortable Boor Metcalf"
"Complex Mel P. Cox"
"Con Abi Bianco" []
"Con Art Carton" []
"Con Rat Cantor" []
"Conner 'Ski' Nickerson"
"Consmith McIntosh" []
"Consort Croston" []
"Consumer Scum Oren"
"Content Connett"
"Control Clot Ron"
"Contuses Countess Su Tecson"
"Cool Bro Loco Rob"
"Cool Cat Al Tocco"
"Cool Kid Dick Loo" []
"Cop-Shy Psycho Posh Cy"
"Coppery Cy Poper"
"Cougher Goucher"
"Cougher Reg Chou" []
"Coughin['] Gino Chu"
"Count Arvilla Vaillancourt"
"Count Berta Betancourt"
"Count Cain Antonucci"
"Count Erica Tucciarone"
"Count Hagman Macnaughton"
"Count Hersh Hutcherson"
"Count Maren Counterman"
"Count Myrna Countryman"
"Count Olano Colantuono"
"Count Rey Courtney"
"Count Sol Coulston"
"Counterfeiter Cerrito Fuente"
"Covered [if player is male]Doc Reve[else]Eve Cord[end if]"
"Coveter Eve Cort"
"Cowardly Waldo Cyr" []
"Cowlick Wilcock"
"Coy Fred Fordyce" []
"Coy Len Conley"
"Coy Leo Cooley"
"Coy Mona Moncayo"
"Coy Nat Cayton"
"Coy Noe Cooney" []
"Coy Ron Conroy" []
"Coy Su Soucy"
"Coy Vern Convery"
"Crafty Cat Fry"
"Craven-Hope Copenhaver"
"Crawler Lew Carr"
"Crazy Bo Czybora"
"Creator Cerrato" []
"Creep Lila Pierceall"
"Creep Roni Perricone"
"Creep Sal Placeres"
"Creep Tran Carpenter"
"Creep Trina Carpentier" []
"Creep Von Provence"
"Criminal Marci Lin" []
"Cristi 'Nah' Christian" []
"Crook Rocko"
"Crooked Cop Dock Cooper"
"Crotchin['] Crichton"
"Cruel Al Cuellar" []
"Cruel Bash Laubscher"
"Cruel Bhat Buchalter" []
"Cruel Bo Curbelo"
"Cruel Diego Delguercio"
"Cruel Ed Crudele"
"Cruel Ena Laurence"
"Cruel Hoa Larouche"
"Cruel Laila Lauricella" []
"Cruel Li Cerulli"
"Cruel Lila Lucarelli"
"Cruel Milo Cullimore"
"Cruel Ol['] Cerullo"
"Cruel Phil Cullipher" []
"Cruel Seth Schlueter"
"Cruel Singh Luchsinger"
"Cruel Stahl Altschuler"
"Cruel Thoma Crouthamel" []
"Cruel Toi Cloutier" []
"Crush-Less Schussler"
"Crush Tea Tauscher"
"Crusher Schruer"
"Crushing [if player is male]Rich Sung[else]Cris Hung[end if]" []
"Crusty Stu Cyr"
"Curb Kid Burdick"
"Cure-All Cruella LaLucre" []
"Cutesie Eustice"
"Czar Aisha Zacharias"
"Czar Alba Balcazar"
"Czar Asia Zacarias"
"Czar Blake Balcerzak"
"Czar Cora Carrazco"
"Czar Em Marzec"
"Czar Kay Zackary"
"Czar Noe Zarcone"
"Czar Oda Cardoza"
"Czar Racz" []
"Czar Rana Carranza"
"Czar Riva Vizcarra"
"Czar Rosia Carrizosa"
"Czar Tora Cortazar"
"Czar Zora Carrozza"
"Da Fool Adolfo" []
"Dachsund-Duds Chan"
"Daimonic Dominica"
"Dale 'Gun' Gaulden"
"Dale-Dog Delgado"
"Damner Erdman" []
"Dan 'Gun' Dungan"
"Dan 'Ranch' Chandran"
"Dan 'Ski' Adkins"
"Dan 'Sneer' Andersen-Andresen"
"Dana 'Gun' Dunagan"
"Dander Denard" []
"Dang Rube Bared-Gun Brundage" []
"Danna 'Gun' Dunnagan"
"Dante 'Legs' Engelstad"
"Dapper Ed Rapp-Pepard" []
"Dara 'Legs' Ragsdale"
"Dario 'Gun' Guardino"
"Dark Bales Barksdale"
"Dark Beech Hardebeck"
"Dark Burch Burckhard"
"Dark-Cap Packard"
"Dark Che Heckard"
"Dark Coy Ackroyd" []
"Dark Fedor Drakeford" []
"Dark Ice Radecki" []
"Dark Ines Iskander" []
"Dark Len Kandler"
"Dark Leo Oldaker" []
"Dark Leon Kolander" []
"Dark-Lie Kildare"
"Dark Link Kirkland" []
"Dark Lins Slinkard"
"Dark Maree Rademaker" []
"Dark Mean Adam Kern"
"Dark Mince Dickerman" []
"Dark Nat Tankard"
"Dark Neeson Skenandore" []
"Dark-Nest Ekstrand"
"Dark Red Dr. Drake"
"Dark Rich Hardrick"
"Dark-Room-Odor Mark"
"Dark Sam Kadrmas"
"Dark Scot Stockard" []
"Dark Sven-O Vondrasek" []
"Dark Swain Radwanski"
"Dark-Way Kay Ward"
"Darn-Low Waldron" []
"Data Driven [if player is male]Davie Arndt[else]Vita Darden[end if]"
"Daunting Tina Gund"
"Dauntless Stan LeSud" []
"Dawn 'Ski' Dawkins"
"Day Rube Beaudry" []
"Dead Cat Tad Cade"
"Dead End Ned Dade"
"Deadline-Dealin['] Ed"
"Deadly Deal Dy"
"Deadly Del Day" []
"Deadly Ed Daly" []
"Deaf Lin Findale-Delfina" []
"Deafer Feared Freeda"
"Dealin['] Ned Ali" []
"Dealing Ida Glen" []
"Dean 'Gun' Dunegan"
"Dean 'Ski' Deakins"
"Death Row Drew Otha" []
"Debbie 'Ranch' Breidenbach"
"Debonair [if player is male]Ira Boden[else]Robin Ade[end if]" []
"Deborah 'Gun' Rodenbaugh"
"Debra 'Gun' Brundage"
"Decatur Rude Cat" []
"Decayed Ace Eddy"
"Decorated Ector Dade"
"Decoyer Cory Dee"
"Decried Decider Cid Reed"
"Dee 'Drawl' Delawder"
"Dee 'Gun' Dungee"
"Dee 'Nah' Headen"
"Dee 'Specs' Cespedes"
"Deep Jon Pendejo"
"Deferrer Ferderer"
"Defiling Fielding"
"Del 'Gun' Gulden"
"Del 'Nah' Handel-Dahlen"
"Del 'Ranch' Chandler" []
"Delaware Earl Wade" []
"Delayer Eardley"
"Dell 'Nah' Helland"
"Delma 'Nah' Haldeman" []
"Demandin['] Ned Minda"
"Demanding Dan Deming"
"Demoter Tom Reed" []
"Demotist Modesitt"
"Denis 'Frat' Standifer" []
"Denis 'Gun' Duensing"
"Depleter Delprete"
"Depraved Pa Vedder"
"Deranged Dreg Dean"
"Deranged Ned Edgar" []
"Derriere Riederer"
"Destroyer Rory Steed" []
"Deviance Vice-Dean Nice Dave" []
"Deviser DeVries" []
"Dexterous Tex Souder"
"Diane 'Legs' Deangelis"
"Diann 'Gun' Dunnigan"
"Dickhead Addi Heck" []
"Dim-Bore Dire-Mob Mr. Dobie" []
"Dim Bulb Mild Bub"
"Dim-Ruck Mudrick"
"Dim Snug Sigmund"
"Dina 'Gun' Dunigan"
"Dion 'Gun' Guindon"
"Dire Tat Attired Ed Raitt"
"Dire Tot Detroit Ted Tiro"
"Dirty Slob Sid Rybolt"
"Diseased Sid Saeed"
"Dishonest [if player is male]Host Denis[else]Tish Edson[end if]" []
"Disowned [if player is male]Sidd Owen[else]Ines Dowd[end if]" []
"Do-[']Em-Mo['] Ed"
"Do-Rag Drago"
"Do-So-NOW Woodson"
"Dodger God Red"
"Dog-Breath [if player is male]Bart Hodge[else]Beth Drago[end if]"
"Doing-OW Goodwin-Wooding" []
"Doltish Sid Holt" []
"Dolty Dy Olt"
"Domo Arn Morando" []
"Domo Bettis Sidebottom"
"Domo Chung Mcdonough"
"Domo Cindie Didomenico"
"Domo Cline Delmonico"
"Domo Eryn Donmoyer" []
"Domo Gage Goodgame" []
"Domo Howe Homewood"
"Domo Huron Omohundro"
"Domo Lance Delmonaco" []
"Domo Leifer Moorefield" []
"Domo Nell Mondello"
"Domo Pace Deocampo"
"Domo Raina Mooradian"
"Domo Ranae Enamorado"
"Domo Raval Almodovar"
"Domo Ren Ormonde"
"Domo Rina Raimondo"
"Domo Rowe Woodrome"
"Domo Shaw Woodhams"
"Don 'Sneer' Enderson"
"Don Abram Boardman"
"Don Al Dolan" []
"Don Alisa Saladino" []
"Don Amy Monday" []
"Don Avis Davison" []
"Don Berna Darbonne" []
"Don Berrian Bernardino" []
"Don Cara Cardona"
"Don Carlee Calderone" []
"Don Clare Calderon" []
"Don Deb Bodden" []
"Don Drema Dearmond"
"Don Earl Leonard" []
"Don Early Reynaldo" []
"Don Ella Lalonde" []
"Don Elsa Adelson" []
"Don Else Edelson"
"Don Erma Medrano-Dameron" []
"Don Eura Rondeau" []
"Don Fern Fondren"
"Don Gail Galindo" []
"Don Gale D'Angelo" []
"Don Gena Donegan" []
"Don Geri Doering" []
"Don Gia Godina"
"Don Ian Andino"
"Don Ines Denison"
"Don Ira Ardoin" []
"Don Larisa Rosalinda" []
"Don Lea Delano" []
"Don Lee Deleon" []
"Don Leia O'Daniel" []
"Don Leif Delfino" []
"Don Les Seldon"
"Don Lili Dillion" []
"Don Lora Orlando" []
"Don Lue Louden"
"Don Macie Domenica" []
"Don Maia Damiano"
"Don Maile Mendiola" []
"Don Mara Armando" []
"Don Mary Raymond" []
"Don Mel Molden-Lemond" []
"Don Mia Amidon" []
"Don Micki Dominick"
"Don Miss Simonds" []
"Don Morgan Mondragon"
"Don Ola Doolan"
"Don Phil Dolphin"
"Don Ralph Randolph" []
"Don Regena DeGennaro" []
"Don Rena Nardone" []
"Don Rey Rodney" []
"Don Rose Rosendo" []
"Don Sal Ladson"
"Don Sam Madson" []
"Don Selina Danielson" []
"Don Shala Lashonda"
"Don Shari Hardison" []
"Don Sima Madison" []
"Don Somer Rosemond"
"Don Tia Donati" []
"Don Tisa DiSanto" []
"Don Tonia Dantonio" []
"Don Trena Anderton" []
"Don Tula Outland" []
"Don Tyra Drayton" []
"Don Vella Loveland" []
"Don Verna VanDoren" []
"Don Waldo Woodland" []
"Don Yael Yolande" []
"Don't-Care [d-t] Crean" []
"Don't-Care Ed Cantor" []
"Don't-Fly Tod Flyn"
"Dona 'Ski' Adkison"
"Done-By Bony Ed Dobney" []
"Done-Deal [if player is male]Eldon Ade[else]Lea Odden[end if]"
"Done-Job JD Boone"
"Donna 'Ski' Adkinson"
"Doom Rep Perdomo"
"Doom-Way Maywood"
"Doomer Rod Moe"
"Dooming Domingo" []
"Doorman Don Mora" []
"Dora 'Gun' Durango"
"Dorie 'Gun' Gourdine"
"Dorine 'Legs' Delsignore"
"Doris 'Nah' Hardison" []
"Doris 'Ranch' Richardson" []
"Doser-So-Red Erdos"
"Double-Talk [if player is male]Odell Kubat[else]Bella Dutko[end if]"
"Douchebag Doug Beach" []
"Dour [n-t] Tondreau" []
"Dour Abe Bordeau" []
"Dour Ali DiLauro"
"Dour Beau Boudreau"
"Dour Erin Ridenour" []
"Dour Gina Guardino"
"Dour Jan Jourdan" []
"Dour Mae DeMauro" []
"Dour Mel Moulder"
"Dour Shantel Southerland" []
"Dour Sol Losurdo"
"Dourest Stouder" []
"Doxin['] Dixon" []
"Dr. Low-World"
"Dr. Sasha Hard[a-word]"
"Drab Alissa Baldassari"
"Drab Ana Rabadan"
"Drab Berry Bradberry" []
"Drab Chester Badertscher"
"Drab Dorine DiBernardo"
"Drab Ed Bedard"
"Drab Ella Beardall" []
"Drab Elsa Balderas"
"Drab Elsy Bardsley" []
"Drab Elyse Beardsley" []
"Drab Erin Bernardi"
"Drab Eryn Bernardy" []
"Drab Fidel Bradfield"
"Drab Glen Bergland-Landberg"
"Drab Lee Baldree" []
"Drab Leif Barfield" []
"Drab Len Breland" []
"Drab Leo Laborde" []
"Drab Leon Bolander" []
"Drab Ligia Garibaldi"
"Drab Link Birkland"
"Drab Liz Blizard"
"Drab Lon Borland" []
"Drab Lora Labrador"
"Drab Lorene Oberlander" []
"Drab Loy Bolyard" []
"Drab Lyn Lybrand"
"Drab Marie Arrambide"
"Drab Milo Lombardi" []
"Drab Ming Bridgman"
"Drab Mona Boardman" []
"Drab Munger Bumgardner" []
"Drab Nigel Baldinger"
"Drab Noe Broaden" []
"Drab Ola Labrado"
"Drab Oren Bernardo" []
"Drab Rae Barreda"
"Drab Rhee Eberhard" []
"Drab Rina Brainard"
"Drab Ronnie Bernardino" []
"Drab Ros Robards"
"Drab Rose Debarros"
"Drab Ross Brossard"
"Drab Ruby Bradbury" []
"Drab Russo Broussard"
"Drab Sara Barradas"
"Drab Sean Banderas" []
"Drab Seth Bethards" []
"Drab Una Brandau" []
"Dragon Gordan Dorgan" []
"Drainer Darrien Radnier"
"Drawin['] Darwin" []
"Drawl Teel Treadwell-Treadwell"
"Drawl Ung Grunwald"
"Drawling Ringwald" []
"Dreaded Red Dade"
"Dreadful Dude Ralf" []
"Dreary Red Ray" []
"Dreisbach Bedchairs"
"Drinking Dirk Ginn"
"Droessler Solderers"
"Droner Dorner"
"Drongo Gordon"
"Drooling [if player is male]Lord Gino[else]Nori Gold[end if]"
"Drooly Old Roy"
"Droopiest Depositor Pedro Tsoi"
"Drowsin['] Windsor" []
"Dry-Lie Ridley" []
"Drysdale Saddlery"
"Dude Earl Delauder" []
"Duel Ref Ulf Reed" []
"Duke Bo Doubek"
"Duke Len Dunklee"
"Dull Rep Prudell"
"Duller Rudell"
"Dumb Carlen Cumberland"
"Dumb-Dumb M-Dub"
"Dumb Esta Bumstead"
"Dumb Garner Bumgardner" []
"Dumb Ira Rimbaud"
"Dumb Linnea Lindenbaum"
"Dumb Malena Mandelbaum"
"Dumb Noreen Demonbreun"
"Dumb Olga Goldbaum"
"Dumb Rees Bermudes"
"Dunce Rolf Lunceford"
"Dung-Bear Brundage" []
"Dyed Eddy"
"E-Z Rep Perez"
"Eagle Algee"
"Earthliest Stealthier [if player is male]Elias Rhett[else]Retta Hiles[end if]"
"Earthly Hartley"
"Earwig Gawrie" []
"Easy-Ayes Seya Seay"
"Easy-Life Elise Fay"
"Eat-Most Tom East" []
"Eatsy Yates" []
"Ed 'Hands' Shadden"
"Ed 'Legs' Sledge"
"Ed 'Nah' Haden"
"Ed 'Ranch' Chenard"
"Ed 'Ski' Dikes"
"Ed 'Sneer' Resende" []
"Edenic Denice"
"Education-Cautioned [i-n] Doucet"
"Edwin 'Sneer' Neiswender"
"Eevil Elvie"
"Effing Giffen"
"Egg-Farts Ferg Gast"
"Eight-Toes Theo Geist"
"Elder Baron Oberlander"
"Elderly Red Lyle"
"Eldon 'Fib' Bonfield"
"Elegant Lee Tang" []
"Elene 'Fib' Benefiel"
"Eli 'Frat' Telfair" []
"Eli 'Plod' Leipold"
"Eli 'Ski' Kisiel"
"Elim-Emil" []
"Elk Grove Keg Lover Reg Volek"
"Elli 'Gun' Guillen"
"Elmo 'Fang' Fogleman" []
"Elmo 'Nah' Holeman" []
"Elsa 'Gun' Lagunes"
"Elza 'Ski' Zaleski"
"Em 'Ranch' Merchan"
"Em 'Ski' Simek"
"Emil 'Nah' Heilman-Hileman" []
"Ena 'Ski' Eakins"
"Enactor Cantero" []
"Enclaved Nev Cadel"
"End-All Lad Len"
"End-All Leland" []
"Endorser Renderos"
"Endowed Don Weed"
"Engaged Ed Gagne" []
"Engaged-Gang Dee" []
"Engaoled DeAngelo" []
"Engel 'Ski' Keesling"
"Engirded Eddinger"
"Engrosser Roger Ness"
"Enigma Geiman"
"Enigmatic Macie Ting"
"Enos 'Drawl' Rosenwald" []
"Ensilaged DeAngelis" []
"Ensnared Andersen" []
"Ephemerist Peter Sheim"
"Erica 'Legs' Gilcrease"
"Erin 'Frat' Ferranti" []
"Erin 'Legs' Eslinger"
"Erlking Klinger" []
"Erma 'Legs' Elgersma"
"Ernie 'Legs' Seelinger"
"Ernie 'Ranch' Nachreiner"
"Errant Terran Ratner" []
"Erratic Art Rice" []
"Etta 'Gun' Tungate"
"Eva 'Legs' Selvage"
"Evader [if player is male]Dav Ree[else]Eve Ard[end if]" []
"Evaders-Adverse Deavers" []
"Evan 'Drawl' Vanderwal"
"Even Al Laneve"
"Even Alda Vandaele"
"Even Cesar Severance"
"Even Clara Carnevale"
"Even Coy Coveney"
"Even Gail Levangie"
"Even Galina Evangelina"
"Even Genial Evangeline"
"Even Gina Angevine"
"Even Hal Vanheel"
"Even Iris Severini"
"Even Karol Vanroekel"
"Even Kay Keaveny"
"Even Kaye Keaveney"
"Even Lita Valiente"
"Even Ngan Vanengen"
"Even Rhea Heavener"
"Even Rod Verdone"
"Even Ross Severson"
"Even Sal Leavens"
"Even Shona Vanhoesen"
"Even Sona Eavenson"
"Even Star Veenstra"
"Even Tara Navarete"
"Even Tarra Navarrete"
"Even Trula Laventure"
"Even Verda Vandeveer"
"Even Will Newville"
"Even Zonia Veneziano"
"Evia 'Gun' Vigneau"
"Evil [n-t] Valiente" []
"Evil Aaron Valeriano" []
"Evil Ada Deavila" []
"Evil Al Vallie" []
"Evil Alba Bellavia"
"Evil Alla Lavallie"
"Evil Anton Valentino" []
"Evil Beau Beliveau" []
"Evil Beula Belliveau" []
"Evil Butler Tuberville"
"Evil Cara Cavalier" []
"Evil Carl Carville"
"Evil Cher Leverich"
"Evil Ciara Cavalieri"
"Evil Dan Ledvina" []
"Evil Dara Delariva" []
"Evil Del Deville"
"Evil Earl Valliere" []
"Evil-Eyes [if player is male]Elvis Yee[else]Ivy Leese[end if]"
"Evil Gaunt Vigneault"
"Evil Gena Levangie"
"Evil Gino Viglione"
"Evil Larson Villasenor" []
"Evil Len Neville"
"Evil Les Seville"
"Evil Lon Novelli-Veillon"
"Evil Lori Riviello" []
"Evil Man Vain Mel"
"Evil Mayer Vermilyea"
"Evil Milan Mainville"
"Evil Nola Avellino"
"Evil Ona Avelino"
"Evil Rae Larivee" []
"Evil Reader Laverdiere"
"Evil Regan Graveline"
"Evil Rios Silverio" []
"Evil Risa Silveira"
"Evil Ro Oliver" []
"Evil Rob Boliver" []
"Evil Rosa Olivares" []
"Evil Russ Versluis"
"Evil Sagan Gavilanes" []
"Evil Sal Sevilla" []
"Evil Sir Silveri"
"Evil Sloan Sevillano" []
"Evil Sona Lievanos"
"Evil Tarra Valtierra" []
"Evil Tona Violante" []
"Evil Tora Voltaire" []
"Evil Zora Olivarez" []
"Eviller Reville"
"Ex-F-Word Drew Fox-Wexford"
"Excitable Tex Bacile"
"Excited Dex Tice"
"Excluder Rex LeDuc"
"Exonerated Tex DeRoane" []
"Expelled Lex Epdel"
"Extra Fine Neat Fixer Tex Efrain"
"Fadlier Def Liar Elfrida" []
"Faining Finigan"
"Fake-Gold Alf Godek" []
"Fake-Grin Rage-Fink Keri Fang" []
"Fake Lin Finklea"
"Fake Nice [if player is male]Ace Finke[else]Ena Feick[end if]"
"Fake Rico Kiracofe" []
"Fakes-Nice Ken Scaife"
"Faltering Taflinger"
"Fang Lord Langford" []
"Fanlike Fink Lea" []
"Far-Crowd Crawford"
"Far-Land Randalf"
"Fashionable [if player is male]Blaine Shoaf[else]Fiona Shelba[end if]"
"Fashionable [if player is male]Fabian Lohse[else]Felisa Hoban[end if]" []
"Fast Dione Distefano"
"Fast Dorn Stanford" []
"Fast Eiler Saterfiel"
"Fast Fats"
"Fast-Lane [if player is male]Stan Leaf[else]Tana Self[end if]"
"Fast Linde Stanfield" []
"Fast Loose Fleta Osso"
"Fast Lore Laforest"
"Fast Lugo Falgoust" []
"Fast Ol['] [if player is male]Alf Tso[else]Flo Ast[end if]"
"Fast Rhee Feathers" []
"Fast Talker Atlas Kreft"
"Fat Amos Mostafa"
"Fat Boor Barfoot" []
"Fat Clem Metcalf" []
"Fat Desire DeFreitas" []
"Fat Edison DiStefano" []
"Fat Ellinger Lingafelter" []
"Fat Enos Stefano" []
"Fat Hilde Hatfield" []
"Fat Ines Stefani" []
"Fat Len Flaten"
"Fat Lise Fleitas" []
"Fat Lola Tafolla"
"Fat Lon Lafont"
"Fat Omer Frometa"
"Fat Rose Foresta" []
"Fat Schindel Stanchfield"
"Fat Sherlene Ashenfelter"
"Fat Su Faust"
"Fat Tyler Flattery" []
"Fat Weidler Waterfield" []
"Faulty Ulf Tay"
"Fay 'Gun' Fanguy"
"Fear-Fare Rafe Efra"
"Feared Wilt Waterfield" []
"Fearful Lauffer"
"Fed-Coal DeFalco" []
"Fed Mr. Fremd"
"Federal Elfreda" []
"Feebler Lefebre" []
"Feistier Seiferti" []
"Felon Anita Lafontaine"
"Felon Cari Fernicola" []
"Felon Edris Rosenfield" []
"Felon Ethan Altenhofen"
"Felon Les Ellefson"
"Felon Mac Flamenco"
"Felon Odis Ildefonso" []
"Felon Rico Florencio" []
"Felon Rod Florendo" []
"Felonious [if player is male]Louie Fons[else]Foolin['] Sue[end if]"
"Fencer Ferenc"
"Fend-Rash Fred Nash" []
"Fetichist Fischetti"
"Fibs Cho Bischof"
"Fiends-Ilk Sinkfield"
"Fierce Recife"
"Fighter Egfirth" []
"Filed-Skin Sinkfield" []
"Financier [if player is male]Eric Finan[else]Ciera Finn[end if]"
"Findable Banfield" []
"Fines-Toad DiStefano" []
"Finisher Erin Fish"
"Fish Breath [if player is male]Bashir Heft[else]Sheba Firth[end if]"
"Five-Foot Vito Eoff"
"Fixater Tex Fair"
"Flashy Shy Alf" []
"Flat-Sneer [if player is male]Ernst Leaf[else]Erna Felts[end if]" []
"Flayin['] Finlay" []
"Flicker Elfrick"
"Flicking Gil Finck"
"Fling-[']Em Fleming"
"Flower Fowler"
"Foamy Mo Fay"
"Fondling Finngold"
"Force-Laugh Flo Gaucher"
"Forced-Laugh [if player is male]Gerald Fouch[else]Freda Clough[end if]"
"Forceful Cleo Ruff" []
"Ford 'Frat' Trafford"
"Forgin['] Grifon" []
"Formidable Abe Milford"
"Foul-Breath [if player is male]Hobert Lauf[else]Ruthe Falbo[end if]"
"Fouler Ulf Roe"
"Foulest-Toes Ulf"
"Fox Drew Wexford"
"Fox Red Exford"
"Fragile Eli Graf"
"Fran 'Fib' Braniff"
"Fraud Bennie Bauernfeind"
"Fraudulent Ren DuFault"
"Free-Lunch [if player is male]Luc Hefner[else]Lue French[end if]"
"Fricker Ferrick"
"Fridge Ferdig"
"Fried-Calf Radcliffe"
"Frightful Riff Gluth"
"Friller Ferrill"
"From-Bad Bamford"
"Front-Teeth Trent Hoeft"
"Frowner Renfrow"
"Fryer Ferry"
"Full Eric Cullifer"
"Full Inge Fuelling"
"Full Rae Lafleur"
"Full Roe Ferullo"
"Futzer Freutz"
"Gafflin['] Naff Gil"
"Gaming Gig-Man M. Giang"
"Gang Leader Delagrange" []
"Gangster Greg Nast" []
"Ganka Kagan"
"Ganker [if player is male]Reg Kan[else]Kera Ng[end if]"
"Garcon Corgan"
"Garlicky Ray Glick"
"Gassy Eli Yglesias"
"Gaudy DuGay"
"Gaunt Ali Lantigua"
"Gaunt Amber Baumgarten" []
"Gaunt Delia Daigneault"
"Gaunt Edris Staudinger" []
"Gaunt Levi Vigneault" []
"Gaunt Lida Daignault" []
"Gaunt Mila Manigault" []
"Gaunt Moe Montague" []
"Gay Lord Ray Gold"
"Gazer Zager"
"Geathers the Sarge" []
"Gene 'Drawl' Greenwald" []
"Generous [if player is male]Gene Urso[else]Sue Groen[end if]"
"Genial-Linage Angeli" []
"Get-Hard Ed Garth"
"Ghastly Lysaght" []
"Ghostly Syg Holt" []
"Giggler Greg Gil"
"Gigi 'Sneer' Geisinger"
"Gil 'Sneer' Eslinger-Selinger"
"Gill 'Sneer' Sellinger"
"Gingerly-Lying Reg"
"Glarin['] Al Ring"
"Glen 'Ski' Kesling"
"Glib Gil B"
"Glib Loner Bollinger"
"Glib Nerd Lindberg"
"Glib Ol['] Bill 'Go Big' Oll" [p]
"Glitziest Stieglitz"
"Glum Bold Goldblum"
"Glutton Tut Long"
"Gnawer Wagner" []
"Gob-is-So-Big Boss Gigi-Bo" []
"Gobbler Bloberg"
"Goblin Boling"
"Godfather Gofer Thad" []
"Goin[']-Igno['] Gino"
"Goin[']-Mod Domingo" []
"Going-Aces Gascoigne"
"Golda 'Nah' Hoagland" []
"Golden God Len DeLong" []
"Golfer Nut Flo Gunter"
"Goner Goren Rogen" []
"Goober Bo Gore"
"Good-Munch Mcdonough" []
"Goon Amina Manoogian"
"Goon Ed Gooden"
"Goon Hans Hoganson"
"Goon Laci Cogliano" []
"Goon Leif Fenoglio" []
"Goon Lin Longino" []
"Goon Lu Luongo"
"Goon Melton Montelongo"
"Goon Meri Geronimo" []
"Goon Robin Bongiorno" []
"Goon Rubi Bourgoin"
"Goon Ruth Roughton"
"Goon Tisa Agostino"
"Goon Vi Govoni"
"Goons-Pal Spagnolo"
"Gorgeous Grouse Og" []
"Gorgeous Ogg Rouse"
"Gorgon Ron Ogg"
"Gorilla Garillo"
"Gormless Gross Mel"
"Gory Al Gaylor"
"Gory Dan Graydon" []
"Gory Fed Godfrey"
"Gory Kena Kornegay" []
"Gory Ula Gourlay"
"Gouger Ogg Ure"
"Gourmand Mug Doran" []
"Grab-is-OK Bograkis" []
"Gracious Guarisco" []
"Gramma Magram"
"Grand Al Garland-Ragland" []
"Grand Berry Grandberry"
"Grand Bo Bragdon"
"Grand Burt Brungardt"
"Grand Ethel Engelhardt"
"Grand-Evil Vanglider" []
"Grand Flo Langford" []
"Grand Ione Digennaro" []
"Grand Levi Vangilder" []
"Grand Li Darling" []
"Grand Moon Mondragon" []
"Grand Peters Prendergast-Pendergrast" []
"Grand Rosen Granderson" []
"Grannie Nearing" []
"Gray-Areas Sara Geary"
"Great Lord Art Gerold"
"Greebo Boeger"
"Greed-Orgy Ed Gregory" []
"Green Belt Engelbert"
"Green Bull Ellenburg"
"Green Cad Ned Grace"
"Green Rube Neuberger-Berenguer"
"Green Sick Seckinger"
"Greenwich [if player is male]Rich Egnew[else]Cher Ewing[end if]"
"Greg 'Sneer' Gregersen"
"Grey Lee Greeley"
"Gridlock Rick Gold"
"Grif the Fighter" []
"Groom[if player is male]-Mo-Org Mr[else]s-Mo-Orgs Mrs[end if]. Goo"
"Groovy Gov Roy"
"Groper Peg Orr" []
"Gropin['] Pig Ron"
"Gross Olin Rossignol"
"Grovelin[']-Lovin['] Reg"
"Grunt-O Truong"
"Grunty Ty Rung"
"Gum Chewer Hue McGrew"
"Gun Lover Vern Lugo"
"Gung Ho Hun Ogg"
"Gus the Hugest"
"Guvsta Gustav"
"Guy 'Sneer' Guernsey"
"Habitue Thibeau"
"Hack 'Fibs' Fishback"
"Hack-Jobs Jack Bosh"
"Haggler Greg Ahl"
"Hair-Legs Grealish"
"Hairless [if player is male]Hal Reiss[else]Lisa Sher[end if]"
"Hairy Amos Yamashiro"
"Hal 'Gun' Hulgan"
"Hal 'Ski' Kalish"
"Hale-Snort Rosenthal" []
"Ham 'Gun' Ghuman"
"Ham 'Ski' Khamis"
"Ham 'Sneer' Ehresman"
"Hana 'Ski' Kashani"
"Handsier Sir Haden Sheridan" []
"Handsome Sham Deon" []
"Hane 'Legs' Glasheen"
"Hans 'Ski' Haskins"
"Hard Cris Richards"
"Hard Em Dahmer-Derham"
"Hard Len Handler" []
"Hard-Line Land Heir [if player is male]Hal Riden[else]Erin Dahl[end if]" []
"Hard-Sell Rash Dell"
"Hardened [if player is male]Ned Hader[else]Dede Rahn[end if]"
"Hardened [if player is male]Reed Hand[else]Edda Hern[end if]" []
"Hardline Herlinda Lenhardi" []
"Hardman Dr. Mahan" []
"Harelip Phailer Ralphie"
"Harm Ace Amacher"
"Harm-Nut Thurman" []
"Harmed Dahmer" []
"Harming Ingrahm"
"Harsh Tia Siharath"
"Hasty Maia Yamashita"
"Hasty Pen Stephany"
"Hasty Red Hardesty"
"Hasty Ty Ash" []
"Hasty Weber Weathersby"
"Hate-Aged Hag Deeta" []
"Hated Flo Oftedahl"
"Hated Guy Daughety"
"Hated Lon Odenthal" []
"Hated Nyla Delahanty"
"Hated Ol['] Rowe Leatherwood" []
"Hated Rolf Oldfather"
"Hated Sal Halstead" []
"Hated Sam Steadham"
"Hated Slim Delashmit" []
"Hated Su Hustead"
"Hats Dude Thaddeus"
"Hattie 'Burp' Breithaupt"
"Hauter Huerta"
"Hayseed Ed Hayes"
"Head Gamer Dee Graham"
"Headcase Shea Cade"
"Headier Heredia" []
"Heartless Sal Tesher"
"Heavy Smoker Vy Shoemaker"
"Heckling Hick Glen"
"Hectoring Creighton" []
"Hee 'Ski' Heikes"
"Hegemon [if player is male]Moe Engh[else]Meg Hoen[end if]"
"Heinous Ines Hou" []
"Held-Back [if player is male]Chad Belk[else]Deb Chalk[end if]"
"Hell-Bound Eldon Buhl"
"Hell-No Len Ohl" []
"Hellion Leo Linh" []
"Henlike Heinkel"
"Herbalist Trish Bale" []
"Herder Dreher"
"Heretic Eichert" []
"Hermetic Mitch Ree"
"Herr Abe Haberer"
"Herr Al Harrel"
"Herr Billy Berryhill"
"Herr Ed Dreher" []
"Herr Ira Harrier"
"Herr Nick Kirchner"
"Herr Pat Prather"
"Herr Rico Corriher"
"Herr Scot Crothers"
"Herr Seth Thresher"
"Herr Sid Shrider"
"Herr Tad Erhardt"
"Herr Ty Ryther"
"Hi-Beer Herbie"
"Hi-Class Sal Isch"
"Hilda 'Legs' Dalgleish"
"Hilde 'Frat' Hartfield"
"Hip Sly Phylis"
"Hirsute Rush Eit"
"Hitman Tim Han" []
"Hoardy Rod Hay"
"Hoboken Ben Hook"
"Hog Luc Clough"
"Holli 'Gun' Loughlin"
"Hollie 'Hands' Hollinshead"
"Homeless Elmo Hess"
"Hong 'Ski' Hosking"
"Honker Hronek"
"Hooch and Ad Honcho Chad Hoon"
"Hooting Hit-Goon Hog [toti]"
"Horrible [if player is male]Rob Riehl[else]Rori Hleb[end if]"
"Hot-Brows Bosworth"
"Hot Ned the Don"
"Hot Ron Horton"
"Howitzer Zoe Wirth" []
"Howly Hy Low"
"Hoyden Doheny"
"Huckster [if player is male]Chet Rusk[else]Ruth Seck[end if]"
"Huckster Kutscher" []
"Huge Tony, the Young Honey-Gut" []
"Hulloing Loughlin" []
"Hummer Mr. Hume"
"Humorless Russ Holme"
"Hussy Shy Su"
"I-Be-Scum Buscemi"
"I-Stank Atkins" []
"Ian 'Gun' Guinan"
"Ian 'Legs' Gelinas-Sinegal"
"Ian 'Ski' Aikins"
"IANAL Alain" []
"Ice Kid Dickie"
"Iceberg Big Cree"
"Iced-Over Eric Dove" []
"Icer Eric Rice" []
"Icky Ed Dickey"
"Icy Man Nic May"
"Icy Norm McInroy"
"Ida 'Gun' Gaudin"
"IDIOTS Sidoti"
"Ignoble Gil Bone" []
"Ignoble Leo Bing" []
"Ignoramus [if player is male]Gus Marion[else]Ros Gumina[end if]"
"Ignoramus [if player is male]Mario Sung[else]Risa Mungo[end if]" []
"Ignorant Arington" []
"Ignorer Roering"
"Igor-All-Gorilla"
"Ill-Ache Ace Hill" []
"Ill Con Collin"
"Ill-Gagner Gallinger"
"Ill-Groan Granillo" []
"Ill-Head Delilah"
"Ill-Hunger Hullinger"
"Ill-Razor Zorrilla"
"Ill Rube Bullier Bill Ure"
"Immenser Rene Mims"
"Impatient Mina Petit"
"Imperial Palmieri" []
"Impure Don, Impounder"
"In-Dock Con Kid Dickon"
"In-Early Lani Rey"
"In-Force Ren Fico" []
"In-Jail Jilian"
"In-Style Ty Niles-Tinsley"
"In-Style Yeltsin" []
"Incensor Rincones"
"Inch-Chin Nic Hinch"
"Indulger [if player is male]Gil Ruden[else]Geri Lund[end if]"
"Inert-Bans Bannister" []
"Ines 'Frat' Stanifer" []
"Inflamed '[d-word-u] Life' Man Fidel" [p]
"Inger 'Legs' Gelsinger"
"Inhumane [if player is male]Huie Mann[else]Nina Hume[end if]"
"Injuro-Junior Jon Rui" []
"Innocent Tien Conn"
"Introvert Trot Ervin" []
"Invader Red Ivan"
"Invalid Vin Dial"
"Ira 'Gun' Guarin"
"Ira 'Hands' Sardinha"
"Ire-Fest Seifert" []
"Ireless Eissler"
"Irvin 'Legs' Siverling"
"Isa 'Gun' Suniga"
"Islander Dan Riles" []
"Islander Sindelar" []
"Isolater Lita Rose"
"Iva 'Gun' Gauvin"
"Iva 'Ranch' Chavarin"
"Ivana 'Legs' Gavilanes"
"Ivana 'Plod' Vialpando"
"Jackhole [if player is male]Joe Chalk[else]Jae Holck[end if]"
"Jalapeno [if player is male]Joe Alpan[else]Anja Opel[end if]" []
"Jara 'Legs' Grajales"
"Jareth the Raj"
"Jaywalker Jake Lawry"
"Jealous Joe Saul" []
"Jen-Dog DeJong" []
"Jere 'Gun' Juenger"
"Jerk Abe Jerabek"
"Jerk Bao Bajorek"
"Jerk Cai Jarecki"
"Jerk Wasik Krajewski"
"Jerkwad Jed Wark"
"Jigsaw-Jaw Sig"
"Jo 'Gun' Joung"
"Jo 'Hands' Dosanjh"
"Joan 'Ski' Janoski-Janosik"
"Jobless Jess Bol"
"John-Doe Jed Hoon"
"Jouster Joe Rust" []
"Jumbo Bum OJ"
"Jus-Nod Judson"
"Just-Bored Bud Trejos" []
"Just-Odd Judd Tso"
"Kara 'Ski' Karasik"
"Karan 'Fib' Fairbank"
"Karl C & Carl K Clark"
"Kera 'Gun' Graunke"
"Kestrel Sterkel"
"Key Czar Zackery"
"Kid Anson Adkinson" []
"Kid Arch Hardick"
"Kid Arn Kinard" []
"Kid Ash Kadish"
"Kid Barnes Bednarski"
"Kid Berna Bednarik" []
"Kid Bernal Birkeland" []
"Kid Briel Kilbride" []
"Kid Cain Kincaid" []
"Kid Carmen Dickerman" []
"Kid Carr Rickard" []
"Kid Cerro Roderick" []
"Kid Cher Hedrick" []
"Kid Cheree Heidecker"
"Kid Chet the [dick-u]" []
"Kid Cole Dolecki" []
"Kid Egnew Wedeking"
"Kid Elyn Kindley"
"Kid Ena Deakin"
"Kid Erich Heidrick" []
"Kid Fran Fradkin"
"Kid Gena Kaeding"
"Kid-Getter Kittredge"
"Kid Gunner Kundinger"
"Kid Hal Hladik" []
"Kid Hong Hodgkin" []
"Kid Inger Dierking" []
"Kid Kena Kinkead"
"Kid Kina Kinkaid" []
"Kid Larch Hrdlicka"
"Kid Lawson Landowski" []
"Kid Lee Keidel"
"Kid Len Elkind" []
"Kid Lyons Dolinsky" []
"Kid Mason Domanski" []
"Kid Mena Dikeman" []
"Kid Moni Dominik"
"Kid Nell Kindell"
"Kid Oslin Dolinski" []
"Kid Ramos Radomski" []
"Kid Rens Dirksen"
"Kid Rensch Hendricks"
"Kid Rheba Birkhead"
"Kid Rourke Ouderkirk"
"Kid Sean Deakins" []
"Kid Selina Danielski" []
"Kid Serna Iskander" []
"Kid Simon Dominski"
"Kid Sloan Nadolski"
"Kid Somer Skidmore"
"Kid Sona Adkison"
"Kid Stan Stadnik"
"Kid Sul Dulski"
"Kid Teresa Kierstead"
"Kid Theron Thorndike"
"Kid Trice Dietrick" []
"Kid Vanselow Levandowski"
"Kid Zane Dziekan"
"Kim 'Ranch' Kirchman"
"Kina 'Legs' Keasling"
"Kinder Kid Ren" []
"Kindly Old [if player is male]Lloyd Dink[else]Dolly Link[end if]"
"King Al Glinka"
"King Arnott Tarkington"
"King Boor Brooking"
"King Borges Konigsberg" []
"King Cal Glackin"
"King Corless Grossnickle"
"King Cortes Stockinger" []
"King Lee Keeling" []
"King Les Kesling"
"King Price Pickering" []
"King Rios Roginski"
"King Saul Klausing"
"King Scot Stocking"
"Kinglier Kreiling" []
"Knee-Jerk Jen Kerek"
"Knicker-Kick Ren"
"Knifey Finkey"
"Knived Kid Nev"
"Knocka Koncak"
"Knowing Nik Wong, King Now"
"KO-Sneer Ken Rose"
"Kory 'Nah' Hornyak"
"Kray Kyra"
"Kremlin Mr. Klein"
"Kris 'Nah' Harkins" []
"Kundinger Underking" []
"Kyra 'Ski' Krysiak"
"Labeled DeBella" []
"Labourer Lou Barre"
"Laconically Cynical Lola"
"Lad Bo, a Bold Bad Ol['] Baldo"
"Ladrone Renaldo" []
"Ladylike Alley Kid Ida Kelly"
"Lagered Regaled Arledge" []
"Lame Gil 'I'm Legal' Millage" []
"Lame Locust Muscatello" []
"Lame Loy O'Malley"
"Lame Pro Palermo" []
"Lame-Pry Parmley" []
"Lame Rebel Bellemare" []
"Laming Gilman" []
"Lan 'Ski' Alkins"
"Lan 'Zoo' Alonzo"
"Land Ace Candela"
"Landlord Droll Dan"
"Lang 'Zoo' Gonzalo"
"Lara 'Ski' Karalis"
"Larcenous Len Caruso" []
"Lardy Ben Brandley" []
"Large Don Glendora"
"Larksome Marsolek"
"Larson 'Zoo' Solorzano"
"Larue 'Legs' Arguelles"
"Lassoer Rosales" []
"Lastin['] Lantis" []
"Laughing Gil Huang"
"Laurence's Ceruleans"
"Lay 'Zoo' Lozoya"
"Lazy Bum Luz Byam"
"Le Bum Blume"
"Le Weird Drew, Lie Wielder" []
"Lea 'Gun' Naugle"
"Lea 'Ski' Lesiak"
"Lead-Fair Alfredia"
"Leader Ed Earl" []
"Leader Russi Deslauriers"
"Lean Cam MacNeal" []
"Lean Mo 'No Meal' Malone" [p] []
"Lean Neal Lane" []
"Lean Posh Alphonse" []
"Leanna's Anneals"
"Leathery Atherley" []
"Lee 'Hands' Haselden"
"Lee 'Ski' Kiesel-Lieske"
"Lee Smith the Slime"
"Leech El Che"
"Leer-Dish Shideler" []
"Legal Arch Gallacher"
"Legal Cari Callegari"
"Legal Dan Langdale"
"Legal Dann Langeland"
"Legal Erin Langelier"
"Legal Ira Allgaier"
"Legal Joi Jagiello"
"Legal Minna Manganelli"
"Legal Ned Delangel"
"Legal Olin Angelillo"
"Legal Omar Gallamore"
"Legal Redd Alldredge"
"Legal Ring Gallinger"
"Legal-Tat Galletta"
"Legal Winter Gillenwater"
"Legal Wren Ellwanger"
"Legs-Lech Schlegel"
"Lem 'Lots-to-Smell' Mostell" [p] []
"Len 'Ski' Elkins"
"Lenard 'Fib' Barnfield"
"Lenard 'Fibs' Bransfield"
"Leo 'Frat' Laforte"
"Leo 'Plod' Leopold"
"Leo 'Ski' Oleski"
"Leprous Sproule"
"Les 'Nah' Hansel" []
"Les 'Ski' Kissel"
"Less-Mean Esselman"
"Lesser Dr. Dressler"
"Lethal Now Lowenthal"
"Lethargic Chari Gelt" []
"Levan 'Drawl' Vanderwall"
"Level-Head [if player is male]Dave Helle[else]Delva Ehle[end if]"
"Leveler Revelle"
"Lew 'Drawl' Wardwell"
"Lew 'Nah' Whalen" []
"Lewd Ann Newland"
"Lewd Anson Lansdowne" []
"Lewd-Call Caldwell"
"Lewd Dirt Twiddler Wilt Redd"
"Lewd Fester Westerfeld"
"Lewd Lad Waddell"
"Lewd Osterman Westmoreland" []
"Lewd Seifert Westerfield"
"Lewd Ungar Gruenwald"
"Lewisham [if player is male]Emil Haws[else]Ami Welsh[end if]"
"Li'l Pig-Lip Gil"
"Liar [d-t] Altidor" []
"Liar Age Alegria" []
"Liar Alf Fairall"
"Liar Bee Belaire"
"Liar Bergen Linebarger"
"Liar Berta Baltierra"
"Liar Beth Thielbar"
"Liar Bo Bailor"
"Liar Boesch Charlebois"
"Liar Bogdon Longobardi" []
"Liar Branca Albarracin"
"Liar Cade Caldeira" []
"Liar Cal Arcilla" []
"Liar Candi Cardinali" []
"Liar Cher Charlier" []
"Liar Chloe Chiarello" []
"Liar Clem Marcelli"
"Liar Clemon Marcellino" []
"Liar Cloud Couillard" []
"Liar Cox Lacroix"
"Liar Dale Dallaire" []
"Liar Darcel Cardarelli"
"Liar Dave Delariva" []
"Liar Deacon Candelario" []
"Liar Del Laidler"
"Liar Deon Andreoli" []
"Liar Don Orlandi" []
"Liar Ed DeLira"
"Liar Edson Leonardis" []
"Liar Eldon Nardiello" []
"Liar Elmes Marseille" []
"Liar Elston Santorelli" []
"Liar Elvin Rainville" []
"Liar Engel Langelier" []
"Liar Eve Larivee" []
"Liar Gatta Tartaglia" []
"Liar Glen Allinger" []
"Liar Goon Longoria"
"Liar Hemp Lamphier" []
"Liar Huett Theriault"
"Liar Isobel Bellisario" []
"Liar Lad Radilla"
"Liar Lamas Amarillas" []
"Liar Lan Ranalli"
"Liar Lance Racanelli" []
"Liar Lea Allaire"
"Liar LeMon Romanelli" []
"Liar Len Rinella" []
"Liar Lester Serritella" []
"Liar Lev Averill" []
"Liar-Lovin['] Villarino" []
"Liar Mabel Mirabella" []
"Liar Mae Laramie" []
"Liar Moog Girolamo"
"Liar Ned Reiland" []
"Liar Oma Almario" []
"Liar Omer Larimore" []
"Liar Oren Lorraine" []
"Liar Patton Portalatin"
"Liar Paz Alpizar"
"Liar Rhett Ritthaler"
"Liar Romer Larrimore" []
"Liar Seibert Balestrieri"
"Liar Stegen Easterling" []
"Liar Stella Saltarelli"
"Liar Tavares Salvatierra"
"Liar Tess Lassiter" []
"Liar Tigue Gualtieri"
"Liar Tobin Bartolini"
"Liar Treva Valtierra" []
"Liar Trude Iturralde" []
"Liar Veeder Laverdiere" []
"Liar Vose Oliveras" []
"Liar-Weeny Earlywine" []
"Liar Yves Sylveira"
"Libeled Bill Dee"
"Libeler Bill Ree-Bleiler" []
"Libertine [if player is male]Bertie Lin[else]Britni Lee[end if]"
"Lida 'Gun' Gauldin"
"Lie-Mug Miguel" []
"Lifer Friel"
"Likable Ike Ball"
"Lilli 'Fang' Gilfillan"
"Limper Mr. Pile"
"Lin 'Nah' Hanlin"
"Lin 'Ski' Likins"
"Lin-Dogg Golding"
"Lina 'Fang' Flanigan" []
"Ling 'Ski' Glinski-Kisling"
"Linn 'Legs' Snelling"
"Lip-Ink Kip Lin"
"Lise 'Ski' Sielski"
"Listener [if player is male]Eli Ernst[else]Ester Lin[end if]"
"Literal Liar Tel" []
"Lither Hitter Hiller" []
"Litigous Sot Luigi"
"Litterbug [if player is male]Gilbert Tu[else]Britt Guel[end if]" []
"Little Bo Bellotti"
"Little Em Millette"
"Little Eve Veillette"
"Little Verne Netterville"
"Lo-Grade Real Dog Geraldo" []
"Lo-Tint Litton" []
"Loan Shark Noah Sklar"
"Loather Leo Rath" []
"Loathsome [if player is male]Hamlet[else]Thelma[end if] Soo"
"Loathsome [if player is male]Theo Lomas[else]Thea Olmos[end if]" []
"Lobsterman Lambertson" []
"Localist Castillo" []
"Lock Ace Leacock"
"Lodesman Smaldone" []
"Lois the Hostile" []
"Lola 'Ski' Kollias"
"Lon 'Legs' Gosnell"
"Lon 'Nah' Hanlon"
"Lon 'Sneer' Lorensen"
"Lone Ty Leyton-Yelton"
"Loner Loren Olner" []
"Loner Lorne Rolen" []
"Long-Fit Lofting" []
"Long-Mad Goldman"
"Long-Revels Snellgrove"
"Long Stan 'Not-Slang' Langston" [p]
"Loo 'Drawl' Woollard"
"Lore 'Hands' Rosendahl"
"Loree 'Fib' Belfiore" []
"Loren 'Ski' Sloniker"
"Lost Heir [if player is male]Eli Short[else]Teri Sohl[end if]" []
"Loud Ben Boulden" []
"Loud Berna Abdelnour" []
"Loud Bore Rod Boule" []
"Loud Clair Couillard" []
"Loud Ernst Osterlund" []
"Loud Gal Dougall"
"Loud Gehrig Loughridge"
"Loud Ira Dilauro" []
"Loud Laci Caudillo" []
"Loud Levi Douville"
"Loud Ma Dumlao"
"Loud Nat Daulton" []
"Loud Obert Trueblood"
"Loud Oscar Colasurdo"
"Loud Ros Losurdo" []
"Loud Shen Hudelson"
"Loud Short Shout Lord Dr. Lou Tosh"
"Loud Tresa Trousdale" []
"Loud Wolf Fullwood" []
"Louder Red Lou Olerud-DeRulo" []
"Loudest Stud Leo" []
"Lousy Sol Yu"
"Lovable Ol['] Belva" []
"Low-Born Ron Blow"
"Low-Class-Scowls Al"
"Low-End Don Lew" []
"Low Kid Kildow"
"Low Les Sowell" []
"Low Nat Walton" []
"Low Seb Bowles" []
"Low Stan Walston" []
"Low-Tax Ox Walt"
"Low Thinker Kenilworth"
"Lowballin['] Will Bolan"
"Loyalist Olly Tsai"
"Lu 'Ski' Sulik"
"Lucrative Victualer [if player is male]Avi Cutler[else]Lucia Vert[end if]" []
"Luk 'Sneer' Kluesner"
"Lumbering Bluminger"
"Lustre Luster Russell Ruett"
"Lute 'Nah' Henault"
"Lux-Money Molyneux"
"Lyn 'Ski' Lykins"
"Ma 'Ski' Miska"
"Mac 'Nah' Mancha"
"Mace 'Plod' Delcampo"
"Macho Man Noah Camm"
"Mack 'Nah' Hackman"
"Mad Ace Maceda"
"Mad Alan Mandala"
"Mad Alden Addleman"
"Mad Angelo Magdaleno" []
"Mad Arie Demaria" []
"Mad Arlen Alderman" []
"Mad Aron Marando" []
"Mad Barrie Arrambide" []
"Mad Ben Debnam" []
"Mad Bernie Biederman"
"Mad Brice Macbride"
"Mad Bull Blumdal"
"Mad CEO Macedo" []
"Mad Chong Mcdonagh"
"Mad Cole Macleod" []
"Mad Corie Mordecai" []
"Mad Cris McDaris"
"Mad Dion Diamond" []
"Mad Earl Delamar" []
"Mad Efren Federman" []
"Mad Eli Delima" []
"Mad Elia Almeida" []
"Mad Else Ledesma" []
"Mad Erich Demarchi"
"Mad Ewen Weedman"
"Mad-Eye [if player is male]Ed Maye[else]Dee May[end if]"
"Mad Felix Maxfield"
"Mad Fern Fredman"
"Mad Gil Migdal" []
"Mad Gino Mandigo" []
"Mad Hal Amdahl"
"Mad Hong Hodgman"
"Mad Huong Doughman"
"Mad Ines Seidman" []
"Mad Inez Zeidman" []
"Mad Iona Dimaano" []
"Mad Kaci Adamcik"
"Mad Kasi Adamski" []
"Mad Lang Gladman"
"Mad Lanita Dimalanta"
"Mad Lauran Marulanda"
"Mad Lea Almeda"
"Mad Leann Adelmann"
"Mad Len Mandel" []
"Mad Leo Olmeda" []
"Mad Leon Doleman" []
"Mad Leona Amendola" []
"Mad Leora Delamora" []
"Mad Les Delmas" []
"Mad Lon Dolman"
"Mad Loren Moreland" []
"Mad Lori Milardo" []
"Mad Lou Dumlao" []
"Mad Mee Medema"
"Mad Neal Adelman" []
"Mad Ned Dedman" []
"Mad Neil Idleman" []
"Mad Nell Melland"
"Mad Nik and Kim Kidman" []
"Mad Old Lad Dom"
"Mad Old Mo Ladd"
"Mad One Damone" []
"Mad Oren Medrano" []
"Mad Rae Madera-Demara" []
"Mad Rana Ramadan" []
"Mad Rena Aderman" []
"Mad Rene Merenda" []
"Mad Rey Demary" []
"Mad Rico Dimarco" []
"Mad Rina Miranda" []
"Mad Rio Moradi" []
"Mad Risa Madaris" []
"Mad Roni Mirando" []
"Mad Rose Derasmo"
"Mad Rush Shumard"
"Mad Ryan Maynard" []
"Mad Sandi Dadisman"
"Mad Shea Ashmead" []
"Mad Sona Adamson" []
"Mad Stan Stamand"
"Mad Stone Eastmond"
"Mad Su Dumas"
"Mad Tennie Tiedemann"
"Mad Terisa Armistead" []
"Mad Tesha Steadham" []
"Mad Tess Smestad"
"Mad Tina Diamant" []
"Mad Tish Stidham" []
"Mad Tona Mandato"
"Mad Tresa Armstead"
"Mad Yael Almeyda"
"Mad Zeno Mendoza" []
"Mad Zora Madrazo"
"Made Ali Almeida" []
"Made Archer Rademacher"
"Made Artis Armistead" []
"Made Caron Cardamone" []
"Made Delia Dealmeida" []
"Made Em Medema" []
"Made Fern Federman" []
"Made Gail Medaglia"
"Made Hebron Bodenhamer"
"Made Ira Madeira" []
"Made Len Edelman" []
"Made Lenn Edelmann"
"Made Les Ledesma" []
"Made Lin Mandile" []
"Made Logan Magdaleno" []
"Made Lon Mendola" []
"Made Lora Delamora" []
"Made Lyn Mandley" []
"Made Man [one of]Dan Emma[or]Ed Amman[at random]" []
"Made Nick Dieckman" []
"Made Nola Amendola" []
"Made Norville DeMoranville"
"Made Olin Mendolia" []
"Made Ray DeMaray" []
"Made Rich Demarchi" []
"Made Rico Mordecai" []
"Made Risa Demarais" []
"Made Ro D'Amore-DeRamo"
"Made Ron Dearmon" []
"Made Roni Demarino" []
"Made Ros Meadors" []
"Made Si DeMasi" []
"Made Stan Steadman" []
"Made Star Armstead" []
"Made Tito DiMatteo"
"Made Trinh Meinhardt"
"Mae 'Ranch' Marchena"
"Maestro Stomaer" []
"Magan 'Ranch' Mcgranahan"
"Malefactor [if player is male]Cal Frometa[else]Leoma Craft[end if]"
"Malicious Lucia Isom"
"Malicious Musical Io" []
"Malodorous Aldous Romo"
"Maltreater [if player is male]Lamar Rette[else]Reta Martel[end if]"
"Man 'Legs' Mangels"
"Man 'Ski' Kamins"
"Manciple McAlpine" []
"Mangler Almgren" []
"Mangler-Hit Eltringham"
"Mangler Mr. Lange" []
"Manhattan Matt Hanna"
"Manie 'Legs' Geiselman"
"Manon 'Ski' Makinson"
"Map Nut Putman"
"Map Nut Putnam"
"Mar-Soon Mansoor" []
"Mara 'Gun' Grauman"
"Mara 'Ranch' Ramcharan"
"Maranda 'Ranch' Ramachandran"
"Marc 'Nah' Marchan"
"Marge 'Nah' Hagerman" []
"Maribel 'Gun' Burlingame"
"Marietta's Metatarsi"
"Mario 'Legs' Margolies"
"Mark 'Gun' Krugman"
"Marmot Motram"
"Marna 'Gun' Graumann"
"Martial Tim Lara"
"Mason 'Gun' Magnuson"
"Masquer Marques"
"Mastodon Stan Odom"
"Mateo 'Gun' Montague"
"Matt 'Gun' Guttman"
"Matt 'Sneer' Testerman"
"Mauls-a-Slum Sam Lu" []
"Maybe-Not Abe Monty" []
"Maybe-Not Ty Beamon" []
"Mcewen 'Hands' Schwendeman"
"Mcshea 'Sneer' Essenmacher" []
"Me-Shy Hymes"
"Meager Graeme" []
"Meagrest Gamester Tam Egers"
"Mean Al Leaman" []
"Mean Aldo Amendola" []
"Mean Art Armenta" []
"Mean Bo 'Emo-Ban' Beamon" [p] []
"Mean Britt Bitterman"
"Mean Cara Camarena"
"Mean Carl MacLaren" []
"Mean Charis Marchesani" []
"Mean Cher Hermance"
"Mean Cora Macareno"
"Mean Del Edelman" []
"Mean Dick Dieckman" []
"Mean Dori Demarino" []
"Mean Doug Domangue"
"Mean Edwin Weidemann"
"Mean Elden Needleman"
"Mean Ennis Eisenmann"
"Mean Fred Federman" []
"Mean Gay Agyeman"
"Mean Geri Germaine" []
"Mean Gil Leaming"
"Mean Gina Nagamine"
"Mean Gino Mangione"
"Mean Glen Engelman"
"Mean Glenn Engelmann"
"Mean Golda Magdaleno" []
"Mean Ines Eisenman" []
"Mean Kia Akamine"
"Mean Kip Niekamp"
"Mean Les Sleeman-Seelman" []
"Mean Linh Heilmann"
"Mean-Lips Spielman"
"Mean Lise Milanese" []
"Mean Lora Molenaar" []
"Mean Lord Moreland" []
"Mean Loy Maloney"
"Mean Lu Manuel" []
"Mean Luis Suleiman" []
"Mean-Mane Eman"
"Mean Mean Amee Mann" []
"Mean Nell Mennella"
"Mean-O Neoma Eamon"
"Mean Ol['] Mo Lane-Leamon" []
"Mean Old [if player is male]Dan Mole[else]Lea Mond[end if]" []
"Mean Old Doleman-Mondale" []
"Mean Olin Moilanen"
"Mean Otis Maisonet" []
"Mean Raul Lauerman"
"Mean Red Merenda-Deerman" []
"Mean Rich Reichman" []
"Mean Rico Caminero" []
"Mean Risa Seminara" []
"Mean Rob Oberman-Boerman" []
"Mean Rod Dameron" []
"Mean Rollo Romanello"
"Mean Sage Geesaman" []
"Mean Sheri Heiserman"
"Mean Sid Seidman" []
"Mean Star Stearman"
"Mean Tara Amarante"
"Mean Teri Tremaine"
"Mean Tisha Mathiasen"
"Mean Toni Mantione"
"Mean Tony Montanye"
"Mean Trey Marteney"
"Mean Ty Yetman"
"Mean Vanna Vanmaanen"
"Mean Worn Morwenna"
"Meanie [if player is male]Ian Mee[else]Ami Nee[end if]"
"Meanie Raj Jeanmarie" []
"Meany Lech McElhaney"
"Meany Mayne"
"Measel'd Ledesma" []
"Measly Sly Mae" []
"Meatier Rita Mee" []
"Mee 'Ranch' Hermance"
"Meek Mr. Kemmer"
"Mega Icky Cagy Mike" []
"Megan 'Nah' Hagemann" []
"Mei 'Nah' Heiman"
"Mei 'Ranch' Reichman" []
"Mel 'Nah' Lehman-Helman" []
"Mel 'Ski' Mikels-Mikles"
"Mel the Helmet"
"Menacing [if player is male]Nic Gamen[else]Nanci-Meg[end if]"
"Mental Len Tam" []
"Merciless [if player is male]Clem Siers[else]Cris Semel[end if]" []
"Mere Pal Parmele, Pre-Meal"
"Mess-O Moses" []
"Meta 'Ranch' Catherman"
"Mia 'Gun' Mungia-Gumina"
"Mia 'Ski' Misiak"
"Mid-Tier Tim Reid" []
"Migrant Girtman" []
"Milda 'Gun' Maulding"
"Miles 'Nah' Leishman"
"Milo 'Nah' Holiman" []
"Min 'Gun' Mungin"
"Min-Wage Wiegman" []
"Mina 'Legs' Seligman"
"Mind-Fear Friedman" []
"Mind-Gamer [if player is male]Dean Grimm[else]Enid Gramm[end if]"
"Ming 'Zoo' Mozingo"
"Minh 'Ski' Mishkin"
"Missoula Sam Louis"
"Mo-Gun Mungo"
"Mo-Gun No-Mug Mungo"
"Mo['] Belly Bellomy"
"Mo['] Far Raffo Marmo" []
"Mo[']-Haste Amos the Hatsome" []
"Moaning Mangino" []
"Modern Dr. Nemo Redmon" []
"Modester Demorest"
"Moe 'Frat' Frometa" []
"Mona 'Nah' Monahan" []
"Mongrel Lormgen"
"Moobs-Bosom SOB Mo"
"Moodiest Sodomite [d-t] Moise"
"More-Pal Palermo" []
"Moronic Ric Moon" []
"Mosher Hosmer"
"Most-Stern Stenstrom"
"Mostly-Sly Tom"
"Motioner Monteiro" []
"Mousy Su Moy" []
"Movie Star [if player is male]Mario Vest[else]Vita Morse[end if]"
"Mr. Hess, a Smasher" []
"Mr. Take-Market" []
"Mrs. Cable-Scramble"
"Ms. Acquired-Crime-Squad"
"Ms. Bob Bombs"
"Mudthorn Thurmond"
"Mumbler Brummel"
"Munch-Good McDonough" []
"Murderer Demurrer Red Rumer"
"Muscular Scum Raul"
"Mustier Sturmie"
"My-Rules Rumsley"
"Nag-a-Doc Cadogan"
"Nail Biter Nate Bilir"
"Nailbiter Albertini" []
"Nameless Esselman" []
"Nameless Sam Elsen" []
"Narrow Raw Ron"
"Nat 'Legs' Stangel-Stangle"
"Nat 'Ski' Atkins"
"Natty Ty Tan"
"Neal 'Drawl' Wallander"
"Neal 'Nah' Lenahan"
"Neal 'Ski' Lesniak"
"Near-Bum [if player is male]Ren Baum[else]Em Braun[end if]"
"Near-Top Patreon Paterno"
"Neck Man McKenna"
"Neckbeard Daren Beck"
"Ned 'Ski' Deskin"
"Needy Ed Nye" []
"Neely 'Ski' Kneisley"
"Neg-[']Em Menge"
"Negative to Vegetation [if player is male]Gene Attivo[else]Evita Gonet[end if]"
"Negator Argento" []
"Negli-Nigel Ligne" []
"Negotiator [if player is male]Otto Aigner[else]Nita Ortego[end if]"
"Neil 'Nah' Lenihan-Linehan"
"Nell 'Ski' Skillen"
"Nemesis Siemens"
"Nepotist Poinsett"
"Nerd Dern" []
"Nerd-Smite Edminster" []
"Nerd-Spite President Ned Presti" []
"Nerdier Ren Reid-Dernier"
"Nerdy Deryn Ryden"
"Nervier Vernier"
"Nervy Verny" []
"Neutral Laurent Renault-Aultner"
"New Boss Snob Wes"
"New-ID Edwin Widen" []
"New Lad Wendal Walden"
"New Master Westerman"
"Newsboy Owensby" []
"Nice-Legs Nic Segel"
"Nice Nice Ince"
"Nice Pol 'Pinocle' Copelin"
"Nicer G (Cringe) Eric Ng" []
"Nicknamer Mckiernan"
"Nigel 'Frat' Taflinger" []
"Nigel 'Ski' Kiesling"
"Niki 'Legs' Kiesling"
"Nil-Opt Lipton" []
"Niles 'Ski' Lesinski"
"Nilsa 'Gun' Lusignan"
"Nine Finger Regine Finn"
"No-Angel Leo Gann"
"No-Arm Ramon" []
"No-Beard Rob Dean"
"No-Beliefs Ben Foiles"
"No-Bet Brad Broadbent"
"No-Bibles Bob Niles"
"No-Blood Loo Bond"
"No-Bores Robeson" []
"No-Breaks Ben Kosar" []
"No-BS Snob Bob [']N Sons" []
"No-Can-Do Don Cano"
"No-Cell Collen"
"No-Chills Nicholls"
"No-Chokes Shen Cook"
"No-Dithers North-Side [if player is male]Sid Thorne[else]Enid Short[end if]"
"No-Drugs Gus Dorn" []
"No-Eats Easton" []
"No-Ethics [if player is male]Otis Chen[else]Toni Esch[end if]"
"No-Faces Fonseca"
"No-Facts Fast Con Scot Fan"
"No-Gab Bogan" []
"'No Girls' Sol Ring" [p] []
"No-Glom Mongol Mo Long-Golmon"
"No-Hats Ashton Antosh" []
"No-Hug Hun Og"
"No-Hurry Hun Rory" []
"No-Hurts Rushton" []
"No-Jest Jetson"
"No-Jewels Lew Jones"
"No-Marks Sam Korn"
"No-Milk Lon Kim"
"No-Mistakes Tami Kesson"
"No-Moves Mo Ovens-Moonves" []
"No-Moves Moonves" []
"No-Needs Ned Enos"
"No-Pace Capone"
"No-Pester Peterson" []
"No-Punks Knupson"
"No-Reek Ken Ore"
"No-Salt Alston" []
"No-Sarcasm Sam Carson"
"No-Scar Carson" []
"No-Skimp Mo Spink"
"No-Smarm Mr. Mason"
"No-Story Royston" []
"No-Style Len Yost" []
"No-Tardy Drayton" []
"No-Taunts Staunton" []
"No-Tax Ox Nat Axton"
"No-Terms Monster Mo Ernst" []
"No-Time Tim Eno"
"No-Tip Alan Napolitan" []
"No-Tip Alona Napolitano" []
"No-Tip Capri Principato"
"No-Tip Ed DePinto"
"No-Tip Edgar Daigrepont"
"No-Tip Em Timpone"
"No-Tip Etta Pettinato"
"No-Tip Geri Pingitore" []
"No-Tip Glen Pingleton"
"No-Tip Grant Partington"
"No-Tip Hal Oliphant" []
"No-Tip Howser Witherspoon"
"No-Tip Lea Lapointe" []
"No-Tip Link Pilkinton"
"No-Tip Ola Politano" []
"No-Tip Roe Petronio"
"No-Tip Rosa Pastorino" []
"No-Tip Rose Petrosino" []
"No-Tip Sears Petrossian" []
"No-Tip Stan Pattinson"
"No-Tip Su Pontius" []
"No-TTYL Lytton"
"No-Works Skowron"
"Nobbish Bob Shin"
"Nodder Ed Dorn" []
"Noe 'Gun' Gunnoe"
"Noe 'Plod' Polendo"
"Noe 'Ski' Sienko"
"Nolo Loon Loo Onlon"
"Non-Aromatic Marcantonio" []
"Non-Mug Mo Gunn"
"Normative Viramonte" []
"Nose-Blow Slob Owen"
"Nosepicker Ken Serpico, Sicker Peon" []
"Noshin['] Hinson"
"Not-Cool Coot Lon" []
"Not-Cool Loot Con Colt Ono" []
"Not-Dumb Bo Mundt"
"Not-Frat Trafton"
"Not-Good Goon [d-t]"
"Not-Hungry Thug Ronny"
"Not-Lying Tiny Long"
"Not Normal [if player is male]Lon Ortman[else]Lorna Mont[end if]"
"Not-Safe Stefano" []
"Not-Sane Santone"
"Not-Smart Mort Nast" []
"Not-Snide Deniston"
"Not-Social [if player is male]Tino Scola[else]Loni Coats[end if]"
"Notary Nat Roy" []
"Now-Lethal Lowenthal"
"NRA Arn"
"Number-One Ruben Meno" []
"Numeric Minceur Nic Reum"
"Nut Rob Bruton" []
"Oafish Isa Hof"
"Obeser Bo Rees"
"Obliger Gil Boer"
"Obliger Glib Reo" []
"Obsolete Boots Lee" []
"Occupied Ed Puccio"
"Ocie 'Ski' Osiecki"
"Oda 'Gun' Dougan"
"Odd Ben Bodden" []
"Odd-Bile Diebold" []
"Odd Daria Daddario"
"Odd Fran Danford"
"Odd Gale Delgado" []
"Odd Lan Donald" []
"Odd Lew Dowdle"
"Odd Luke, Old Duke"
"Odd Man Mad Don"
"Odd Maren Dearmond" []
"Odd Max Maddox"
"Odd Min Dimond" []
"Odd Mina Diamond" []
"Odd Monsen Edmondson"
"Odd Myer Dermody"
"Odd Oren Redondo"
"Odd Rina Dinardo" []
"Odd Sina Addison" []
"Odd Tonia Didonato"
"Odorless Del Rosso"
"Offline Flo Fine" []
"Offshore Fresh Foo['] [if player is male]Shef Roof[else]Rose Hoff[end if]"
"Ogle Cat Colgate" []
"Ogling Gong Li"
"Ogre [d-t] DeGroot"
"Ogre Alda Regalado" []
"Ogre Alf LaForge" []
"Ogre Ann Gennaro"
"Ogre Avis Gervasio"
"Ogre Bentsen Engebretson"
"Ogre Bernd Rodenberg"
"Ogre Bill Bolliger"
"Ogre Brant Bontrager" []
"Ogre Bren Bergeron-Groebner" []
"Ogre Brent Rotenberg"
"Ogre Burns Rosenburg"
"Ogre Dan Dragone" []
"Ogre Dana Agredano"
"Ogre Diann Digennaro" []
"Ogre Don Goodner"
"Ogre Embry Borgmeyer"
"Ogre Esau Oseguera"
"Ogre Geri Gregoire"
"Ogre Ian Noriega" []
"Ogre Jamel Melgarejo" []
"Ogre Lad Geraldo" []
"Ogre Lan Lagrone" []
"Ogre Lev Vogeler"
"Ogre Levan Governale"
"Ogre Luis Silguero"
"Ogre Lula Arguello"
"Ogre Man Germano Marengo-Moragne"
"Ogre Marna Garramone" []
"Ogre Maud Argumedo"
"Ogre Mila Magloire" []
"Ogre Minh Moehring" []
"Ogre Mo Groome"
"Ogre Nell Goellner"
"Ogre Reid Roediger"
"Ogre Ren Goerner"
"Ogre Rob Borrego"
"Ogre Sana Aragones"
"Ogre Saul Salguero" []
"Ogre Sean Ragonese"
"Ogre Si Sergio"
"Ogre Singh Higgerson"
"Ogre Tad DeGroat" []
"Ogre Ted Goedert"
"Ogre Una Noguera"
"Oh-[crap-u] Chopra" []
"Oh-No Hoon" []
"Ol['] Chet 'Lo-Tech' Lochte"
"Ol['] Pain Napoli"
"Ol['] Rex Rolex"
"Ol['] SOB Sobol" []
"Ola 'Gun' Angulo"
"Old Cheat Deloatch" []
"Old Dog Og Dold" []
"Old Fran Randolf" []
"Old Gun DuLong"
"Old Liar Radillo" []
"Old Lita DiTolla"
"Old Thumb Humboldt"
"Olde Cap'N Copeland"
"Oleaginous [if player is male]Louis Genoa[else]Sonia Logue[end if]"
"Olga 'Legs' Gallegos"
"Omer 'Gun' Mounger"
"Omerta Tam Roe" []
"Omni-Moni Mino" []
"On-a-Diet [toti] Ade"
"On-Drugs Rod Sung" []
"On-I-Bash Siobhan"
"On-That Hatton" []
"On-the-Fly Hefty Lon"
"Ona 'Legs' Gleason"
"Ona 'Zits' Santizo"
"Once-Dumb Duncombe"
"Once-Tall Lancelot" []
"One-Arm Ramone Merona" []
"One-Cap Capone" []
"One-Flog Flo Egon" []
"One-Hat Heaton" []
"One-Plant Napleton"
"Oofer Orfeo"
"Operator Art Poore"
"Ora 'Gun' Ungaro"
"Ora 'Plod' Lopardo"
"Ora 'Ski' Sikora-Rosiak"
"Orange Ned DeGennaro" []
"Oregon Gooner Reg Ono" []
"Oren 'Frat' Frontera"
"Oren 'Ski' Erikson"
"Org-Gro Rog"
"Orgiast Rastogi"
"Ornater Treanor"
"Ornery Ren Roy"
"Ornery Ron Rey" []
"Ostentatious-Toe Toussaint" []
"Oswald 'Ski' Sadlowski"
"Otakon Oakton"
"Outland Lout Dan Daulton" []
"Over-Literal Leila Trevor"
"Over-Pitch Petrovich"
"Ox-Quite-Toxique Quixote"
"Paid Art Partida" []
"Paid Cal Capaldi"
"Paid Husain Dauphinais"
"Paid Lavon Vialpando"
"Paid Leo DePaoli" []
"Paid Leon DeNapoli" []
"Paid Mir DiPrima" []
"Paid Noe Peinado" []
"Paid Nola Paladino" []
"Paid Olsen Espindola" []
"Paid Ren DiPerna"
"Paid Rico Dicaprio"
"Paid Ro Parodi" []
"Paid Rosa Paradiso" []
"Paid Sera Paradise" []
"Palau Paula"
"Pallider Del Pilar" []
"Pam 'Ranch' Parchman"
"Pam 'Sneer' Spreeman"
"Paranoid Pro Aidan" []
"Pardon Vet Davenport" []
"Paris 'Ski' Pisarski"
"Parsonic Scarpino"
"Pasty Sap Ty" []
"Patchy Chap Ty"
"Patriotic Capriotti"
"Paul 'Ski' Pulaski"
"Pauser Prause" []
"Payer Peary"
"Peaked Deepak"
"Pearl 'Nah' Lanphear"
"Pearlier LaPierre" []
"Peckish Pischke"
"Peckish Schipke" []
"Peculiar Paul Rice" []
"Peeved Veep Ed"
"Pei 'Legs' Spiegel"
"Peking Pig Ken"
"Pensioner [if player is male]Enos Perin[else]Irene Pons[end if]"
"Permanent Petermann"
"Permeant Man Peter"
"Pernicious Spice Nouri"
"Peru Prue & Rupe" []
"Perv-Sot Prevost" []
"Petra 'Ski' Petrakis"
"Pettier Peretti"
"Petty Perry Petry"
"Pia 'Legs' Legaspi"
"Picadore DeCaprio" []
"Pig Deon Pidgeon"
"Pig Detra Patridge" []
"Pig Elsa Glaspie-Legaspi"
"Pig Elsa Legaspi" []
"Pig Else Spiegel"
"Pig Lem Gimpel"
"Pig Len Epling"
"Pig Leslie Gillespie"
"Pig Lin Gilpin"
"Pig Lon Poling"
"Pig Luis Puglisi"
"Pig Luna Pauling"
"Pig Neth Thigpen" []
"Pig Raye Gariepy" []
"Pig Rena Pinegar" []
"Pig Renick Pickering" []
"Pig Seth Speight"
"Pig Son Gipson" []
"Pig Wetter Pettigrew"
"Pigpen Epping"
"Pikeman Niekamp" []
"Pillock Pollick"
"Pimply Pip Lym"
"Pink Elton Pilkenton"
"Pink Gil 'King Lip' Kipling" [p]
"Pink Lea Pelikan"
"Pink Lisa Lapinski"
"Pink Lois Polinski"
"Pink Luis Lupinski"
"Pink Mae Niekamp"
"Pink Mel Kemplin"
"Pink Miss Simpkins"
"Pink Nona Pankonin"
"Pink Pox Pip Knox"
"Pink Rey Prinkey"
"Pink Rosa Parkison"
"Pink Sol Plonski"
"Pink Tessa Stepanski"
"Pink Tom Kimpton"
"Pinstripe Ines Tripp"
"Placatory Playactor Cory Plata"
"Plant Iona Napolitan"
"Plant Lea Pallante"
"Plant Lorie Pontarelli"
"Plant Mo Lampton"
"Plant Ned Pentland"
"Plant Poe Appleton"
"Play-Cool Claypool"
"Pleasant Pale Stan" []
"Plonker Ren Polk"
"Plottin['] [if player is male]Lon Pitt[else]Lin Pott[end if]"
"Plotzed Petzold"
"Plumber Rep Blum"
"Plyin['] Pliny"
"Plying-So-Spongily 'Lips' Yong"
"Pointer Petroni" []
"Pointy No-Pity Ty Pino" []
"Polecat Pat Cole" []
"Police-Liar Picariello"
"Polite Rex, Exploiter" []
"Pools Kid Podolski"
"Poorliest Pistolero [if player is male]Sol Prieto[else]Tori Lopes[end if]"
"Pops Rene Epperson"
"Popular Lou Rapp"
"Porin['] Ripon"
"Porkiest Petroski" []
"Pornier Perrino"
"Pornos-Snoop'r POS Ron" []
"Poseur Prouse"
"Posh Hoss Hopp"
"Poshnik Hopkins" []
"Poshnik Kip Sohn" []
"Posturer [if player is male]Rupert So[else]Su Porter[end if]"
"Pot Addict Patti Codd"
"Potent Mel Templeton"
"Pottier Perotti"
"Powder-Blue Pueblo Drew"
"Powerful Rupe Wolf"
"Practical Cart Calip"
"Prating Prig Nat"
"Predator Tad Roper" []
"Predatory Toad Perry" []
"Predo-Doper Pedro" []
"Pressor Prosser"
"Private Pat Iver"
"Pro-Evil Rip Love" []
"Pro Les Sloper-Spoerl"
"Pro-Life-of-Peril Flip Ore" []
"Pro-Viruses Supervisor Rose Purvis"
"Problematic [if player is male]Bert Campoli[else]Patrice Blom[end if]"
"Properly-Reply Pro Rory Lepp" []
"Punitive Evi Putin"
"Pure Al Lauper"
"Put-Downer Drew Upton"
"Quainter Antiquer [if player is male]Art Quine[else]Teri Quan[end if]" []
"Quasher H-Square"
"Queer Cari Cerqueira"
"Queer Jo Requejo"
"Queer Marti Marquerite"
"Queer Matt Marquette"
"Queer Romo Roquemore"
"Queer Shin Henriques"
"Quiet Ox Quixote"
"The Race Cheater Chet Rea"
"Rackety Ty Acker" []
"Rad Dog Godard"
"Rae 'Legs' Glaeser"
"Rae 'Nah' Ahearn"
"Rae 'Plod' Leopard"
"Rae 'Ski' Kaiser-Raikes"
"Rainmaker [if player is male]Ira Kerman[else]Erma Arkin[end if]"
"Rainmaker [if player is male]Mark Neria[else]Kira Erman[end if]" []
"Rakish Shakir"
"Ramon 'Ski' Romanski"
"Rancid Cardin"
"Rancid Dr. Cain" []
"Rancid Nic Ard" []
"Rancored Dorrance" []
"Rank Abe Baranek"
"Rank Ace Anacker"
"Rank Bee Beranek"
"Rank Debi Bednarik" []
"Rank Del Kandler" []
"Rank Ed Danker" []
"Rank Elf Falkner"
"Rank Geri Kerrigan-Kerrigan" []
"Rank Kay Kraynak"
"Rank Kim Kirkman"
"Rank Les Karlsen-Sklenar"
"Rank Lis Larkins"
"Rank Loss Karlsson"
"Rank Loy Karolyn"
"Rank Mae Akerman"
"Rank Maria Markarian" []
"Rank Mei Kaminer"
"Rank Moe Romanek" []
"Rank Pam Parkman"
"Rank Rene Rennaker"
"Rank Si Raskin" []
"Rank Sol Karlson"
"Rank Tad Tankard" []
"Rank Tami Martinka"
"Rank Ted Dankert"
"Rank Tess Karstens"
"Rank Tod Kondrat" []
"Rank Tom Kortman" []
"Rant-Box Ox Brant Braxton"
"Rash Boy Rob Hays" []
"Rash Dolt Stordahl"
"Rash Meg Gresham" []
"Rash Roni Harrison" []
"Rash Shar Sahr"
"Rat-Not Arnott"
"Rat Seth Hastert" []
"Ratlike Talkier Litaker"
"Rattiness-Resistant [if player is male]Trent Issa[else]Tisa Stern[end if]" []
"Rau 'Legs' Glauser"
"Raul 'Plod' Poullard"
"Ravager Vergara" []
"Rave Boy Overbay" []
"Raw Deal Lea Ward" []
"Raw Hood Harwood"
"Raw Ike Kierwa"
"Ray-Dog O'Grady" []
"Rayna 'Gun' Nungaray"
"Re-Dealing Geraldine" []
"Real-Class Scarsella" []
"Real Quick Alec Quirk"
"Real Ripe Al Pierre" []
"Real Sick Clarksie"
"Real-Twist Stirewalt" []
"Realest Stealer Lee Rast" []
"Realtor/Relator Al Torre"
"Reap-Dim Dampier"
"Reap Dr. Draper"
"Rec-of-Force Cofer" []
"Recidivist Cristi Devi"
"Red 'Nah' Harden-Harned" []
"Red Baron Bro Andre" []
"Red Ben Bender"
"Red-Coats DeCastro" []
"Red Dog Dodger" []
"Red Dre Erd"
"Red-Gun Gruden" []
"Red Gwen Dwenger"
"Red-Line Leidner" []
"Red Wolf Fred Low"
"Reda 'Plod' Delprado"
"Reddening Dendinger"
"Redneck Dencker" []
"Reed 'Ski' Dierkes"
"Reed Holt the Older" []
"Reeve 'Nah' Heavener"
"Reformado Framer Odo"
"Refringed Fred Negri" []
"Regan 'Ski' Kasinger"
"Regent Genter-Engert"
"Regine 'Zits' Seitzinger"
"Rejected Ced Jeter" []
"Relaxed Rex Dale"
"Relenting-Nil Regent [if player is male]Len Tigner[else]Teri Glenn[end if]"
"Relying Ringley"
"Remissory Morrissey"
"Ren 'Legs' Gensler"
"Rend-All Darnell Landler"
"Rene 'Frat' Ferrante-Ferrante" []
"Rene 'Hands' Hernandes"
"Renita 'Legs' Easterling"
"Rent Boy Bo Tyner"
"Rent Boy Bret Noy" []
"Rent Boy Rob Tyne" []
"Rent Boy Tony Erb" []
"Rent Boy Ty Borne" []
"Repelling Pellegrin"
"Repo Man Rampone"
"Resetter Streeter"
"Resonant Stan Nero" []
"Restive Sievert"
"Retainer Renteria" []
"Retreater Ratterree"
"Revenant Tavenner"
"Revisor Riveros"
"Rex Lew-Wexler"
"Rey 'Frat' Raftery" []
"Rey 'Gun' Gurney"
"Rey 'Nah' Harney-Hayner"
"Reyes 'Gun' Guernsey"
"Rhea-So-Hoarse" []
"Rheumatoid [if player is male]Theo Midura[else]Maudie Roth[end if]"
"Rheumic Murchie"
"Rhoda 'Gun' Draughon"
"Rich 'Sneer' Schreiner"
"Rich-Needs Schneider"
"Rich Sot Christo"
"Rifest Strife Sifter Stef Ri" []
"Rifle Nut [if player is male]Len Fruit[else]Rue Flint[end if]"
"Right-Bank King Barth" []
"Rina 'Legs' Salinger"
"Rinser Risner"
"Rip-Glands Spradling"
"Ripped Perp Di" []
"Risa 'Legs' Grisales"
"Ritz-O Ortiz"
"Roach Arch-O Rocha" []
"Roadman Armando" []
"Roaster Serrato" []
"Rob 'Gun' Ogburn"
"Rob 'Legs' Solberg-Solberg"
"Rob 'Sneer' Berrones"
"Rob 'Zits' Zobrist" []
"Rob-Con Bronco Bo Corn"
"Rob, Ex-Boxer"
"Robt 'Legs' Stolberg"
"Robust Bro Stu"
"Rod 'Gun' Ground"
"Rod 'Sneer' Renderos" []
"Roil-Games Margolies"
"Roil-Lad Radillo" []
"Rolf 'Gun' Furlong"
"Roll-[']Em Moller"
"Romancer Cranmore"
"Rompish Morphis"
"Ron 'Ski' Sorkin"
"Roni 'Legs' Gorsline-Solinger"
"Rootless Rosselot" []
"Ros 'Fib' Forbis" []
"Ros 'Nah' Sharon" []
"Rosann 'Gun' Gunnarson"
"Roscoe 'Legs' Groseclose"
"Rose 'Gun' Surgeon"
"Rosi 'Ranch' Richarson"
"Rot-Bag Bogart" []
"Rotten Trent-O Retton" []
"Rottin['] Triton"
"Roughed Red Hugo"
"Routing Guitron" []
"Rubbish Bri Bush" []
"Rube Em Beumer"
"Rube Esch Buescher"
"Rube Ewan Newbauer"
"Rube Ferg Freeburg"
"Rube Gal Glauber" []
"Rube Gilman Burlingame" []
"Rube Hartley Leatherbury"
"Rube Lemon Melbourne" []
"Rube Sage Gesbauer"
"Rube Sly Elsbury"
"Rube Snyder Dusenberry"
"Rube Sosa Brosseau"
"Rube Tank Bartunek" []
"Rude Al Eluard" []
"Rude Dr. Rudder"
"Rude Sly Dursley"
"Rueing Guerin"
"Rumbliest Stumblier Burt Miles"
"Run-For-Fun Orr"
"Runt Bo 'No Trub' Burton" [p] []
"Rushed Alton Southerland" []
"Rushed Otto Osterhoudt"
"Rushed Sol Shoulders"
"Rutha 'Legs' Slaughter"
"Ruthless Les Hurst"
"Sad-Front Stanford" []
"Sad-Wink Dawkins" []
"Sadler 'Fibs' Brassfield"
"Safe-Con Fonseca" []
"Saintly [if player is female]Sly Tina[else]Tiny Sal[end if]" []
"Sallow Slow Al"
"Sam 'Gun' Mangus"
"Sam 'Nah' Ashman" []
"Sam 'Ski' Kassim"
"Sam 'Zoo' Somoza"
"Samesy Massey" []
"Samson 'Gun' Magnusson"
"Sane-Munch Schuneman"
"Sane Pro Pearson" []
"Sang 'Ski' Gaskins-Kassing"
"Sangfroid [if player is male]Ford Gains[else]Doris Fang[end if]"
"Sanguine Gia Nunes"
"Santo 'Ski' Atkisson"
"Sardonic Scardino" []
"Sarge Al Lagares"
"Sarge Anh Sanghera" []
"Sarge Case Escarsega" []
"Sarge Diego Georgiades"
"Sarge Elden Greenslade" []
"Sarge Eva Seagrave"
"Sarge Jon Grosjean"
"Sarge Lamont Mastrangelo" []
"Sarge Les Graessle" []
"Sarge Lin Salinger-Aslinger" []
"Sarge Lou Salguero" []
"Sarge Lu Glauser" []
"Sarge Mel Elgersma"
"Sarge Milo Margolies" []
"Sarge Ned Snedegar" []
"Sarge Noe Ragonese" []
"Sarge Ona Aragones" []
"Sarge Renton Rosengarten"
"Sarge Yuri Ysaguirre"
"Sarina 'Ski' Sarkisian"
"Savviest Tessa-Viv"
"Scammin['] McManis"
"Scariest Teri Cass"
"Scary Elbert Castleberry" []
"Scary Les Casserly" []
"Scary Sue Syracuse" []
"Scheduler Ed Ruschel" []
"Schemin['] Sim Chen" []
"Schmoozer Zoe Schrom"
"Schoolin['] Lois Cohn"
"Scone Kid Dickeson" []
"Scoundrel Elson Curd" []
"Scoundrel Ren DuClos" []
"Scouser Russ Coe" []
"Screw-All Carswell"
"Scum Broker Mosbrucker"
"Scum Cal McLucas"
"Scum Dione Nicodemus"
"Scum Han Cushman-Schuman" []
"Scum Hanner Schuermann"
"Scum Ian Mancusi"
"Scum Iona Cusimano"
"Scum Raia Misuraca"
"Scum Reda DeMarcus" []
"Scum Serna Marcussen"
"Scum Signe McGuiness"
"Seamiest Sietsema"
"Seamy Mayes" []
"Sean 'Ski' Kissane-Isaksen"
"Seb Holt the Slob"
"Secluded Luc Deeds"
"Secret-Life [if player is male]Eric Feltes[else]Reese Clift[end if]"
"Secretive Steve Rice" []
"See 'Ski' Kissee"
"See-Bold Bledsoe" []
"See-Red Ed Rees"
"Seedy Syeed" []
"Seething Seth Negi" []
"Self-Serving Vig Flessner"
"Semi-Raw Wiersma"
"Senhorita Hortensia" []
"Senor Soren Noser" []
"Sensorial Israelson" []
"Separatist Passaretti"
"Shady Dy Ash" []
"Shallow Ol['] Walsh" []
"Shallow Slow Hal"
"Sham Albert Halberstam" []
"Sham Ann Hansman"
"Sham Art Hamstra" []
"Sham Breana Abrahamsen"
"Sham Celina Aeschliman" []
"Sham Celine Michaelsen" []
"Sham Eda Ashmead" []
"Sham Eli Ishmael" []
"Sham Eric Marchesi" []
"Sham Erin Shireman" []
"Sham Ernie Heiserman" []
"Sham Ida Shimada" []
"Sham Katia Takashima"
"Sham Lea Salameh" []
"Sham Leann Hanselman"
"Sham Len Shelman"
"Sham Neil Leishman" []
"Sham Nell Shellman"
"Sham Nettie Matthiesen"
"Sham Nicole Michaelson" []
"Sham Oren Horseman" []
"Sham Rena Shearman" []
"Sham Rene Ehresman" []
"Sham Ron Horsman" []
"Sham Roni Harmison"
"Sham Star Stramash"
"Sham Teri Hiemstra" []
"Sham Tia Mathias" []
"Sham Toni Mathison"
"Sham Ty Mathys"
"Sham Una Hausman"
"Shambolic Milo Basch"
"Shana 'Nah' Shanahan"
"Shanker Kashner" []
"Shark Caleb Blackshear"
"Shark Ione Kaneshiro"
"Shark Les Harkless"
"Shark Lobo Lashbrook"
"Shark Paco Prochaska"
"Sharp Ed Shepard"
"Sharp Kurt Parkhurst"
"Sharp Mace Amspacher"
"Sharp Si Phariss"
"Shifty Ty Fish"
"Shin 'Legs' Hessling"
"Shlocky Shylock Sly Koch"
"Shon 'Ski' Hoskins"
"Shona 'Plod' Adolphson"
"Shoplifter Trifle-Posh [if player is male]Phil Foster[else]Flor Speith[end if]"
"Short [i-n] Hairston" []
"Short Fuse [if player is male]Foster Hsu[else]Ruth Fosse[end if]"
"Short Man Stan Mohr"
"Shorted Des Hort" []
"Shot Mr. Strohm"
"Shouter Sue Roth" []
"Shouting Otis Hung" []
"Shrinker Kirshner"
"Shroudy Shy Dour [if player is male]Rudy Soh[else]Dy Roush[end if]"
"Shush-U Hsu"
"Shy-Fort Forsyth"
"Shyster Seth Rys"
"Si 'Frat' Safrit" []
"Si 'Legs' Lessig"
"Sick Bald Backslid Sid Black"
"Sick Ned Dickens" []
"Sick-Rent Stricken Nickster"
"Sickener Ericksen" []
"Sid 'Gun' Dingus"
"Sid 'Sneer' Driessen-Resendis" []
"Silent Al Santelli"
"Silent Alona Santaniello" []
"Silent Buena Laubenstein"
"Silent Dee Edelstein" []
"Silent Eda Adelstein"
"Silent Gary Singletary"
"Silent Gerry Singleterry"
"Silent Hong Shingleton" []
"Silent Lora Santorelli" []
"Silent Mi Milstein"
"Silent Nola Antonellis" []
"Silent Owen Lowenstein" []
"Silent Ree Esterline"
"Silent Roge Oesterling" []
"Silent-Yawn Winstanley" []
"Silk-Crest Slickster [if player is male]Les Strick[else]Lis Streck[end if]"
"Sin-Jerk Jerkins" []
"Sin Kid Diskin" []
"Sin-Large Salinger" []
"Sin-Mouth Humiston" []
"Sink-Ye Kinsey"
"Sir Erv Rivers"
"Sir Paul Luprisa"
"Ski-Not Kitson"
"Skinned Denkins" []
"Skunk Carchi Cruickshank"
"Slanderer Red Larsen"
"Slapper Les Rapp"
"Slapper Perp Sal" []
"Slattern Sal Trent"
"Slavin['] Lu Sullivan"
"Slavish Shiv Sal"
"Sleazebag Baz LeSage"
"Sleazeball [if player is male]Les Bellaza[else]Zella Sable[end if]"
"Slick Arndt Strickland"
"Slick-Deal Lis Cadlek"
"Slick Evan Vansickle" []
"Slick Luong Gullickson"
"Slick Nemo Mickelson"
"Slick Rheba Blackshire"
"Slick Una Caulkins" []
"Slicker Rickles"
"Slim Slim Miss Mill"
"Slimeball [if player is male]Ellis Lamb[else]Elba Mills[end if]"
"Slimier Iris Lem" []
"Slimy Hack Michalsky"
"Slimy Sy Lim"
"Slithery Trish Ley"
"Slob Ace Belasco"
"Slob Alec Ceballos"
"Slob Ament Bostelman"
"Slob Andre Balderson" []
"Slob Arce Barcelos"
"Slob Archie Charlebois" []
"Slob Arendt Balderston" []
"Slob Arment Lambertson" []
"Slob Arnett Rosenblatt" []
"Slob Boss Boll"
"Slob Clare Barcellos"
"Slob Dana Sandobal"
"Slob Dee Bledsoe" []
"Slob Ed Sebold"
"Slob Edy Seybold"
"Slob Elsie Boisselle" []
"Slob Euna Banuelos" []
"Slob Ginter Gilbertson" []
"Slob Gryder Goldsberry" []
"Slob Ham Lashomb"
"Slob Janik Jablonski" []
"Slob Karol Allsbrook"
"Slob Kiesow Sobolewski"
"Slob Laseter Ballesteros"
"Slob Len Bonsell"
"Slob Leo Belloso"
"Slob Lew Boswell" []
"Slob Lina Bonillas-Sabillon"
"Slob Lore Sorbello"
"Slob Luci Cubillos"
"Slob Man Lambson"
"Slob Maren Rosenbalm" []
"Slob Monroe Rosenbloom" []
"Slob Nack Blackson"
"Slob Nygren Bryngelson"
"Slob Ona Bolanos"
"Slob Ree Ebersol" []
"Slob Regina Gabrielson" []
"Slob Rena Alberson"
"Slob Rey Broyles" []
"Slob Sera Labrosse"
"Slob Soroka Alsobrooks"
"Slob Tad Bolstad"
"Slob Trace Belcastro"
"Slob Traci Cristobal" []
"Slob Trena Bartleson" []
"Slob Yanik Yablonski" []
"Slobbery [if player is male]Bob Ryles[else]Lory Ebbs[end if]" []
"Sloshed Del Hoss" []
"Sloth Holst" []
"Slouchin['] Colin Hsu"
"Slouchy Coy Lush [if player is male]Sly Chou[else]Lucy Soh[end if]"
"Slovenly Lon Selvy"
"Slow-Bike Lebowski"
"Slow-Hater Showalter" []
"Slum Con Scum Lon"
"Sly [n-t] Stanley" []
"Sly Abe Basley" []
"Sly Ace Claeys"
"Sly Al Sally"
"Sly Antwine Winstanley" []
"Sly Avi Sylvia"
"Sly Cesar Casserly" []
"Sly Dante Standley"
"Sly Dean Slayden"
"Sly Debera Beardsley" []
"Sly Debra Bardsley" []
"Sly Dedra Drysdale" []
"Sly Dee Sedley-Seydel"
"Sly Dina Lindsay" []
"Sly Dog Sy Gold"
"Sly Eden Densley"
"Sly Elma Smalley" []
"Sly Else Lessley"
"Sly Em Myles" []
"Sly Enid Lindsey"
"Sly Erich Chrisley"
"Sly Ethel Heltsley"
"Sly Evan Snavely"
"Sly Eve Selvey"
"Sly Evie Livesey"
"Sly Ewa Wasley"
"Sly Ewan Wansley"
"Sly Ewart Swartley"
"Sly Fae Safley"
"Sly Ike Liskey"
"Sly Ines Nissley"
"Sly Ivan Sylvain"
"Sly Kevin Levinsky"
"Sly Kip Lipsky"
"Sly Lea Lasley" []
"Sly Leah Lashley"
"Sly Lee Lesley"
"Sly Leon Ellyson"
"Sly Lu Sully" []
"Sly Luc Scully"
"Sly Mae Masley" []
"Sly Mei Smiley" []
"Sly Nat Stanly"
"Sly Neil Linsley"
"Sly Ol['] Lysol Solly"
"Sly Ora Saylor-Royals"
"Sly Otto Tolstoy"
"Sly Petra Spratley"
"Sly Reeve Eversley"
"Sly Retta Satterly"
"Sly Rosa Saylors"
"Sly Rupe Pursley"
"Sly Sera Salyers"
"Sly Sue Ulysse"
"Sly Tera Slayter" []
"Sly Thea Stahley"
"Sly Wade Swadley"
"Sly Wee Wesley"
"Sly Zeke Szekely"
"Slyboots Stoolsby"
"Smart [if player is female]Ms. Art [end if]Stram" []
"Smart Rube Burmaster" []
"Smasher [if player is male]Mr. Hasse[else]Ms. Shear[end if]" []
"Smeary Ramsey" []
"Smelly Sly Mel"
"Smoky Ice Comiskey" []
"Smurfy [if player is male]Mr. Sy Fu[else]Ms. Fury[end if]" []
"Snag-This Hastings" []
"Snakebird Bednarski" []
"Snarly Sly Arn"
"Snazzy Sy Zanz"
"Sneaky-Snakey Kay Sen" []
"Sneaky Sy Kane" []
"Sneering Ensigner"
"Snickerer [if player is male]Eric Kerns[else]Cris Kreen[end if]"
"Snickering Nick Singer"
"Snickering Rick Ensign" []
"Snide Al Daniels" []
"Snide Berto Doberstein" []
"Snide Bo DeBonis"
"Snide Chae Deschaine"
"Snide Cher Schneider" []
"Snide Eldora DeLeonardis"
"Snide Gale DeAngelis" []
"Snide Irma DeMarinis" []
"Snide Kali Danielski" []
"Snide Lara Saldierna" []
"Snide Leta Adelstein" []
"Snide Lora Leonardis" []
"Snide Ma Seidman" []
"Snide Moe DeSimone"
"Snide Neal Danielsen"
"Snide Nola Danielson" []
"Snide Opal Espindola" []
"Snide Pa DeSpain"
"Snide Paz Dispenza"
"Snide Raul Lauridsen" []
"Snide Retha Eisenhardt" []
"Snide Rock Dickerson" []
"Snide Valko Levandoski"
"Snidey Sidney"
"Snooper Pro Enos"
"Snoopier Poisoner Ines Poor"
"Snorer-Gob Rosenborg"
"Snorter Torrens"
"Snot Nat Stanton"
"Snout Suton" []
"Snow-Hating Washington"
"Snuck-In Nick Sun"
"So-Angry Grayson" []
"So-Bland Sal Bond" []
"So-Brutal [if player is male]Saul Bort[else]Lura Bost[end if]" []
"So-Busy Boss Yu" []
"So-Crazy Scary Oz" []
"So-Dapper [if player is male]Pedro Asp[else]Dora Epps[end if]"
"So-Fiery Sy Fiore"
"So Flat Soft Al" []
"So-Foul Ulf Soo"
"So-Gaudy Gus O'Day" []
"So-Happy Posh-Pay Pop Hays" []
"So-Hurt Su Roth" []
"So-Manic Nic Amos" []
"So-Meh Moshe" []
"So-Mighty Gio Smyth"
"So-Pretty [if player is male]Rey Potts[else]Rosy Pett[end if]" []
"So-Smart Art Moss"
"So-Tall Al Olst" []
"So Tricky Rick Yost"
"So-Ugly Guy Sol"
"So-Wasted Tessa Dow"
"SOB Al, a Slob So Bla"
"SOB Al Sabol" []
"SOB Alma Balsamo"
"SOB Anita Sabatino"
"SOB Art Bartos" []
"SOB Carmen Branscome" []
"SOB Dee DeBose"
"SOB Don Dobson"
"SOB Eric Briscoe" []
"SOB Erin Briseno"
"SOB Erma Ambrose" []
"SOB Estrella Ballesteros" []
"SOB Len Nobles"
"SOB Leta Seabolt" []
"SOB Mac Bascom" []
"SOB Marion Ambrosino"
"SOB Marna Abramson"
"SOB Nola Bolanos" []
"SOB Oren Osborne" []
"SOB Rena Seaborn" []
"SOB Rey Boyers"
"SOB Ron Osborn"
"SOB Roni Orbison" []
"SOB Tia Tobias" []
"SOB Tom Toombs"
"SOB Trey Boyster"
"SOB Ty Ostby"
"SOB, Well, Slob Lew Bellows" []
"Sod-Bile Seibold"
"Softest Fossett"
"Softie Dan DiStefano" []
"Softie Ren Firestone" []
"Sol 'Ranch' Charlson"
"Son 'Nah' Hanson" []
"Sona 'Fib' Bonifas"
"Sona 'Legs' Gonsales"
"Sona 'Ski' Isakson"
"Sonnet King Kensington"
"Soon 'Ski' Kissoon"
"'Soot' Soto"
"Sore [n-t] Senatore" []
"Sore Al LaRose" []
"Sore Alden Rosendale" []
"Sore Alva Arevalos" []
"Sore Ann Arenson" []
"Sore Art Serrato" []
"Sore Belle Bellerose"
"Sore Bland Balderson" []
"Sore Bong Borgeson"
"Sore Brad Debarros" []
"Sore Brock Rosebrock"
"Sore Carl Corrales" []
"Sore Chin Richeson" []
"Sore Dan Nodarse" []
"Sore Dan'l Alderson" []
"Sore Danna Andreason" []
"Sore Delinda DeLeonardis" []
"Sore Don Rosendo" []
"Sore Ed DeRose" []
"Sore Edris Desrosier" []
"Sore Emery Rosemeyer"
"Sore Erin Reierson"
"Sore Flo Roelofs"
"Sore Gena Ragonese" []
"Sore Gilma Margolies" []
"Sore Grant Garretson" []
"Sore Ham Ashmore" []
"Sore Hunt Southern" []
"Sore Ida Isadore" []
"Sore Isabel Labossiere" []
"Sore Kami Kisamore" []
"Sore Ken Erekson"
"Sore Kent Koestner"
"Sore Laci Cerasoli" []
"Sore Lan Salerno" []
"Sore Laurice Lacoursiere"
"Sore Lem Melrose" []
"Sore Lev Selover" []
"Sore Li Losier-Sorlie"
"Sore Linda Leonardis" []
"Sore Ling Gorsline-Solinger" []
"Sore Link Sloniker" []
"Sore Luca LaCourse" []
"Sore Man Masoner" []
"Sore Mertie Ostermeier" []
"Sore Mi Mosier" []
"Sore Min Romines"
"Sore Minta Sarmiento" []
"Sore Morton Monterroso"
"Sore My Smoyer"
"Sore Nat Orantes-Santore" []
"Sore Neff Efferson"
"Sore Nell Ellerson" []
"Sore Nick Erickson" []
"Sore Nilsa Israelson" []
"Sore Nob Osborne" []
"Sore Norah Roanhorse"
"Sore Old Dolores" []
"Sore Pat Pastore" []
"Sore Pauley LaPeyrouse"
"Sore Reid Derosier"
"Sore Ren Roesner"
"Sore Rena Reasoner" []
"Sore Ryann Rynearson"
"Sore Sal Rosales" []
"Sore Sam Mesaros"
"Sore Si Rossie" []
"Sore Star Serratos"
"Sore Su Rousse"
"Sore Tank Atkerson"
"Sore Terra Serratore"
"Sore Thu Souther" []
"Sore Tina Restaino" []
"Sore Torie Tesoriero"
"Sore Ty Oyster"
"Sore Una Rosenau"
"Sore Valda Salvadore" []
"Sore Vera Rosevear"
"Sore Verda Verderosa"
"Sore Verona Reasonover"
"Sore Vin Iverson" []
"Sore Vita Evaristo" []
"Sore Von Overson"
"Sore Wm Mowers" []
"Sot Tso"
"Sound-Mind Simon Nudd"
"Sour Alec Lacourse" []
"Sour Ed Souder"
"Sour Gale Salguero" []
"Sour Les Roussel" []
"Sour Man Mansour"
"Sour Sol Lorusso"
"Sour Thad Southard"
"Sourish Ross Hui"
"Spare-No-Persona Pearson" []
"Sparky Sy Karp"
"Spider Gengler Gindlesperger"
"Spider Tsang Springstead"
"Spider Van Pendarvis" []
"Spiker Perski"
"Spinout Pontius" []
"Spiritous Pistorius"
"Spook Sopko" []
"Squinty Nyquist"
"Staci 'Nah' Chastain"
"Stakin-Takins['] Atkins" []
"Stale Rap Palestra"
"Staley's Lysates"
"Stalker Starkel"
"Stalling Stan Gill" []
"Stammerin['] Rammstein"
"Star 'Nah' Strahan" []
"Staring Gastrin" []
"Staunch Stan Chu"
"Stealer Laertes" []
"Stealthy Hayslett"
"Stern-Lie Eli Ernst" []
"Stern Ogre Torgersen"
"Stickup Kip Cust"
"Sticky Sick Ty"
"Stinger Gestrin"
"Stingy Earl Singletary" []
"Stinker Sir Kent"
"Stinkeroo [if player is male]Oren Sitko[else]Rosi O'Kent[end if]"
"Stinky-Skin Ty"
"Stocky Ty Ocks"
"Stompnik Tompkins" []
"Stone Cold Ced Tolson" []
"Stone-Raw Waterson" []
"Stones-Rich Christeson Stroschein" []
"Storm 'Nah' Horstman" []
"Stormin['] Ron Smit"
"Storming Mort Sing" []
"Stormy 'My Sort' [if player is male]Mr. Yost[else]Ms. Troy[end if]" [p]
"Stout Ed Testudo"
"Striking Rik Ginst"
"Stud-Was-Wuss Tad" []
"Stumpy Stu Pym"
"Stypto-Spotty Ty Post" []
"Such-a-Jerk Jack Usher"
"Sulker Kusler"
"Sulky Devan Levandusky"
"Superficial [if player is male]Lupe Friscia[else]Felicia Spur[end if]"
"Sure Sal LaRusse"
"Sure-Suer Reus" []
"Swan 'Ski' Wassink"
"Swearin['] Waisner" []
"Swearing [if player is male]Geri Swan[else]Si Wagner[end if]" []
"Sweathog Stew Hoag"
"Sweating Gwen Tsai" []
"Sweating Inga West" []
"Swen-Ye-Weensy Sweeny"
"Swiggin['] Wiggins"
"Swinging Sig Gwinn"
"Swooner Rosenow"
"Sybarite [ta] Byers"
"Tacky KC Tay" []
"Talia 'Gun' Lantigua"
"Tama 'Gun' Tanguma"
"Tama 'Ski' Aksamit"
"Tana 'Ranch' Carnathan"
"Tank Kant"
"Tarnished [if player is male]Dean Hirst[else]Enid Stahr[end if]" []
"Tarnished Seth Randi"
"Tarnished Trish Dean"
"Tarsha 'Gun' Straughan"
"Tart Barb Barr-Batt" []
"Tasia 'Gun' Agustina"
"Taskin['] Atkins" []
"Tasteful Sue Flatt"
"Tat-Rube Taubert"
"Tax Evader Ava Dexter"
"Tea Slob Seabolt" []
"Teamster Matt Rees"
"Technocrat Coach Trent"
"Teflon-Net Flo Felton" []
"Ten-Vice Vicente"
"Tena 'Ski' Kienast"
"Tense Pro Peterson" []
"Tera 'Gun' Turnage-Turnage"
"Teri 'Gun' Guertin"
"Teri 'Legs' Striegel-Stiegler"
"Terra 'Gun' Guerrant"
"Terri 'Nah' Rinehart-Reinhart"
"Terrible Bert Iler"
"Testator-Attestor [if player is male]Art Totes[else]Tresa Ott[end if]"
"Tetchier Teichert" []
"Tetchy Chetty"
"Thea 'Gun' Hungate"
"Thick Art Kithcart"
"Thick Ed, the [dick-u]" []
"Thick Ewan Whitenack" []
"Thick Hoss Hotchkiss-Hotchkiss"
"Thick Leo Eickholt"
"Thick Mason Mackintosh" []
"Thick Mena Mckeithan"
"Thick Milnes Kleinschmit" []
"Thick Oren Cronkhite"
"Thick Orval Kratochvil"
"Thief Feith" []
"Thin Allen Tannehill" []
"Thin Amos Mathison" []
"Thin Ann Hinnant"
"Thin-Beard Derin Bhat"
"Thin Cree Chretien" []
"Thin Darell Litherland"
"Thin Earl Hartline" []
"Thin Elana Nathaniel" []
"Thin Greco Creighton" []
"Thin Hower Whitehorn"
"Thin Kong Knighton"
"Thin Lee Thielen"
"Thin Mae Heitman" []
"Thin Maw Whitman" []
"Thin Montag Nottingham"
"Thin Moss Smithson"
"Thin Narcisse Christiansen" []
"Thin Oleg Leighton" []
"Thin Olga Hotaling" []
"Thin Opal Oliphant" []
"Thin Oster Rothstein" []
"Thin Peg Thigpen" []
"Thin Rosa Hairston" []
"Thin Saul Shinault"
"Thinky Ty Kihn"
"Thor 'Nah' Hathorn"
"Thorg Groth"
"Three-Balls Herb Stella"
"Thrifty Ty Firth"
"Thumper Humpert"
"Tia 'Gun' Giunta-Guinta"
"Tie Snob Bo Stein" []
"Tight-End Ted Night"
"Timewaster [if player is male]Matt Weiser[else]Tamie Werst[end if]"
"Tin Brute Brunetti" []
"Tina 'Ranch' Tranchina"
"Tiny-Legs Stingley"
"Tire-Games Stegmaier"
"Tired-Gut Tut Ridge"
"Tisa 'Gun' Agustin"
"Toad Al Dolata"
"Toad Art Attardo"
"Toad Dion DiDonato" []
"Toad Ed Taddeo"
"Toad Graser Ostergaard" []
"Toad Isis DiStasio"
"Toad Lech Deloatch" []
"Toad Leon Toledano"
"Toad Nino Dantonio" []
"Toad Rhee Dorethea"
"Toad Rush Southard" []
"Toad Sol Stodola"
"Toad Su Daoust"
"Toad Vito D'Ottavio" []
"Tobin 'Sneer' Borenstein" []
"Tod 'Nah' Hadnot" []
"Toi 'Gun' Guinto-Guiton"
"Tolerant Tarleton" []
"Tom 'Chins' McIntosh"
"Tom 'Nah' Thoman" []
"Tomcat Cottam"
"Tomcat Mac Ott" []
"Tomi 'Gun' Guimont"
"Tona 'Legs' Stangelo"
"Tonda 'Legs' Gladstone"
"Toni 'Sneer' Orenstein" []
"Tonker Okrent"
"'Tonkings' Kingston"
"Tony 'Nah' Anthony"
"Too-BS Sot Bo" []
"Too-Cross Coot Ross"
"Too-Dark Rod Kato" []
"Too-Drunk Ron Dutko" []
"Too-Dumb Bo DuMot"
"Too-Evil Leo Voit"
"Too-Fancy Coy Afton"
"Too-Hard Hood Rat [d-t] Hora" []
"Too-Heavy Tova Hoye"
"Too-Hungry Thor Young"
"Too-Mad Tom Dao"
"Too-Nervy Tony Rove"
"Too-Nice Toni Coe"
"Too-Slick Otis Lock" []
"Too Tired Otto Reid" []
"Toolman Lomanto"
"Topeka Kat Poe" []
"Tori 'Gun' Guitron"
"Tormentor Norm Otter"
"Tortured Ruder Tot Rod Utter" []
"Tot Con Cotton"
"Totaler Loretta" []
"Touchy Ty Chou"
"Tough Berlin Lightbourne" []
"Tough Born Broughton" []
"Tough Cannon Connaughton"
"Tough Dyer Dougherty"
"Tough Esta Southgate"
"Tough Guy Ugg Touhy"
"Tough Han Haughton" []
"Tough Lan Laughton"
"Tough Ned Doughten"
"Tough Rod Thurgood"
"Tough Ron Roughton" []
"Tough Shar Hartsough"
"Tough-Skin Shogun Kit"
"Tough Starin['] Rottinghaus"
"Tough Wisher Housewright"
"Townish Whitson" []
"Trains Man Sanmartin"
"Tran 'Legs' Stangler"
"Tranquil Tariq Lun"
"Transitive, Revisitant [if player is male]Ivan Sitter[else]Vita Estrin[end if]"
"Treacly [if player is male]Carl Tye[else]Leta Cyr[end if]"
"Tree-Top Repetto"
"Trena 'Legs' Lestrange"
"Trevor 'Hands' Vanderhorst"
"Tricky Kit Cyr"
"'Triggers' Greg Rist"
"Trim Hot Tim Roth"
"Trim Ted Dittmer"
"Trina 'Legs' Lastinger"
"Trina 'Ski' Kristina"
"Troglodyte [if player is male]Goldy Otter[else]Dotty Lorge[end if]"
"Troubling Brit Luong"
"Trouncer Curt Reno"
"Trouncing Curington"
"Trucker Ruckert"
"Truster Surrett" []
"Twangier Weingart" []
"Tweedy Weed Ty" []
"Twisted Twit Des"
"Twisty-Wits Ty"
"Twit Ed DeWitt"
"Two-Bit Twit Bo" []
"Tyree Huong the Younger" []
"Tzaddik Kid Datz"
"Tzar Abe Tabarez"
"Tzar Alba Baltazar"
"Tzar Basilia Aristizabal"
"Tzar Bernie Barrientez"
"Tzar Cora Cortazar"
"Tzar Ed Dartez"
"Tzar Eli Altizer"
"Tzar Esh Shatzer"
"Tzar Eva Tavarez"
"Tzar Gil Garlitz"
"Tzar Lea Laterza"
"Tzar Les Stalzer"
"Tzar Man Zartman"
"Tzar Meg Metzgar"
"Tzar Mia Maritza"
"Tzar Min Ritzman"
"Tzar Monroe Monterroza"
"Tzar Noble Brazelton"
"Tzar Ona Tarazon"
"Tzar Sera Terrazas"
"Tzar Sher Shartzer"
"Tzar Skye Zaretsky"
"Tzar Sly Zylstra"
"Tzar Sol Stolarz"
"Uber-Fat Faubert"
"Uber-Sly Elsbury" []
"Uglier Reg Liu" []
"Ugly [n-t] Gaultney"
"Ugly Bacha Claybaugh"
"Ugly Dog Guy Gold"
"Ugly Hector Clougherty" []
"Ugly Lori Guillory"
"Ugly Mace Mcgauley" []
"Ugly Rhea Laughery"
"Ula 'Hands' Lashunda"
"Ulcer-y Cuyler Curley" [p]
"Un-Drab Dunbar" []
"Un-Elated Deneault"
"Un-Fancy Nancy Fu"
"Un-Firm Murfin"
"Un-Freed Dufrene" []
"Un-Slim Sumlin"
"Un-Tricky Icky Runt, Nut Ricky"
"Una 'Legs' Lagunes"
"Unamenable [if player is male]Manuel Bean[else]LeeAnn Baum[end if]"
"Uncaring Cari Gunn"
"Uncool Con Lou"
"Uncool Luc Ono" []
"Under-Age Gene Radu" []
"Underbite Brute Enid"
"Unfeeling Glennie Fu"
"Unfriendly Lendin[']-Fury Rudie Flynn"
"Unglibly-Bullying Bill Yung"
"Unholy [if player is male]Lon Huy[else]Lyn Huo[end if]"
"Unkempt Nut Kemp"
"Unlabored Abdelnour" []
"Unloved [if player is male]Eldon Vu[else]Lu Devon[end if]"
"Unmarred Ruder Man Dane Murr"
"Unmovable [if player is male]LeVon Baum[else]Avon Blume[end if]"
"Unpleasant [if player is male]Nat Paulsen[else]Luann Pesta[end if]"
"Unready Daren Yu" []
"Unready Reynaud DuRaney" []
"Unsafe Sue Fan"
"Unsaved Dave Sun"
"Unsettling Glenn Titus"
"Unsocial [if player is male]Luis Cano[else]Sonia Luc[end if]" []
"Unwelcoming Luni McGowen"
"Unwieldy [if player is male]Delwin Yu[else]Wendy Liu[end if]" []
"Upland Dunlap"
"Ur-Rage Guerra"
"Uraemic Maurice" []
"Use Act Cuesta"
"Vain Alec Valencia" []
"Vain Arch Chavarin" []
"Vain Artis Arvanitis"
"Vain Celano Valenciano" []
"Vain Claud Advincula"
"Vain Clem Mcelvain-Mcinvale" []
"Vain Cosmo Osmanovic"
"Vain Dahl Haviland"
"Vain Del Ledvina" []
"Vain Della Villaneda" []
"Vain Elton Valentino" []
"Vain Gene Angevine"
"Vain Gino Giovanni"
"Vain Jock Jankovic"
"Vain Leo Avelino" []
"Vain Leora Valeriano" []
"Vain Lou Luviano"
"Vain Pok Pivonka"
"Vain Rick Vicknair"
"Vain Rog Gravino"
"Vain Rosa Savarino"
"Vain Rosell Villasenor" []
"Vain Sadie Avedisian"
"Vain Sera Arenivas"
"Vain Shawnta Viswanathan" []
"Vain Sly Sylv[if player is male]ain[else]ina[end if]" []
"Vain Sol Salvino" []
"Vain Tor Vitrano"
"Vain Tosha Stavinoha"
"Vain Yates Avetisyan"
"Val 'Ski' Slavik-Slivka"
"Valued Dave Lu" []
"Vapid Nola Vialpando" []
"Vapid Ona Padovani"
"Vaunter Ventura" []
"Velour Voleur Lu Rove" []
"Venita 'Legs' Evangelist"
"Verbal Vrabel"
"Verena 'Plod' Vanderpoel"
"Vermin Mervin Mivner" []
"Verna 'Plod' Vanderpol"
"Verona 'Plod' Vanderpool"
"Very Cool Cory Love"
"Very-Mean Everyman Evan Remy"
"Vi 'Legs' Selvig"
"Vi 'Sneer' Iversen" []
"Vibrant Del Vanderbilt" []
"Vidal 'Nah' Haviland" []
"Vigneron Novinger"
"Viler-Lot Tolliver"
"Villain Li'l Ivan" []
"Villainous [if player is male]Louis Alvin[else]Luna Silvio[end if]"
"Villainous Io Sullivan" []
"Violent [toti] Lev"
"Voiders Devisor [if player is male]Edris Vo[else]Vi Erdos[end if]"
"Volatile [if player is male]Al Violet[else]Iva Tolle[end if]"
"Wack-Dish Shadwick" []
"Wack Job Jack Bow"
"Wade 'Sneer' Wandersee"
"Wan Lord Rowland" []
"Wan Toad Towanda"
"Wankish Nik Shaw-Hawkins"
"Want-Home Mo Wathen" []
"Warmer Mr. Ware"
"Warney Yawner Ray Wen"
"Warped Drew 'Pa' Pardew"
"Warty Raw Ty"
"Warzone Zorwena" []
"Was-Nerd Andrews Swander" []
"Was-True Wauters"
"Waster Rat Wes" []
"Way Fair Waif Ray"
"Weakling Gale Wink" []
"Wealthy Whatley" []
"Weaseling [if player is male]Galen[else]Angel[end if] Wise"
"Weaseling [if player is male]Lewis Egan[else]Elise Wang[end if]" []
"Webb of Few Bob"
"Wee Nik Weinke"
"Weird Fleta Waterfield" []
"Well-Born Brownell" []
"Well-Knit Will Kent"
"Well Ned Wendell" []
"Well-to-Do Lewd Tool Leo Woldt"
"Wendee Weeden" []
"Wes 'Ranch' Crenshaw"
"West Side Ted Weiss"
"Wet Hit Hewitt"
"Whale LaHew"
"Whap-a-Ton Powhatan"
"Whapping Pip Hwang"
"Wheedler Ed Wehrle"
"Wheedler-Heel Drew" []
"Whomper Morphew"
"Wilson 'Ski' Slowinski"
"Winded Dedwin"
"Winker Kerwin"
"Winker Wrekin"
"Wired Alf Warfield" []
"Wired Amy Widmayer"
"Wired Gay Ridgeway"
"Wired Genna Winegarden"
"Wired Inge Weidinger"
"Wired Lan Reinwald" []
"Wolf Darling Wallingford" []
"Wolf Dodie Woodfield"
"Wolf Les Fellows" []
"Wolf Rebel Belflower"
"Wolf Red Welford" []
"Wolf Reid Wilfredo" []
"Wolf Tran Fornwalt"
"Worm Cell Cromwell"
"Wormer Merrow"
"Wormy Wry Mo"
"Worn Ed Wredon" []
"Worried or Wired Rio Drew" []
"Worsening Niswonger" []
"Worst Cathie Crosthwaite"
"Worst Cree Worcester"
"Worst Haley Aylesworth" []
"Worst Hiram Arrowsmith"
"Worst Honey Noseworthy"
"Worst Kim Wikstrom"
"Worst Kina Tarnowski" []
"Worst Kobe Westbrook"
"Worst Leah Showalter" []
"Worst Lu Truslow"
"Worst Mick Wickstrom"
"Worst Rheba Robertshaw"
"Worst Tena Watterson" []
"Worsted Rod West"
"'Wrath' Warth"
"Wrathful Walt Fuhr"
"Wrekin Winker Nik Rew" []
"Wuss-Like Sulewski"
"X-Raying Gary Nix"
"Yakima Mia Kay"
"Ye Con Coyne"
"Yeasty Yatesy"
"Yen-Led Len Dey" []
"Yen Lord Dreylon Reynold-Londrey" []
"Yesnik Kinsey"
"Yobling Bony Gil" []
"Yobnik Boykin"
"Yodeler Delorey" []
"Younger NY Rogue Guy Oren" []
"Zeroing Ozinger"
"Zia 'Gun' Zuniga"
"Zia 'Legs' Szeliga"
"Zoe 'Gun' Noguez"
"Zoe 'Plod' Delpozo"
"Zona 'Legs' Gonzales"
"Zoo-Call Collazo"
"Zoo-Land D'Alonzo"
"Zooming Mozingo"

table of prestigious bums [xxv8]
blurb
"The Abe Bethea"
"Abel 'Yes' Beasley"
"Ace Alden Encalade"
"Ace Ali Alicea"
"Ace Alton Anacleto"
"Ace Alvin Valencia" []
"Ace Arlinda Candelaria" []
"Ace Arvilla Ciavarella"
"Ace Avril Cavalier" []
"Ace Barr Cabrera-Barreca"
"Ace Brasil Cabriales"
"Ace Brinson Bernasconi" []
"Ace Carmon Maccarone"
"Ace Codi Caicedo"
"Ace Dan Cadena"
"Ace Darin Adriance" []
"Ace Darrin Carradine" []
"Ace Dirk Radecki" []
"Ace Don Deacon"
"Ace Dove Acevedo"
"Ace Edris Dicesare"
"Ace Elvira Cavaliere" []
"Ace Errol Correale"
"Ace Flo Cefalo"
"Ace Grisel Gilcrease" []
"Ace Harold Delarocha"
"Ace Hines Chianese" []
"Ace Hunt Cauthen"
"Ace Hurst Tauscher" []
"Ace Ines Necaise" []
"Ace Inger Carnegie" []
"Ace Isis Caissie"
"Ace Jin Janice"
"Ace Kemp Mcpeake"
"Ace Kim Mackie" []
"Ace Klos Sealock"
"Ace Kyler Ackerley" []
"Ace Kym Mackey"
"Ace Lan Canale-Canela"
"Ace Laurent Laracuente" []
"Ace Lavern Carnevale" []
"Ace Lida Alcaide"
"Ace Lin Celani" []
"Ace Lon Celano"
"Ace Lorinda Candelario" []
"Ace Loris Cerasoli" []
"Ace Luba Beaulac"
"Ace Luz Uzelac"
"Ace Ly Lacey-Caley" []
"Ace Mark Amacker"
"Ace Marna Camarena" []
"Ace Min Mencia"
"Ace Ming Cangemi"
"Ace Minh Eichman" []
"Ace Minor Caminero" []
"Ace Moll Comella"
"Ace Myrl Mcleary" []
"Ace Nat Catena"
"Ace Ned Decena-Candee" []
"Ace Ness Senesac" []
"Ace Orr Correa"
"Ace Otis Estacio"
"Ace Ramon Macareno" []
"Ace Rana Aracena"
"Ace Reid Decaire"
"Ace Rhett Charette"
"Ace Rich Recchia"
"Ace Rod Decaro" []
"Ace Rolf Laforce"
"Ace Ron Nocera"
"Ace Ronald Colandrea" []
"Ace Roni Acierno"
"Ace Ros Coreas-Cesaro" []
"Ace Rosen Escareno" []
"Ace Rosi Cesario"
"Ace Rush Schauer-Schauer"
"Ace Ruth Taucher"
"Ace Sal Casale"
"Ace Shon Acheson" []
"Ace Sloan Escalona"
"Ace Son Escano"
"Ace Stan Scatena"
"Ace Star Caserta"
"Ace Tona Caetano"
"Ace Toni Atencio" []
"Ace Tony Coatney"
"Ace Tonya Cayetano"
"Ace Tran Cantera" []
"Ace Ty Tacey"
"Ace Vaughn Cavenaugh"
"The Adams Steadham" []
"Al 'Top' Plato" []
"Al 'Yep' Paley"
"Al 'Yes' Sealy"
"The Al Leath"
"Alana 'Top' Patalano"
"Alden 'FBI' Banfield" []
"Alec 'Hup' Plauche"
"Alf 'Hup' Pufahl"
"Alf 'Yes' Safley"
"Ali 'Top' Pilato"
"Aline 'Top' Lapointe" []
"The Alma Leatham"
"Alton 'Buy' Labounty" []
"Amb. [n-t] Bateman"
"Amb. Chae Beacham"
"Amb. Chan Bachman"
"Amb. Chandler Chamberland"
"Amb. Charline Chamberlain" []
"Amb. Cher Chamber" []
"Amb. Chun Buchman" []
"Amb. Cole Lacombe"
"Amb. Comer Macomber"
"Amb. Daron Boardman" []
"Amb. Earl Marable" []
"Amb. Ena Beaman" []
"Amb. Erin Bierman" []
"Amb. Erinn Biermann"
"Amb. Erline Lieberman"
"Amb. Gino Gambino"
"Amb. Hearn Haberman" []
"Amb. Huang Baughman" []
"Amb. Jenni Benjamin"
"Amb. Kern Berkman"
"Amb. Laura Arambula"
"Amb. Leech Chamblee"
"Amb. Ling Gamblin"
"Amb. Linh Hamblin"
"Amb. Lon Malbon"
"Amb. Lyle Bellamy" []
"Amb. Ned Debnam" []
"Amb. Nell Bellman"
"Amb. Noe Beamon" []
"Amb. Rene Beerman"
"Amb. Rey Mabrey" []
"Amb. Ron Broman" []
"Amb. Rubin Birnbaum" []
"Amb. Sarah Abrahams" []
"Amb. Sha Basham"
"Amb. Tona Boatman"
"Amb. Tyler Tremblay" []
"Amb. Una Bauman"
"Amb. Zeno Bozeman"
"Ana 'FBI' Fabian"
"Ann 'Buy' Bunyan" []
"Ann 'Top' Panton"
"Anna 'Top' Pantano"
"Aron 'Yes' Reynosa"
"Arron 'Buy' Raybourn"
"Art 'Yep' Tarpey"
"Art 'Yes' Stayer"
"Atty. Bree Attebery" []
"Atty. Lesh Hayslett" []
"Atty. Pew Pettway"
"Awesome Don Woodmansee"
"The Barney Abernethy" []
"Bert 'Yes' Seybert"
"Big Abe Gebbia"
"Big Aron Nobriga"
"Big Ayana Agbayani"
"Big Brad Gibbard"
"Big Brandie Bainbridge"
"Big Caren Brigance" []
"Big Chanell Lingelbach"
"Big Chloe Cobleigh"
"Big Darin Brigandi" []
"Big Deon Boeding"
"Big Earle Gabriele"
"Big Ebony Gibboney"
"Big Efren Fineberg" []
"Big Eli Liebig"
"Big Erinn Breining"
"Big Erma Brimage" []
"Big Ernest Steinberg" []
"Big Lee Geibel"
"Big Len Ebling-Bingle" []
"Big Lenard Baldinger" []
"Big Leona Belongia"
"Big Lon Boling" []
"Big Loren Oblinger" []
"Big Mara Giambra"
"Big Nell Belling"
"Big Nick Bicking"
"Big Ola Baglio"
"Big Ora Borgia-Abrigo"
"Big Oren Gerbino"
"Big Orlando Longobardi" []
"Big Remona Giambrone"
"Big Rena Binegar" []
"Big Rene Ebinger"
"Big Rhea Habiger-Bagheri"
"Big Ron Grobin" []
"Big Shaunte Stinebaugh" []
"Big Trena Brigante" []
"Big Trina Briganti"
"Bold Abram Labombard"
"Bold Ali Badillo"
"Bold Ann Blandon"
"Bold Ara Labrado" []
"Bold Chet Bechtold" []
"Bold Eli Leibold-Dibello"
"Bold Farris Brailsford"
"Bold Fran Blanford"
"Bold Ian Baldoni"
"Bold Inger Olberding" []
"Bold Irma Lombardi" []
"Bold Lee Debello"
"Bold Len Leblond"
"Bold Lew Bodwell"
"Bold Loree Rebolledo" []
"Bold Maglione Bloomingdale"
"Bold Maw Wambold"
"Bold Nell Blondell"
"Bold Nina Blandino"
"Bold Omar Lombardo" []
"Bold Rae Laborde-Belardo" []
"Bold Ray Bolyard" []
"Bold Raye Boardley" []
"Bold Reeve Breedlove"
"Bold Regena Baldenegro" []
"Bold Rena Rabenold" []
"Bold Rene Bolender" []
"Bold Rey Bordley"
"Bold Roe Robledo" []
"Bold Skidmore Middlebrooks"
"Bold Uyeda Doubleday"
"Bold Yan Boyland" []
"Born-Leader Oberlander" []
"Boss Aura Bourassa"
"Brain Asa Sanabria"
"Brain Cole Claiborne"
"Brain Doren Bernardino" []
"Brain Ester Barrientes" []
"Brain Lem Liberman"
"Brain Lott Albritton"
"Brain Mchale Chamberlain" []
"Brain Oster Barrientos" []
"Brant 'Yes' Stanbery"
"Breana 'Top' Bonaparte" []
"Burl 'Yes' Elsbury"
"The Burl Hulbert"
"Busy Hwa Bushway" []
"Busy Wert Westbury"
"Cal 'Yep' Capley"
"Cal 'Yes' Claeys"
"Callie 'Top' Capetillo"
"The Capra Capehart" []
"Caren 'Hup' Uncapher"
"Caren 'Top' Caperton" []
"The Carlson Charleston" []
"The Carri Chartier" []
"Celinda 'Hup' Duplechain"
"CEO Ard Decaro" []
"CEO Arlinda Candelario" []
"CEO Arp Pecora"
"CEO Asha Saechao"
"CEO Audet Decoteau"
"CEO Auger Oceguera" []
"CEO Ball Cabello"
"CEO Balls Ceballos" []
"CEO Barr Bracero"
"CEO Blohm Holcombe"
"CEO Burk Roebuck"
"CEO Carl Alcocer"
"CEO Chi Choice" []
"CEO Chmura Carmouche"
"CEO Dahl Deloach" []
"CEO Dan Deacon" []
"CEO Darst Decastro" []
"CEO Dave Acevedo" []
"CEO Denker Eckenrode"
"CEO Dorr Cordero" []
"CEO Fredi Federico" []
"CEO Glover Colegrove"
"CEO Hack Heacock"
"CEO Hans Acheson" []
"CEO Herd Deroche"
"CEO Hinkle Kincheloe" []
"CEO Hol Coelho"
"CEO Hutt Touchet" []
"CEO Karns Ackerson" []
"CEO Krall Locklear"
"CEO Kremer Creekmore"
"CEO Kyla Coakley"
"CEO Lamb Lacombe" []
"CEO Lenard Calderone" []
"CEO Loy Cooley" []
"CEO Ly Coyle" []
"CEO Lyn Conley" []
"CEO Myrl Mcelroy-Mcleroy"
"CEO Ned Cedeno"
"CEO Nott Cottone"
"CEO Ok Cooke"
"CEO Pan Capone" []
"CEO Rand Cardone"
"CEO Sina Asencio" []
"CEO Siu Soucie"
"CEO Stoll Costello" []
"CEO Suda Saucedo"
"CEO Suder Escudero"
"CEO Sy Cosey"
"CEO Ta Catoe"
"CEO Tina Atencio" []
"CEO Tran Cantero" []
"CEO Trent Cornette"
"CEO Trinh Tichenor" []
"CEO Tu Cueto"
"CEO Un Cuneo"
"CEO Ute Coutee"
"CEO Vanish Schiavone" []
"CEO Vella Lovelace"
"CEO Yon Cooney" []
"CEO Yu Couey"
"CEO Yun Younce"
"Cesar 'Hup' Purchase"
"CFO Alina Califano"
"CFO Andre Defranco" []
"CFO Ara Cafaro"
"CFO Arie Cafiero" []
"CFO Arlen Falconer-Florance" []
"CFO Arline Fernicola" []
"CFO Arn Franco"
"CFO Art Factor"
"CFO Baine Boniface"
"CFO Brant Bancroft"
"CFO Cai Fiacco"
"CFO Carnes Francesco"
"CFO Dale Defalco" []
"CFO Darin Difranco"
"CFO Derk Eckford" []
"CFO Dormer Comerford"
"CFO Dyer Fordyce" []
"CFO Earl Laforce" []
"CFO Ebert Beecroft"
"CFO Elinor Florencio" []
"CFO Erie Orefice"
"CFO Erika Kiracofe" []
"CFO Evita Fivecoat"
"CFO Fey Coffey"
"CFO Fidel Coffield" []
"CFO Finn Conniff"
"CFO Frink Finfrock"
"CFO Irma Formica"
"CFO Lauren Faulconer" []
"CFO Lea Cefalo" []
"CFO Leman Flamenco" []
"CFO Lida Difalco"
"CFO Lina Falconi"
"CFO Linares Lefrancois" []
"CFO Linder Cornfield" []
"CFO Lord Colford"
"CFO Lu Fulco"
"CFO Luna Faulcon"
"CFO Mort Comfort"
"CFO Neal Falcone"
"CFO Peter Perfecto"
"CFO Ragan Carfagno"
"CFO Rains Francois"
"CFO Reider Frederico"
"CFO Ren Confer"
"CFO Rina Fricano"
"CFO Rundle Lunceford" []
"CFO Sean Fonseca" []
"CFO Serna Scarfone"
"CFO Shani Schifano"
"CFO Shelden Schoenfeld"
"CFO Stahr Ashcroft"
"CFO Su Fusco"
"CFO Tamala Catalfamo"
"CFO Thu Foutch"
"CFO Torry Roycroft"
"CFO Tran Crafton"
"CFO Worth Howcroft"
"Champ Al Clapham"
"Champ Ali Macphail"
"Champ Soren MacPherson" []
"Cherish 'Top' Christophe" []
"CIO Adler Cordelia" []
"CIO Alden Caliendo" []
"CIO Angela Giacalone"
"CIO Angeles Coglianese"
"CIO Angla Giancola"
"CIO Ann Canion"
"CIO Arlen Naclerio" []
"CIO Bran Carboni"
"CIO Cade Caicedo" []
"CIO Cain Ciancio"
"CIO Cal Calico"
"CIO Caren Carcione" []
"CIO Cari Ciriaco"
"CIO Carmina Marinaccio"
"CIO Cesar Escorcia"
"CIO Cher Cherico"
"CIO Chick Cichocki"
"CIO Connie Inocencio"
"CIO Cuc Cuccio"
"CIO Damen Domenica" []
"CIO Dan Donica" []
"CIO Danks Dickason" []
"CIO Dell Cedillo" []
"CIO Drema Mordecai" []
"CIO Ellman Monacelli" []
"CIO Elvina Olivencia"
"CIO Esta Estacio" []
"CIO Esther Oestreich"
"CIO Floren Florencio" []
"CIO Fran Fricano" []
"CIO Gilson Consiglio"
"CIO Gina Ignacio"
"CIO Hans Cashion-Schiano" []
"CIO Hart Torchia"
"CIO Heiner Choiniere"
"CIO Herman Marchione"
"CIO Hung Noguchi"
"CIO Islam Mascioli"
"CIO Kash Sachiko"
"CIO Kerns Erickson" []
"CIO Kirk Rokicki"
"CIO Le Coile-Celio-Cielo"
"CIO Leandra Candelario" []
"CIO Len Nicole"
"CIO Lin Nicoli"
"CIO Lina Nicolai"
"CIO Linda DiNicola" []
"CIO Link Nikolic"
"CIO Lis Scioli"
"CIO Logan Cogliano" []
"CIO Lon Nicolo"
"CIO Long Cooling" []
"CIO Loren Cornelio" []
"CIO Luna Luciano"
"CIO Luther Clouthier" []
"CIO Mac Moccia"
"CIO Mara Macario"
"CIO Maren Caminero" []
"CIO Maris Casimiro"
"CIO Marlen Marcelino" []
"CIO Marna Marciano" []
"CIO Miller Cimorelli"
"CIO Muller Cullimore" []
"CIO Myrl McIlroy"
"CIO Nat Catino"
"CIO Ned Condie" []
"CIO Nicola Cianciolo"
"CIO Nyla Nicolay"
"CIO Olin Ciolino"
"CIO Ona Iacono"
"CIO Pat Capito"
"CIO Rambo Ambrocio" []
"CIO Rand Conradi" []
"CIO Raul Ciraulo"
"CIO Red D'Erico" []
"CIO Ren Cirone-Enrico" []
"CIO Rena Acierno" []
"CIO Rich Chirico"
"CIO Riva Vicario"
"CIO Rotter Tortorice"
"CIO Rust Turcios" []
"CIO Sadler DeCarolis" []
"CIO Sam Mascio"
"CIO Saran Saracino" []
"CIO Sean Asencio" []
"CIO Shanti Aitchison"
"CIO Shaun Chiusano"
"CIO Shelman Michaelson" []
"CIO Sina Nicasio"
"CIO Sol Colosi" []
"CIO Stanton Costantino"
"CIO Sue Soucie" []
"CIO Sugar Guarisco" []
"CIO Super Precious" []
"CIO Taran Catarino" []
"CIO Tarrance Terracciano"
"CIO Tarvin Victorian" []
"CIO Tena Atencio" []
"CIO Tom Comito"
"CIO Tova Octavio"
"CIO Tran Cortina-Nicotra-Cintora"
"CIO Trena Caterino" []
"CIO Trude Coudriet" []
"CIO Vallie Iacovelli"
"CIO Verna Veronica" []
"CIO Vince Vicencio"
"CIO Von Covino"
"CIO Wink Nowicki"
"The Clay Atchley" []
"Cmdr. Alec Mccardle"
"Cmdr. Beale Delcambre"
"Cmdr. Bey Mcbryde"
"Cmdr. Gay Mcgrady"
"Cmdr. Hana Marchand"
"Cmdr. Kenia Dickerman" []
"Cmdr. Kuo Murdock" []
"Cmdr. Lea Mcardle" []
"Cmdr. Mona Mcdorman"
"Cmdr. Neoma Commander" []
"Cmdr. Yao Mcadory" []
"Coach Al Cachola"
"Coach Carin Cornacchia"
"Coach Lan Canchola"
"Coach Ma Camacho"
"Coach Myna McConahay"
"Coach Myung McConaughy"
"Coach Rod Corchado"
"Col. Abel Cabello" []
"Col. Ada Aldaco"
"Col. Adriane Candelario" []
"Col. Aldo Collado" []
"Col. Alva Cavallo"
"Col. Andre Calderon" []
"Col. Angelo Colangelo" []
"Col. Barney Clayborne" []
"Col. Beam Lacombe" []
"Col. Bert Colbert"
"Col. Bertha Batchelor" []
"Col. Beth Bechtol"
"Col. Bryan Clayborn" []
"Col. Bud Bolduc"
"Col. Cara Larocca"
"Col. Chana Canchola" []
"Col. Cora Larocco"
"Col. Diego Coolidge"
"Col. Ed Dolce" []
"Col. Edwardo Calderwood" []
"Col. Efren Florence" []
"Col. Eli Collie"
"Col. Ella Colella"
"Col. Elvis Scoville"
"Col. Emmer McLemore"
"Col. Eryn Conerly"
"Col. Esta Lacoste" []
"Col. Gaines Cangelosi" []
"Col. Herb Blocher"
"Col. Hines Nicholes"
"Col. Huang Coughlan"
"Col. Ian Nicola" []
"Col. Kaye Coakley" []
"Col. Ken Conkle"
"Col. Key Cokley"
"Col. Lanny Connally"
"Col. Lenny Connelly"
"Col. Leo Coello"
"Col. Linn Lincoln"
"Col. Lora Carollo"
"Col. Meggan Mcgonagle"
"Col. Mila Mollica"
"Col. Nilsa Callison"
"Col. Noah Calhoon" []
"Col. Raina Carolina"
"Col. Rana Alarcon-Carolan"
"Col. Ray Caylor"
"Col. Regan Longacre" []
"Col. Rhea Laroche" []
"Col. Rina Carlino" []
"Col. Sade Salcedo" []
"Col. Shani Nicholas" []
"Col. Sue Clouse"
"Col. Tessa Costales"
"Col. Theda Deloatch" []
"Col. Tiara Talarico"
"Col. Trena Carleton" []
"Col. Tyra Claytor" []
"Col. Watt Walcott"
"Col. Zola Collazo"
"Dale 'Yes' Elsayed"
"Dan 'Yep' Pandey"
"The Darrin Reinhardt" []
"DDS Angie Sandidge" []
"DDS Earl Saddler" []
"DDS Gena Gadsden"
"DDS Gia Gaddis"
"DDS Inge Giddens-Eddings"
"DDS Iona Addison" []
"DDS Noe Seddon"
"DDS Regina Sandridge" []
"DDS Una Dundas"
"Dead Larson D'Alesandro" []
"Dead Laurel Lauderdale" []
"Dead Lavern Landaverde"
"Dead Luc Delduca"
"Dead Noor Aredondo" []
"Dead Ren Dearden" []
"Dead Rob Deboard"
"Dead Ron Denardo" []
"Dead Sol Soledad"
"Dean 'Top' Daponte" []
"Del 'Yep' Pedley"
"Del 'Yes' Seydel"
"Delores 'Yes' Delosreyes"
"Denver 'Top' Devenport" []
"Deon 'Buy' Beydoun"
"Derek 'Yes' Dekeyser"
"Diane 'Hup' Dauphine"
"Dina 'Top' Pintado" []
"Dir. Abe Beaird" []
"Dir. Al Laird" []
"Dir. Alec Cardiel" []
"Dir. Ana Adrian" []
"Dir. Argo Garrido" []
"Dir. Aron Riordan" []
"Dir. Ash Rashid" []
"Dir. Ben Binder" []
"Dir. Berg Bridger"
"Dir. Berna Brainerd" []
"Dir. Brianne Bernardini"
"Dir. Buck Burdick" []
"Dir. Cora Ricardo" []
"Dir. Del Riddle" []
"Dir. Dell Riddell" []
"Dir. Dick Riddick"
"Dir. Dona Dinardo" []
"Dir. Ely Ridley" []
"Dir. Ewen Weidner" []
"Dir. Fay Friday" []
"Dir. Fe Fried-Efird" []
"Dir. Gena Reading" []
"Dir. Gene Edinger" []
"Dir. Gilma Grimaldi" []
"Dir. Glen Grindle-Dingler"
"Dir. Glenn Lindgren"
"Dir. Gooch Goodrich"
"Dir. Green Redinger" []
"Dir. Guy Guidry"
"Dir. Hall Hillard"
"Dir. Inger Ridinger"
"Dir. Jean Jardine" []
"Dir. Keach Headrick"
"Dir. Ken Kinder" []
"Dir. Lang Darling" []
"Dir. Langton Darlington" []
"Dir. Lee Riedel" []
"Dir. Len Linder"
"Dir. Leo Delrio" []
"Dir. Lew Wilder" []
"Dir. Lina Rinaldi" []
"Dir. Loma Milardo" []
"Dir. Lon Ridlon"
"Dir. Mae Merida" []
"Dir. Man Minard"
"Dir. Mana Miranda" []
"Dir. Matt Dittmar" []
"Dir. McKean Dickerman" []
"Dir. Mee Diemer" []
"Dir. Myna Minyard" []
"Dir. Neal Ireland" []
"Dir. Ned Reddin"
"Dir. Nigel Dreiling"
"Dir. Nola Orlandi" []
"Dir. Olga Giraldo"
"Dir. Reba Berardi" []
"Dir. Red Ridder"
"Dir. Regan Gardiner" []
"Dir. Rolfe Reliford" []
"Dir. Ros Dorris"
"Dir. Sam Simard" []
"Dir. Sana Sardina" []
"Dir. Schenk Hendricks" []
"Dir. Shane Sheridan" []
"Dir. Shona Hardison" []
"Dir. Sina Siniard" []
"Dir. Snow Windsor" []
"Dir. Stefan Standifer" []
"Dir. Wen Widner" []
"Dir. Wes Swider"
"Dir. Wolf Wilford" []
"Dir. Yang Ginyard" []
"Dir. Zoe Dozier"
"Doer Al Laredo" []
"Doer Alba Arboleda" []
"Doer Ali Deloria" []
"Doer Alma Delamora" []
"Doer Amber Beardmore"
"Doer Ash Rhoades"
"Doer Bess Debrosse"
"Doer Brandi DiBernardo" []
"Doer Brian Berardino" []
"Doer Cami Mordecai" []
"Doer Cher Derocher"
"Doer Cyr Cordrey"
"Doer Dan Denardo" []
"Doer Danilo Dileonardo" []
"Doer Daron Arredondo" []
"Doer Don Redondo" []
"Doer Ely Delorey" []
"Doer Fran Ferrando"
"Doer Geri Roediger" []
"Doer Glen Delnegro" []
"Doer Hoyt O'Doherty" []
"Doer Inez Derienzo"
"Doer Isa Derosia" []
"Doer Lan Leandro" []
"Doer Lance Calderone" []
"Doer Lea Deloera" []
"Doer Len Delnero" []
"Doer Li Delrio" []
"Doer Lina Andreoli" []
"Doer Ling Dolinger" []
"Doer Linh Reinhold"
"Doer Liza Elizardo" []
"Doer Lyn Reynold" []
"Doer Man Medrano" []
"Doer Mel Delmore"
"Doer Mia Demario"
"Doer Mina Demarino" []
"Doer Nilsa Leonardis" []
"Doer Nina Andreoni" []
"Doer Noah Nearhood" []
"Doer Nola Leonardo" []
"Doer Pam Padmore"
"Doer Paz Pedroza"
"Doer Rico Cordeiro"
"Doer Sam Meadors-Derasmo" []
"Doer Sol Dolores" []
"Doer Stan Dorantes"
"Doer Su Souder" []
"Doer Tab Bretado" []
"Doer Tim Tidmore" []
"Doer Tuan Tondreau" []
"Doer Una Rondeau" []
"Doer Val Velardo-Velador" []
"Doer Zina Darienzo" []
"Don 'Buy' Boundy"
"Dorla 'Top' Dalporto"
"The Dorla Aderholt" []
"The Dory Doherty" []
"Earl 'Top' Platero-Portela" []
"Ed 'Buy' Dubey"
"Eden 'Top' Deponte" []
"Elana 'Top' Pantaleo"
"Eli 'Buy' Bilyeu" []
"Eli 'Top' Polite" []
"Eli 'Yes' Leisey"
"The Eli Thiele"
"Elite Drew Detweiler"
"Elite Zahn Hazeltine"
"Elli 'Top' Petillo"
"Elmo 'Yes' Moseley"
"Elsa 'Yep' Peasley"
"Elva 'Yes' Veasley"
"Ender 'Buy' DeBruyne"
"Eneida 'Hup' Dauphinee"
"Enid 'Top' Depinto" []
"Eric 'Yep' Piercey"
"Erik 'Yes' Keirsey"
"Erin 'Top' Petroni" []
"Ernest 'Top' Petterson" []
"The Erwin Whitener"
"Esq. Lui Quiles"
"Esq. Mauro Mosquera" []
"Esq. Paula Pasquale"
"Esq. Raul Quarles"
"Etta 'Yep' Payette"
"Eva 'Yep' Peavey"
"Eva 'Yes' Veasey"
"Eve 'Top' Peveto"
"Ewen 'Yes' Sweeney"
"Exalted Tex Dale"
"Fear-CIO Cafiero" []
"Gala 'Hup' Alpaugh"
"The Gary Hagerty-Hegarty" []
"Gen. Al Lange-Nagle" []
"Gen. Aldo Dangelo" []
"Gen. Ali Eaglin" []
"Gen. Alta Galante" []
"Gen. Alvi Lavigne" []
"Gen. Alvin Langevin" []
"Gen. Ara Reagan" []
"Gen. Art Garten" []
"Gen. Astrid Grinstead" []
"Gen. Aura Garneau" []
"Gen. Azure Zerangue"
"Gen. Bart Bangert" []
"Gen. Bo Bogen" []
"Gen. Bristol Gilbertson" []
"Gen. Carlo Longacre" []
"Gen. Chu Cheung"
"Gen. Dahl Hegland"
"Gen. Dan Degnan" []
"Gen. Delisa Deangelis" []
"Gen. Dona Donegan" []
"Gen. Dori Doering" []
"Gen. Dorian Digennaro" []
"Gen. Dorn Gendron"
"Gen. Ed Degen"
"Gen. Eda Deegan" []
"Gen. Elke Engelke"
"Gen. Elsa Angeles" []
"Gen. Erica Carnegie" []
"Gen. Inger Greening"
"Gen. Ira Gainer" []
"Gen. Irma Germain" []
"Gen. Irwin Wininger" []
"Gen. Isa Gaines" []
"Gen. Karri Kerrigan" []
"Gen. Kati Keating" []
"Gen. Keli Keeling" []
"Gen. Kitson Stoneking" []
"Gen. Le Engel-Engle"
"Gen. Lea Neagle" []
"Gen. Lenita Galentine" []
"Gen. Les Engles-Engels" []
"Gen. Lila Gallien" []
"Gen. Lis Ingles" []
"Gen. Lisa Gelinas-Sinegal" []
"Gen. Liston Singleton" []
"Gen. Lora Lagrone" []
"Gen. Lori Olinger" []
"Gen. Lorna Lonergan" []
"Gen. Lu Leung" []
"Gen. Lyda Gladney" []
"Gen. Lyla Langley" []
"Gen. Mahan Hagemann" []
"Gen. Man Engman" []
"Gen. Marc Mcgrane" []
"Gen. Maren Greenman" []
"Gen. Mary Germany" []
"Gen. Mast Stegman"
"Gen. Mel Mengel" []
"Gen. Miller Mellinger" []
"Gen. Miss Messing" []
"Gen. Nat Tengan"
"Gen. Ninfa Finnegan"
"Gen. Odis Godines" []
"Gen. Ola Angelo" []
"Gen. Ora Orange" []
"Gen. Piper Eppinger" []
"Gen. Rae Gerena" []
"Gen. Ray Graney-Garney" []
"Gen. Raye Greaney"
"Gen. Reid Deering-Edinger" []
"Gen. Rhea Henegar" []
"Gen. Rhoda Hagedorn" []
"Gen. Rider Redinger" []
"Gen. Rob Borgen-Bogner" []
"Gen. Rod Gorden" []
"Gen. Rolf Lofgren" []
"Gen. Ron Negron"
"Gen. Root Ortegon"
"Gen. Rose Greeson" []
"Gen. Roy Gorney" []
"Gen. Rubi Breunig" []
"Gen. Rubin Bruening" []
"Gen. Ruth Gunther" []
"Gen. Salo Gleason" []
"Gen. Sam Manges" []
"Gen. Seth Hentges" []
"Gen. Sid Dinges" []
"Gen. Star Stanger" []
"Gen. Steiner Greenstein"
"Gen. Storm Engstrom"
"Gen. Stotler Longstreet" []
"Gen. Sui Seguin" []
"Gen. Talbert Greenblatt" []
"Gen. Terra Gaertner" []
"Gen. Twyla Gwaltney" []
"Gen. Ula Naugle"
"Gen. Verla Lavergne" []
"Gen. Vi Given"
"Gen. Walter Greenwalt" []
"Gen. Wardle Greenwald" []
"Gen. Will Welling" []
"Gen. Yao Gonyea" []
"Gen. Yu Yeung"
"Gen. Yun Nguyen" []
"Gertie 'Top' Potteiger"
"Gil 'Yes' Sigley"
"Gina 'Top' Pignato"
"Gov. Brush Vosburgh"
"Gov. Corse Cosgrove"
"Gov. Darren Vangorder" []
"Gov. Ena Genova"
"Gov. Lin Loving" []
"Gov. Neese Genovese"
"Gov. Re Grove"
"Gov. Risa Gravois"
"Gov. Rosner Grosvenor"
"Gov. Rude Verdugo" []
"Gov. Sigala Salvaggio"
"Great Barnum Baumgartner" []
"Great Eden Teegarden"
"Great Hui Gauthier"
"Great Hurst Straughter"
"Great Hy Hegarty" []
"Great Lehn Englehart" []
"Great Mia Armitage" []
"Great Niles Easterling" []
"Great Rhea Gearheart"
"Great Salmon Mastrangelo" []
"Hair Snob Harbison" []
"Hal 'Yes' Ashley"
"Ham 'Yes' Haymes"
"The Harley Heatherly"
"Hero Amy Haymore"
"Hero Ben Boehner"
"Hero Borski Brookshier"
"Hero Cal LaRoche" []
"Hero Charl Horlacher"
"Hero Dann Hernando" []
"Hero Debnam Bodenhamer" []
"Hero Dona Nearhood" []
"Hero Drew Rohweder"
"Hero Elk Koehler"
"Hero Emil Lohmeier"
"Hero Fred Hereford"
"Hero Gill Golliher"
"Hero Iverson Risenhoover"
"Hero Lew Woehler"
"Hero Ling Ohlinger"
"Hero Lise Olheiser"
"Hero Luca Larouche" []
"Hero Mart Mehrotra"
"Hero Meda Morehead"
"Hero Mikel Kohlmeier"
"Hero Ming Moehring" []
"Hero Mister Strohmeier" []
"Hero Neil Reinoehl"
"Hero Ren Hoerner"
"Hero Rich Roehrich"
"Hero Sam Ashmore" []
"Hero Scobee Cheeseboro"
"Hero Sid Doshier"
"Hero Sky Shorkey"
"Hero Sly Horsley" []
"Hero Su Houser"
"Hero Ty Yother" []
"Hero Van Hanover" []
"Hero Velma Hovermale"
"Hero Wambolt Bartholomew"
"Hon. Adler Leonhard" []
"Hon. Ann Hannon"
"Hon. Ardis Hardison" []
"Hon. Art Harton"
"Hon. Artis Hairston" []
"Hon. Atwell Lowenthal" []
"Hon. Bert Bohnert"
"Hon. Berta Rathbone" []
"Hon. Bo Bohon"
"Hon. Boan Bohanon"
"Hon. Bos Hobson" []
"Hon. Brack Hornback" []
"Hon. Buckler Hornbuckle"
"Hon. Burge Boughner"
"Hon. Cao Cahoon"
"Hon. Carr Charron"
"Hon. Case Acheson" []
"Hon. Casi Cashion" []
"Hon. Celis Nicholes" []
"Hon. Chiu Houchin"
"Hon. Cola Calhoon" []
"Hon. Cris Cornish"
"Hon. Dague Donaghue"
"Hon. Dalgleish Hollingshead"
"Hon. Dall Holland" []
"Hon. Damm Hammond"
"Hon. Darell Hollander" []
"Hon. Day Haydon"
"Hon. Del Holden"
"Hon. Delmar Holderman" []
"Hon. DeVries Devonshire"
"Hon. Edgar Hagedorn" []
"Hon. Ek Koehn"
"Hon. Elma Holeman" []
"Hon. Erb Bohner-Hebron"
"Hon. Eric Eichorn" []
"Hon. Erich Eichhorn"
"Hon. Etter Etherton" []
"Hon. Fife Neihoff"
"Hon. Freda Forehand" []
"Hon. Gaunt Naughton"
"Hon. Gee Goheen" []
"Hon. Greig Goehring"
"Hon. Grisel Holsinger"
"Hon. Gros Goshorn"
"Hon. Grout Roughton" []
"Hon. Guilbert Lightbourne" []
"Hon. Guill Loughlin" []
"Hon. Hal O'Holohan"
"Hon. Ham Hohman"
"Hon. Hart Hathorn" []
"Hon. Hee Hoehne"
"Hon. Hettinger Hetherington"
"Hon. Ira Hirano" []
"Hon. Issac Chiasson"
"Hon. Janes Johansen-Johannes" []
"Hon. Jansen Johannsen"
"Hon. Jason Johanson"
"Hon. Jed Dejohn"
"Hon. Jessop Josephson"
"Hon. Kaiser Kaneshiro" []
"Hon. Kearns Hankerson"
"Hon. Kera Honaker"
"Hon. Krone Korhonen"
"Hon. Kyra Hornyak" []
"Hon. Lam Lohman" []
"Hon. Lan Hanlon" []
"Hon. Law Lawhon"
"Hon. Legros Longshore"
"Hon. Leist Holstein" []
"Hon. Lis Hilson"
"Hon. Loma Holoman" []
"Hon. Ma Mahon-Ohman" []
"Hon. Mack Hockman"
"Hon. Mae Mahone" []
"Hon. Magan Monaghan"
"Hon. Mana Monahan" []
"Hon. Mar Harmon" []
"Hon. Mart Rothman"
"Hon. Matis Mathison" []
"Hon. Maus Housman"
"Hon. Maye Mahoney"
"Hon. Mccaa Coachman" []
"Hon. Mcnease Schoeneman" []
"Hon. Mesta Matheson" []
"Hon. Mick Hickmon"
"Hon. Mila Holiman" []
"Hon. Motta Mantooth-Toothman"
"Hon. Ned Hendon"
"Hon. Nola O'Hanlon" []
"Hon. Nutting Huntington"
"Hon. Odea Donahoe"
"Hon. Oster Thoreson" []
"Hon. Palm Pohlman"
"Hon. Rae O'Hearn-Hearon"
"Hon. Rangel Langhorne"
"Hon. Re Horne-Rhone"
"Hon. Red Rhoden-Herdon"
"Hon. Ren Hernon"
"Hon. Resnick Henrickson"
"Hon. Retta Atherton" []
"Hon. Rettig Hottinger" []
"Hon. Rick Hornick" []
"Hon. Rigel Ohlinger" []
"Hon. Ring Horning"
"Hon. Risa Harnois"
"Hon. Roe Honore"
"Hon. Rost Thorson"
"Hon. Rust Rushton" []
"Hon. Rust Rushton-Hurston" []
"Hon. Sadler Rosendahl" []
"Hon. Scarlet Charleston" []
"Hon. Sender Henderson" []
"Hon. Sid Dishon"
"Hon. Sill Hollins" []
"Hon. Sin Hinson" []
"Hon. Sink Hinkson"
"Hon. Sisk Hoskins"
"Hon. Six Hixson"
"Hon. Skip Hopkins" []
"Hon. Slater Rosenthal" []
"Hon. Smart Horstman" []
"Hon. Sol Ohlson"
"Hon. Solt Holston"
"Hon. Staci Atchison"
"Hon. Stem Thomsen"
"Hon. Stice Etchison" []
"Hon. Streit Rothstein" []
"Hon. Stu Huston" []
"Hon. Su Huson" []
"Hon. Suter Southern" []
"Hon. Tad Donath" []
"Hon. Tal Halton"
"Hon. Tam Thoman" []
"Hon. Tay Hayton"
"Hon. Tea Heaton" []
"Hon. Thacker Heckathorn"
"Hon. Tomas Thomason" []
"Hon. Toms Thomson"
"Hon. Torbert Brotherton" []
"Hon. Tow Howton" []
"Hon. Tower Howerton" []
"Hon. Trice Tichenor" []
"Hon. Tse Heston" []
"Hon. Tut Hutton"
"Hon. Tyler Thornley"
"Hon. Vera Hanover" []
"Hon. Verna Vanhorne"
"Hon. Wald Howland" []
"Hon. Wert Worthen" []
"Hon. Witt Whitton" []
"Hon. Ye Honey" []
"Hon. Yeoman Mooneyhan"
"Ian 'Top' Patino" []
"Icon Al Nicola" []
"Icon Alber Claiborne" []
"Icon Ali Nicolai" []
"Icon Art Cortina" []
"Icon Asa Casiano"
"Icon Ash Cashion" []
"Icon Case Ascencio"
"Icon Denis Considine" []
"Icon Ed Condie" []
"Icon Gala Giancola" []
"Icon Gerth Creighton" []
"Icon Gia Ignacio" []
"Icon Helms Michelson" []
"Icon Isa Nicosia" []
"Icon Kerns Nickerson"
"Icon Lara Carolina" []
"Icon Lord Coldiron" []
"Icon Luc Council"
"Icon Mara Marciano" []
"Icon Ortis Sciortino"
"Icon Pam Campion"
"Icon Sal Nicolas" []
"Icon Segal Cangelosi" []
"Icon Seth Etchison" []
"Icon Shrum Murchison" []
"Icon Stag Costigan" []
"Icon Stanton Constantino"
"Icon Star Cortinas" []
"Icon Stone Cosentino"
"Icon Su Cousin"
"Icon Tash Atchison" []
"Icon Trisha Christiano"
"Icon Watts Wainscott" []
"Ida 'Yes' Daisey"
"Ilona 'Top' Politano" []
"In-Demand Ned Mandi" []
"Ines 'Top' Pistone" []
"The Ines Theisen"
"Ira 'Top' Poitra" []
"Iris 'Top' Spirito"
"Jana 'Top' Pantoja"
"Jo 'Yes' Josey"
"Jon 'Yes' Joynes"
"The Karma Hatmaker" []
"Keren 'Top' Petrenko"
"Kim 'Yes' Kimsey"
"Kurt 'Yes' Sturkey"
"The Kylie Keithley"
"Lady Mae Almeyda" []
"Lady Olga Golladay"
"Lady Otte Aydelott" []
"Lady Ree Eardley" []
"Lady Ren Darnley"
"Lara 'Top' Parlato" []
"The Larson Rosenthal" []
"Lea 'Yes' Easley-Sealey"
"Leader Fitts Satterfield"
"Leader Jan Alejandre"
"Leah 'Yes' Heasley"
"Leanna 'Top' Pantalone"
"Lee 'Buy' Belyeu"
"Lee 'Hup' Heupel"
"Lee 'Yes' Seelye"
"Leet Amos Altemose" []
"Leet Art Letarte"
"Leet Blair Laliberte" []
"Leet Bo Belote"
"Leet Carl Cretella"
"Leet Chet Chelette"
"Leet Denis Edelstein" []
"Leet Erinn Enterline"
"Leet Gay Gateley"
"Leet Grad Ratledge"
"Leet Handy Delehanty"
"Leet Ivan Valiente" []
"Leet Kay Keatley"
"Leet Kimbra Timberlake" []
"Leet Les Estelle"
"Leet Linn Tennille"
"Leet Liz Leitzel"
"Leet Lou Ouellet" []
"Leet Mart Marlette"
"Leet Mary Altmeyer" []
"Leet Mirna Leiterman"
"Leet Mister Settlemire"
"Leet Nat Lanette"
"Leet Navin Valentine" []
"Leet Rawling Gillenwater"
"Leet Reid Dieterle" []
"Leet Rich Treichel"
"Leet Rick Terlecki"
"Leet Rob Boelter"
"Leet Rose Oesterle"
"Leet Sam Maltese"
"Leet Sandi Adelstein" []
"Leet Shani Haseltine" []
"Leet Sid Steidle"
"Leet Signor Oesterling" []
"Leet Syed Steedley"
"Leet Tad Delatte"
"Leet Tom Molette"
"Leet Toni Leonetti"
"Leet Tresa Satterlee" []
"Leet Ty Tetley"
"Leet Van Valente" []
"Leet Vito Violette"
"Len 'Yep' Penley"
"Len 'Yes' Ensley"
"Leo 'Buy' Bouley" []
"Les 'Top' Postel-Postle"
"The Les Stehle"
"Leta 'Yes' Teasley"
"Levi 'Yes' Livesey"
"Lew 'Yes' Wesley"
"The Lewis Whitesel"
"Lila 'Top' Patillo" []
"The Lillian Lilienthal"
"Lin 'Top' Lipton" []
"Lin 'Yes' Insley"
"Lina 'Yes' Ainsley"
"Link 'Yes' Kinsley"
"Lise 'Top' Pistole" []
"Lita 'Yes' Stailey"
"Liz 'Top' Politz"
"Loida 'Top' Dapolito"
"The Loma Lamothe" []
"The Lon Helton" []
"Loo 'Yep' Pooley"
"Lord Abe Laborde" []
"Lord Alec Cardello" []
"Lord Bay Bolyard" []
"Lord Blair Robillard"
"Lord Ethan Leonhardt" []
"Lord Fang Langford" []
"Lord Fitch Litchford" []
"Lord Ian Orlandi" []
"Lord Lan Rolland"
"Lord Neace Calderone" []
"Lord Nigel Dollinger" []
"Lord Pal Pollard" []
"Lord Pavone Vanderpool" []
"Lord Sean Alderson" []
"Lord Shane Rosendahl" []
"Lord Shaunte Southerland" []
"Lord Sweetman Westmoreland" []
"Loree 'FBI' Belfiore" []
"Lou 'Yes' Ousley"
"Louder Doer Lu" []
"The Luna Henault" []
"The Ma Mehta"
"The Mack Ketcham" []
"Man 'Top' Patmon"
"The Maren Matherne"
"Marg 'Buy' Burgamy" []
"Maria 'Top' Imparato"
"Marie 'Top' Imperato"
"Marlen 'Top' Palmerton" []
"The Marlena Leatherman"
"Mary 'Buy' Maybury"
"The Mason Matheson" []
"Master Burr Armbruster"
"Master Ed Demarest" []
"Master Ida Armistead" []
"Master Les Lemasters"
"Master Logan Mastrangelo" []
"Master Minh Smitherman"
"Master Weldon Westmoreland" []
"MBE Ace McAbee"
"MBE Adrien Biederman" []
"MBE Al Lambe" []
"MBE Ali Lambie" []
"MBE Alia Amabile"
"MBE Alisa Lambiase"
"MBE Alston Bostelman" []
"MBE Ana Beaman" []
"MBE Arch Chamber" []
"MBE Archie Bachmeier"
"MBE Arline Lieberman" []
"MBE Arn Berman" []
"MBE Aron Oberman" []
"MBE Ashly Shambley"
"MBE Can Mcbean-Mcbane"
"MBE Cano Mancebo"
"MBE Carry McBrayer" []
"MBE Carson Branscome" []
"MBE Chris Schembri"
"MBE Clark Blackmer"
"MBE Dan Debnam" []
"MBE Daniel Beidleman"
"MBE Darcel Delcambre" []
"MBE Darci Macbride" []
"MBE Dion Imboden"
"MBE Donovan Vandenboom"
"MBE Elston Belmontes"
"MBE Elton Belmonte"
"MBE Ena Beeman"
"MBE Gena Begeman"
"MBE Gil Gimbel" []
"MBE Gross Mossberg"
"MBE Hartley Barthelemy"
"MBE Herr Brehmer"
"MBE Hy Hemby"
"MBE Karole Blakemore" []
"MBE Karon Bronkema" []
"MBE Kena Beekman"
"MBE Lara Marable" []
"MBE Larin Liberman" []
"MBE LaRock Blackmore" []
"MBE Larson Lamberson-Rosenbalm" []
"MBE Leach Chamblee" []
"MBE Lina Liebman"
"MBE Lira Maribel" []
"MBE Lita Maltbie"
"MBE Lora Lombera" []
"MBE Lord Rembold"
"MBE Lore Belmore" []
"MBE Lorita Baltimore" []
"MBE Lory Bromley"
"MBE Loy Mobley" []
"MBE Lu Blume" []
"MBE Ly Melby"
"MBE Lyla Bellamy" []
"MBE Marco Macomber" []
"MBE Martin Timberman"
"MBE Oscar Camberos" []
"MBE Peters September"
"MBE Rae Beamer" []
"MBE Ralston Lambertson" []
"MBE Rana Bearman"
"MBE-Rank Berkman" []
"MBE Raul Baumler" []
"MBE Ray Mabrey-Mabery" []
"MBE Regan Bergeman"
"MBE Reilly Billmeyer"
"MBE Rena Beerman" []
"MBE Renna Breneman"
"MBE Rey Embrey"
"MBE Rhee Hembree"
"MBE Rico Crombie" []
"MBE Rod Bodmer"
"MBE Ronna Borneman"
"MBE Rosa Ambrose" []
"MBE Rose Ormsbee"
"MBE Rosen Emberson"
"MBE Rowan Bowerman"
"MBE Ruth Humbert"
"MBE Sal Balmes" []
"MBE Scot Combest"
"MBE Skinner Mesenbrink"
"MBE Sona Boseman" []
"MBE Strock Beckstrom"
"MBE Tana Bateman" []
"MBE Tora Otremba"
"MBE Tula Bultema" []
"MBE Tyler Trembley"
"MBE Urbina Birenbaum"
"MBE Zona Bozeman" []
"Mensch Eura Scheuerman" []
"Mensch Gil Schmeling" []
"Mensch Iola Michaelson" []
"Mensch Paro Macpherson" []
"Mensch Rohrer Schermerhorn"
"Mensch Tera Manchester"
"The Mina Heitman" []
"The Minna Heitmann"
"Miss Ena Messina"
"Miss Noon Simonson" []
"Miss Pink Simpkins" []
"Mo 'Buy' Boyum"
"Mo 'Yes' Mosey"
"The Mo Thome"
"Mogul Bahr Malbrough" []
"Mogul Han Loughman" []
"Mogul Linch Mcloughlin"
"Mogul Riel Guillermo" []
"Morris 'Yes' Morrissey"
"Mr. Abe Brame" []
"Mr. Abel Marble" []
"Mr. Acree Creamer"
"Mr. Agan Garman"
"Mr. Aitken Martinek"
"Mr. Ara Marra"
"Mr. Ariel Larimer"
"Mr. Aron Marron"
"Mr. Asa Armas"
"Mr. Ash Harms" []
"Mr. Asha Sharma" []
"Mr. Ashburn Marshburn"
"Mr. Ashton Horstman" []
"Mr. Aubry Marbury" []
"Mr. Auten Trueman"
"Mr. Ayon Maynor" []
"Mr. Bacon Cambron"
"Mr. Baine Bierman" []
"Mr. Barney Berryman"
"Mr. Bauch Burcham"
"Mr. Baugh Hamburg"
"Mr. Beane Beerman" []
"Mr. Beau Baumer"
"Mr. Bey Embry"
"Mr. Blouin Milbourn" []
"Mr. Bogan Borgman"
"Mr. Boots Bostrom"
"Mr. Bou Borum"
"Mr. Boyle Bromley-Moberly" []
"Mr. Bracey McBrayer" []
"Mr. Breen Bremner"
"Mr. Brundage Bumgardner" []
"Mr. Burrage Marburger"
"Mr. Cadel Mcardle" []
"Mr. Cain McNair" []
"Mr. Cane Carmen-Mcnear" []
"Mr. Canon Cornman"
"Mr. Casson Crossman"
"Mr. Castelli Mcallister"
"Mr. Castile Mcalister" []
"Mr. Chas Schram" []
"Mr. Chasteen Manchester" []
"Mr. Coady Carmody" []
"Mr. Core Cromer"
"Mr. Cowell Cromwell"
"Mr. Coy Mcroy"
"Mr. Cree Mercer" []
"Mr. Cuccia Marcucci"
"Mr. Dana Armand" []
"Mr. Dean Redman-Menard" []
"Mr. Dee Meder"
"Mr. Deeds Medders"
"Mr. Deem Demmer"
"Mr. DeHaan Hardeman" []
"Mr. Delano Moreland" []
"Mr. Deleo Delorme" []
"Mr. Deon Redmon" []
"Mr. Doane Medrano-Dameron" []
"Mr. Dumond Drummond" []
"Mr. Ealey Remaley" []
"Mr. Earl Marler"
"Mr. Eason Amerson-Roseman" []
"Mr. Eastin Martines" []
"Mr. Eaton Martone" []
"Mr. Ebert Rembert"
"Mr. Edison Dinsmore" []
"Mr. Eisen Meiners" []
"Mr. Eley Remley"
"Mr. Eli Imler"
"Mr. Elie Lemire"
"Mr. Elmo Rommel"
"Mr. Eloy Morley"
"Mr. Ely Myler"
"Mr. Erick Merrick" []
"Mr. Espana Spearman"
"Mr. Ethan Rethman"
"Mr. Etzel Metzler-Meltzer"
"Mr. Ewin Merwin"
"Mr. Ezell Zellmer"
"Mr. Fodor Morford"
"Mr. Fonda Dorfman"
"Mr. France McFarren"
"Mr. Gale Melgar"
"Mr. Gebo Moberg"
"Mr. Geis Grimes"
"Mr. Genesis Messinger" []
"Mr. Geno Monger"
"Mr. Gile Gilmer"
"Mr. Gino Moring"
"Mr. Goley Gormley"
"Mr. Guice McGuire" []
"Mr. Hames Hammers"
"Mr. Hanner Herrmann"
"Mr. Hasting Stringham" []
"Mr. Hatley Matherly" []
"Mr. Heacock Cockerham"
"Mr. Heap Perham"
"Mr. Hiles Mishler"
"Mr. Hoag Gorham"
"Mr. Hosea Ashmore" []
"Mr. Hyer Rhymer"
"Mr. Ian Marin" []
"Mr. Ivan Marvin"
"Mr. Jemison Jimmerson"
"Mr. Joines Jimerson"
"Mr. Kao Marko-Komar" []
"Mr. Kareem Kammerer"
"Mr. Keenan Kennamer"
"Mr. Kogan Krogman"
"Mr. Labonte Lamberton"
"Mr. Lake Markle-Markel"
"Mr. Lance Mclaren"
"Mr. Leech Melcher"
"Mr. Leo Morel-Merlo"
"Mr. Leto Molter"
"Mr. Lubin Milburn"
"Mr. Maisonet Miramontes"
"Mr. Mallet Trammell"
"Mr. Mance Mcnemar"
"Mr. Matheson Smotherman" []
"Mr. Mose Sommer"
"Mr. Moses Sommers"
"Mr. Mule Rummel"
"Mr. Nagata Matranga" []
"Mr. Nathan Hartmann"
"Mr. Nations Martinson" []
"Mr. Neal Lerman" []
"Mr. Neil Milner" []
"Mr. Noah Harmon" []
"Mr. O'Neil Merlino" []
"Mr. Ochs Schrom"
"Mr. Oller Morrell"
"Mr. Ollie Morelli" []
"Mr. Orear Marrero" []
"Mr. Osby Ormsby"
"Mr. Oster Stormer"
"Mr. Ostlund Lundstrom"
"Mr. Osuna Mansour" []
"Mr. Pace Camper"
"Mr. Page Pegram" []
"Mr. Palen Perlman"
"Mr. Pare Parmer"
"Mr. Parente Parmenter" []
"Mr. Patel Lampert" []
"Mr. Peter Tremper"
"Mr. Rey Merry-Rymer"
"Mr. Roane Marrone" []
"Mr. Rowe Merrow-Mowrer" []
"Mr. Sage Magers"
"Mr. Said Mardis" []
"Mr. Sato Mastro" []
"Mr. Scalia Mariscal" []
"Mr. Shahan Harshman"
"Mr. Shane Sherman" []
"Mr. Shea Rhames" []
"Mr. Sheats Smathers"
"Mr. Shehan Hershman"
"Mr. Sloane Salmeron"
"Mr. Soto Ostrom"
"Mr. Steen Mertens"
"Mr. Tassone Masterson" []
"Mr. Tee Emert"
"Mr. Theiss Smithers"
"Mr. Thiede Meredith" []
"Mr. Tien Minter"
"Mr. Tim Trimm"
"Mr. Toon Morton" []
"Mr. Toone Montero" []
"Mr. Tuan Turman-Truman"
"Mr. Tyson Nystrom"
"Mr. Vice McIver"
"Mr. Weil Wilmer"
"Mr. Witcher Mcwhirter"
"Mr. Yao Mayor-Raymo"
"Mr. Yearby Mayberry"
"Mr. Zane Manzer"
"Mr. Zito Moritz"
"Mrs. Ai Maris" []
"Mrs. Alica Mariscal" []
"Mrs. Anette Streetman" []
"Mrs. Anne Manners"
"Mrs. Arie Ramires" []
"Mrs. At-Smart-Marts" []
"Mrs. Beason Bosserman"
"Mrs. Becha Chambers" []
"Mrs. Blaine Silberman" []
"Mrs. Cain Crisman" []
"Mrs. Cason Crossman" []
"Mrs. Cherish Schrimsher"
"Mrs. China Chrisman" []
"Mrs. Cho Schrom" []
"Mrs. Chu Schrum" []
"Mrs. Dede Medders" []
"Mrs. Dee Demers" []
"Mrs. Della Ramsdell"
"Mrs. Dione Dinsmore" []
"Mrs. Dorton Nordstrom"
"Mrs. Eaton Osterman" []
"Mrs. Eda Demars" []
"Mrs. Edna Manders" []
"Mrs. Eisen Meissner" []
"Mrs. Elie Mireles"
"Mrs. Elma Lammers" []
"Mrs. Else Smelser"
"Mrs. Elvina Silverman" []
"Mrs. Elyse Messerly"
"Mrs. Enos Sermons" []
"Mrs. Erich Schirmer" []
"Mrs. Esta Masters" []
"Mrs. Estela Lemasters" []
"Mrs. Etzel Smeltzer"
"Mrs. Eun Sumner"
"Mrs. Garton Armstrong"
"Mrs. Gennie Ensminger"
"Mrs. Giesen Messinger" []
"Mrs. Gobert Bergstrom-Stromberg"
"Mrs. Hae Rhames" []
"Mrs. Hahne Hershman" []
"Mrs. Heitman Smitherman" []
"Mrs. Hite Smither" []
"Mrs. Hye Rhymes" []
"Mrs. Ida Simard" []
"Mrs. Imes Simmers" []
"Mrs. Janie Minjares"
"Mrs. Joane Jamerson"
"Mrs. Jonie Jimerson" []
"Mrs. Ka Marks" []
"Mrs. Kia Makris" []
"Mrs. Leach Chalmers" []
"Mrs. Lehi Mishler" []
"Mrs. Leona Salmeron" []
"Mrs. Lue Sumler"
"Mrs. Lula Sumrall"
"Mrs. Moe Sommer" []
"Mrs. Mose Sommers" []
"Mrs. Muse Summers"
"Mrs. Nation Martinson" []
"Mrs. Neace Cremeans" []
"Mrs. Nees Messner"
"Mrs. Nenita Martinsen" []
"Mrs. Nitta St. Martin" []
"Mrs. Odea Meadors" []
"Mrs. Oja Majors"
"Mrs. Olea Morales" []
"Mrs. Ona Ransom" []
"Mrs. Pate Stamper" []
"Mrs. Rio Morris" []
"Mrs. Seaton Masterson" []
"Mrs. See Messer"
"Mrs. Sina Sirmans"
"Mrs. Sona Rossman"
"Mrs. Sue Musser"
"Mrs. Tena Martens"
"Mrs. Tesha Smathers" []
"Mrs. Theis Smithers" []
"Mrs. Tina Martins" []
"Mrs. Tona Marston-Stroman" []
"Mrs. Tonia Stromain" []
"Mrs. Tony Nystrom" []
"Mrs. Tu Sturm-Strum" []
"Mrs. Ute Sumter" []
"Mrs. Yee Meyers"
"Ms. Aasen Seamans" []
"Ms. Adele Ledesma" []
"Ms. Adorno Rosamond" []
"Ms. Ager Magers" []
"Ms. Agnes Magness"
"Ms. Ai Masi-Amis" []
"Ms. Aide Demasi" []
"Ms. Ake Maske"
"Ms. Ali Islam-Smail" []
"Ms. Alla Llamas" []
"Ms. Allen Mansell-Sellman" []
"Ms. Alley Smalley" []
"Ms. Angel Mangels" []
"Ms. Ani Manis-Mains"
"Ms. Anise Messina" []
"Ms. Ann Manns"
"Ms. Antone Stoneman"
"Ms. Ara Armas" []
"Ms. Arrington Morningstar" []
"Ms. Asaro Massaro"
"Ms. Au Maus-Saum"
"Ms. Audet Umstead"
"Ms. Bacher Chambers" []
"Ms. Barahona Abrahamson"
"Ms. Bea Beams"
"Ms. Cairns Crissman" []
"Ms. Canales Casselman"
"Ms. Cao Mosca"
"Ms. Capo Campos"
"Ms. Carbone Branscome" []
"Ms. Carin Crisman" []
"Ms. Celinda McDaniels" []
"Ms. Chaffin Schiffman"
"Ms. Chan McShan"
"Ms. Chana Cashman" []
"Ms. Cherri Schirmer" []
"Ms. Cherry McSherry"
"Ms. Chi Chism"
"Ms. Chin McNish"
"Ms. Christa Christmas" []
"Ms. Chun Munsch"
"Ms. Coe Cosme-Comes"
"Ms. Cohan Hanscom" []
"Ms. Coop Compos"
"Ms. Cora Marcos" []
"Ms. Cuellar Marcellus"
"Ms. Dante Stedman"
"Ms. Darell Ramsdell" []
"Ms. Dee Deems"
"Ms. Delfina Mansfield"
"Ms. Diane Seidman" []
"Ms. Dinah Dishman" []
"Ms. Dison Simonds" []
"Ms. Doane Mendosa" []
"Ms. Dona Madson" []
"Ms. Doreen Densmore"
"Ms. Dorine Dinsmore" []
"Ms. Dyson Symonds"
"Ms. Eason Seamons"
"Ms. Eda Meads-Smead-Dames"
"Ms. Eden Mendes" []
"Ms. Eiler Mireles" []
"Ms. Eisen Siemens" []
"Ms. Eisner Meissner" []
"Ms. Elie Meisel"
"Ms. Elli Milles"
"Ms. Elsa Samsel"
"Ms. Elser Smelser" []
"Ms. Ely Myles" []
"Ms. Ena Means-Seman-Manes"
"Ms. Erin Misner"
"Ms. Esta Mestas"
"Ms. Etta Mattes"
"Ms. Eula Samuel" []
"Ms. Eury Rumsey"
"Ms. Eyre Meyers" []
"Ms. Foran Forsman"
"Ms. Gena Manges" []
"Ms. Gene Menges"
"Ms. Geri Grimes" []
"Ms. Gillan Smalling" []
"Ms. Gina Sigman" []
"Ms. Gino Sigmon" []
"Ms. Gloria Margolis" []
"Ms. Goris Grissom"
"Ms. Guin Mingus" []
"Ms. Hae Hames" []
"Ms. Hager Gresham" []
"Ms. Hai Isham" []
"Ms. Haile Ishmael" []
"Ms. Hana Ashman" []
"Ms. Hance McShane"
"Ms. Hara Sharma" []
"Ms. Harting Stringham" []
"Ms. Harton Horstman" []
"Ms. Hattie Matthies"
"Ms. Haun Shuman-Husman"
"Ms. Hearn Sherman" []
"Ms. Heaton Matheson" []
"Ms. Helena Eshelman-Eshleman"
"Ms. Herma Hammers" []
"Ms. Horne Mershon"
"Ms. Hue Humes"
"Ms. Hyer Rhymes" []
"Ms. Ickes Messick"
"Ms. Ida Dimas" []
"Ms. In Nims"
"Ms. Ione Simeon" []
"Ms. Isa Simas" []
"Ms. Jae James"
"Ms. Jina Jasmin"
"Ms. Joane Jameson"
"Ms. Joanie Jamieson"
"Ms. Joiner Jimerson" []
"Ms. Jonie Jemison"
"Ms. Ka Mask"
"Ms. Kaelin Lemanski"
"Ms. Kali Klimas"
"Ms. Kao Smoak"
"Ms. Kari Makris" []
"Ms. Kee Meeks"
"Ms. Keli Mikels"
"Ms. Kelle Kellems"
"Ms. Kelli Miskell" []
"Ms. Kellie Mikesell"
"Ms. Kena Manske"
"Ms. Korte Ekstrom"
"Ms. Lal Small"
"Ms. Lanza Salzman"
"Ms. Lapine Spielman" []
"Ms. Laseter Lemasters" []
"Ms. Lathan Stahlman"
"Ms. Latrice McAlister" []
"Ms. Lea Salem" []
"Ms. LeBaron Rosenbalm" []
"Ms. Ledonne Mendelson"
"Ms. Leedy Smedley" []
"Ms. Leila Maselli" []
"Ms. Lemon Lemmons"
"Ms. Lena Selman"
"Ms. Lenahan Hanselman" []
"Ms. Lenita Simental" []
"Ms. Leona Anselmo" []
"Ms. Leora Morales" []
"Ms. Lerma Lammers" []
"Ms. Lili Millis"
"Ms. Lorena Salmeron" []
"Ms. Lou Solum"
"Ms. Lue Lemus"
"Ms. Lula Allums"
"Ms. Lunde Lumsden"
"Ms. Magno Gammons"
"Ms. Mahon Hammons" []
"Ms. Mance McMeans"
"Ms. March Schramm"
"Ms. Melcher Schlemmer"
"Ms. Mi Mims"
"Ms. Miers Simmers" []
"Ms. Moen Emmons"
"Ms. Mona Ammons"
"Ms. Monti Timmons"
"Ms. Morefield Sommerfield"
"Ms. Morse Sommers" []
"Ms. Nealon Melanson"
"Ms. Nedra Marsden-Manders" []
"Ms. Neese Meneses"
"Ms. Nenita Steinman"
"Ms. Nichole Michelson" []
"Ms. Nickole Mickelson" []
"Ms. Noe Semon" []
"Ms. Nola Salmon-Lamson"
"Ms. Nona Manson"
"Ms. Noon Monson"
"Ms. Nuno Munson"
"Ms. O'Hare Ashmore" []
"Ms. Ola Lomas"
"Ms. Ona Mason" []
"Ms. Oneil Limones"
"Ms. Ora Ramos" []
"Ms. Pak Kamps"
"Ms. Peel Semple"
"Ms. Petra Stamper" []
"Ms. Pilla Millsap"
"Ms. Pinto Timpson" []
"Ms. Polen Plemons"
"Ms. Raab Abrams"
"Ms. Rachel Chalmers" []
"Ms. Rae Mears"
"Ms. Rains Sirmans" []
"Ms. Raya Ramsay"
"Ms. Raye Ramsey-Mayers" []
"Ms. Reed Demers" []
"Ms. Rees Messer" []
"Ms. Reeve Meserve"
"Ms. Reina Reisman" []
"Ms. Reith Smither" []
"Ms. Remer Remmers"
"Ms. Renetta Testerman" []
"Ms. Renita Martines" []
"Ms. Renna Manners" []
"Ms. Retha Mathers" []
"Ms. Rey Myers" []
"Ms. Rhea Rhames" []
"Ms. Rhee Hermes" []
"Ms. Riehl Mishler" []
"Ms. Rio Moris"
"Ms. Roane Amerson" []
"Ms. Roby Ormsby" []
"Ms. Roe Moser" []
"Ms. Rohe Hosmer" []
"Ms. Root Ostrom" []
"Ms. Rose Mosser" []
"Ms. Rosen Sermons" []
"Ms. Rost Storms" []
"Ms. Roye Moyers" []
"Ms. Ruano Mansour" []
"Ms. Rueda DeRamus" []
"Ms. Rule Sumler" []
"Ms. Sarno Rossman" []
"Ms. Sau Asmus"
"Ms. Seaborn Bosserman" []
"Ms. Sean Maness"
"Ms. Seay Massey" []
"Ms. Seyler Messerly" []
"Ms. Signe Messing" []
"Ms. Sim Simms"
"Ms. Sion Simons" []
"Ms. Slane Lessman"
"Ms. Sloan Salmons" []
"Ms. Sona Samson" []
"Ms. Spano Sampson"
"Ms. Spino Simpson"
"Ms. Stoehr Smothers"
"Ms. Susan Sussman"
"Ms. Ta Mast-Stam"
"Ms. Tait Mattis" []
"Ms. Tam Stamm"
"Ms. Tapley Stampley"
"Ms. Tart Smartt"
"Ms. Tea Mesta"
"Ms. Tee Teems"
"Ms. Tegan Stegman" []
"Ms. Tena Masten"
"Ms. Tera Master" []
"Ms. Thai Mathis" []
"Ms. Thea Thames-Mathes"
"Ms. Thersa Smathers" []
"Ms. Thi Smith-Smtih"
"Ms. Thor Strohm" []
"Ms. Tia Matis" []
"Ms. Tiernan Martinsen" []
"Ms. Tina Mastin"
"Ms. To Toms"
"Ms. Tona Matson"
"Ms. Tone Montes"
"Ms. Tonita Mattison" []
"Ms. Tora Mastro" []
"Ms. Torain Stromain" []
"Ms. Torre Stormer" []
"Ms. Trena Martens" []
"Ms. Tresa Masters" []
"Ms. Trina Martins" []
"Ms. True Sumter" []
"Ms. Una Manus"
"Ms. Uren Sumner" []
"Ms. Wai Swaim" []
"Ms. Walley Walmsley" []
"Ms. Waneta Sweatman"
"Ms. Weil Wilmes"
"Ms. Wheat Mathews" []
"Ms. Wheaton Mathewson" []
"Ms. Wilkie Milewski"
"Ms. Willa Sawmill" []
"Ms. Wille Willems"
"Ms. Willia Willaims" []
"Ms. Woodall Smallwood"
"Ms. Yelle Smelley"
"Ms. Yuen Munsey"
"Nat 'Yes' Tansey"
"The Nat Hatten" []
"Ned 'Buy' Budney"
"The Neil Thielen" []
"Nerissa 'Top' Petrossian" []
"Newport Town Rep Powtner" []
"Ng, Elite Gentile"
"Nick 'Yep' Pickney"
"Ola 'Buy' Boulay" []
"Ola 'Yep' Pelayo"
"The Olga Holgate" []
"Olin 'Top' Lopinto"
"Omer 'Yes' Seymore"
"Ossie 'Top' Esposito"
"Pam 'Yes' Sampey"
"Pearl 'Yep' Rappleye"
"Phil 'Top' Philpot-Philpot"
"Phil 'Yes' Shipley"
"Pig Trader Partridge" []
"Prime Doer Pridemore" []
"Pro Akins Parkison"
"Pro Aly Paylor" []
"Pro Cai Caprio"
"Pro Cain Carpino"
"Pro Cessna Casperson" []
"Pro Chara Chaparro"
"Pro Cort Proctor"
"Pro Diemer Pridemore" []
"Pro Elli Perillo"
"Pro Elma Palermo-Palmore" []
"Pro Gault Portugal"
"Pro Hunt Northup" []
"Pro Ines Pierson" []
"Pro Kao Kapoor"
"Pro Kearns Parkerson"
"Pro Lee Lepore"
"Pro Leo Pooler-Looper"
"Pro Leta Laporte" []
"Pro Lux Proulx"
"Pro Nat Parton"
"Pro Shen Pehrson"
"Pro Sneed Pederson"
"Pro Speier Prosperie"
"Pro Staten Patterson" []
"Pro Steen Peterson" []
"Pro Tien Pointer" []
"Pro Tye Torpey" []
"Pro Walt Partlow"
"Promoted Tom Pedro"
"Promoter Tom Roper"
"PUA Al Paula-Palau" []
"PUA Barnes Spanbauer"
"PUA Cade Decapua"
"PUA Calton Cantalupo"
"PUA Dale Depaula"
"PUA Dante Patnaude" []
"PUA Del Depaul" []
"PUA Elmore Pomerleau"
"PUA Ely Pauley"
"PUA Gil Puglia"
"PUA Hearn Harpenau"
"PUA Les Paules" []
"PUA Lev Vaupel"
"PUA Ly Pauly" []
"PUA Mac Campau"
"PUA Mace Campeau"
"PUA Neil Pauline"
"PUA Olin Paulino" []
"PUA Red Pardue" []
"PUA Rey Payeur"
"PUA Rios Aispuro"
"PUA Sol Paulos"
"PUA Tanis Paustian"
"Pundit Rees Turnipseed" []
"Pundit Sal Duplantis" []
"Rae 'Top' Tropea" []
"The Rae Heater" []
"The Rakestraw Starkweather"
"Ralph 'Yes' Sharpley"
"Ranae 'Hup' Harpenau"
"Reda 'Yep' Pereyda"
"Reed 'Top' Depetro"
"Ren 'Buy' Burney"
"Rena 'Top' Paterno" []
"Rene 'Top' Petrone"
"Rep. [n-t] Parente"
"Rep. Al Pearl" []
"Rep. Alda Laprade"
"Rep. Aldo Leopard"
"Rep. Alta Peralta" []
"Rep. Aly Player" []
"Rep. Ament Peterman" []
"Rep. Arie Pereira"
"Rep. Ariel LaPierre" []
"Rep. Art Prater"
"Rep. Beau Beaupre" []
"Rep. Casson Casperson" []
"Rep. Cathrine Charpentier"
"Rep. Caton Caperton" []
"Rep. Chas Schaper"
"Rep. Cho Copher-Porche"
"Rep. Cort Procter"
"Rep. Dick Pedrick" []
"Rep. Don Penrod" []
"Rep. Eda Pardee-Pereda"
"Rep. Edson Pederson" []
"Rep. Ella Laperle"
"Rep. Elsa Perales" []
"Rep. Else Sleeper"
"Rep. Elsy Presley"
"Rep. Elva Peavler" []
"Rep. Elza Peralez"
"Rep. Enos Penrose"
"Rep. Erin Perrine" []
"Rep. Etchison Stonecipher" []
"Rep. Fife Pfeifer"
"Rep. Gil Pilger"
"Rep. Gina Pinegar" []
"Rep. Hamel Lamphere"
"Rep. Hanscom Macpherson" []
"Rep. Hart Prather" []
"Rep. Ian Napier" []
"Rep. Ice Pierce"
"Rep. Ida Piedra" []
"Rep. Ike Keiper"
"Rep. Ira Rapier" []
"Rep. Isa Arispe-Parise" []
"Rep. Jean Prejean" []
"Rep. Kay Parkey"
"Rep. Ken Kepner"
"Rep. Keo Roepke"
"Rep. Lee Peeler"
"Rep. Leo Lepore" []
"Rep. Ling Pringle" []
"Rep. Lois Piersol"
"Rep. Loma Palermo" []
"Rep. Loo Pooler" []
"Rep. Lu Luper"
"Rep. Mac Camper" []
"Rep. Mal Palmer-Marple" []
"Rep. Mana Pearman"
"Rep. Marten Parmenter" []
"Rep. Mast Stamper" []
"Rep. Mila Palmeri" []
"Rep. Monaco Cooperman" []
"Rep. Myrna Perryman"
"Rep. Ned Pender"
"Rep. Nell Pernell"
"Rep. Nelli Pellerin" []
"Rep. Ness Spenser"
"Rep. Odom Perdomo" []
"Rep. Olst Polster" []
"Rep. Omara Paramore"
"Rep. Oren Perrone"
"Rep. Oster Restrepo"
"Rep. Ott Potter"
"Rep. Pan Napper"
"Rep. Pat Tapper"
"Rep. Pei Pieper"
"Rep. Pino Rippeon"
"Rep. Pyle Epperly"
"Rep. Rae Perera-Reaper"
"Rep. Ram Parmer" []
"Rep. Rash Sharper"
"Rep. Raye Pereyra"
"Rep. Renita Trepanier" []
"Rep. Rio Pierro" []
"Rep. Ro Roper"
"Rep. Ron Perron"
"Rep. Ross Prosser" []
"Rep. Sade Paredes"
"Rep. Santo Paterson" []
"Rep. Sato Pastore" []
"Rep. Scot Spector" []
"Rep. Scott Prescott"
"Rep. Senecal Lesperance"
"Rep. Sha Sharpe-Phares"
"Rep. Shad Shepard" []
"Rep. Shon Pherson" []
"Rep. Sion Pierson" []
"Rep. Sneed Pedersen"
"Rep. Sona Pearson" []
"Rep. Spano Apperson" []
"Rep. Staton Patterson" []
"Rep. Steen Petersen" []
"Rep. Stone Peterson" []
"Rep. Strachan Carstarphen" []
"Rep. Su Purse" []
"Rep. Tal Alpert"
"Rep. Tamela Palmateer" []
"Rep. Teston Petterson" []
"Rep. Tina Painter" []
"Rep. Toi Prieto" []
"Rep. Tone Petrone" []
"Rep. Toni Pointer" []
"Rep. Tony Poynter" []
"Rep. Toy Torpey" []
"Rep. Trula Perrault"
"Rep. Ty Petry" []
"Rep. Yip Rippey"
"Rep. Zada Pedraza"
"Rey 'Top' Torpey" []
"Rich Aida Dichiara"
"Rich Al Cihlar"
"Rich Amee Cheramie"
"Rich Ava Chavira"
"Rich Brad Birchard"
"Rich Bull Burchill"
"Rich Dame Demarchi" []
"Rich Detra Reichardt" []
"Rich Earl Charlier" []
"Rich Eddie Diederich"
"Rich Elma Melichar" []
"Rich Elmo Melchior"
"Rich Elmore Melchiorre"
"Rich Elsy Chrisley" []
"Rich Ena Cherian" []
"Rich Englebert Lichtenberger"
"Rich Ernst Christner"
"Rich Esteban Steinbacher"
"Rich Ester Streicher"
"Rich Fae Fichera"
"Rich-Fees Schiefer" []
"Rich Fidel Crihfield"
"Rich Genie Eichinger"
"Rich Hans Harnisch"
"Rich Irma Mirarchi"
"Rich Joe Jericho" []
"Rich Kam Hamrick"
"Rich Ken Kirchen"
"Rich Lea Charlie" []
"Rich Lee Eichler-Reichle"
"Rich Leeds Scheidler" []
"Rich Leif Freilich"
"Rich Leila Chiarelli" []
"Rich Leola Chiarello" []
"Rich Lew Wilcher"
"Rich Lu Ulrich"
"Rich Lula Churilla"
"Rich Ma Marchi-Hamric-Marich" []
"Rich Marti Trimarchi"
"Rich Mina Marchini"
"Rich Naoma Marchiano"
"Rich Neoma Marchione" []
"Rich Nestor Chronister" []
"Rich Nigel Reichling"
"Rich Ninfa Franchini"
"Rich Noe Eichorn" []
"Rich Oma Marchio"
"Rich Paris Schirripa"
"Rich Reda Reichard" []
"Rich Sam Chismar"
"Rich Sondra Richardson" []
"Rich Stenson Christenson"
"Rich Tanna Tranchina"
"Rich Tera Reichart" []
"Rich Tresa Carithers" []
"Rich Ula Laurich"
"Rich Wes Schwier"
"Risa 'Top' Poitras" []
"Rob 'Yes' Boyers"
"Robt 'Yes' Boyster"
"Rock 'Yes' Croskey"
"Rod 'Yes' Dorsey"
"Ron 'Yep' Poyner"
"The Ron Thorne" []
"The Ronald Leonhardt" []
"Ros 'Yep' Poyser"
"The Ros Stoehr"
"Rose 'Top' Stroope" []
"Rosia 'Top' Saporito" []
"Rosina 'Hup' Spainhour"
"Rosina 'Top' Pastorino" []
"The Roy Yother" []
"The Russ Shuster"
"Sade 'Top' Podesta"
"Sal 'Top' Postal" []
"Sal 'Yep' Pasley"
"Sam 'Top' Postma"
"Sam 'Yep' Sampey"
"Sam 'Yes' Massey"
"The Sam Thames-Mathes" []
"Sara 'Top' Spataro" []
"Saul 'Hup' Paulhus"
"Scion Annett Constantine"
"Scion Art Cortinas" []
"Scion Asa Isaacson"
"Scion Ash Chaisson" []
"Scion Enid Considine" []
"Scion Gale Cangelosi" []
"Scion Hal Nicholas" []
"Scion Hamel Michaelson" []
"Scion Herr Richerson"
"Scion Kern Nickerson" []
"Scion Loren Cornelison" []
"Scion Su Cousins"
"Scion Tori Sciortino" []
"Scion Una Asuncion"
"The Sebrina Eisenbarth" []
"Sec. Al Cales"
"Sec. Alan Canales" []
"Sec. Alaniz Canizales"
"Sec. Aldo Salcedo" []
"Sec. Alla Casella"
"Sec. Alongi Cangelosi" []
"Sec. Altman Castleman"
"Sec. Andra Cardenas" []
"Sec. Ara Caesar" []
"Sec. Arce Caceres"
"Sec. Aron Creason"
"Sec. Art Caster"
"Sec. Arthur Caruthers" []
"Sec. Ash Chasse"
"Sec. Baran Barcenas"
"Sec. Barela Calabrese"
"Sec. Bari Brescia" []
"Sec. Baro Escobar" []
"Sec. Belk Beckles"
"Sec. Bohr Schober"
"Sec. Borman Branscome" []
"Sec. Conant Constance"
"Sec. Corine Ceniceros"
"Sec. Difranco Defrancisco"
"Sec. Edith Tedeschi"
"Sec. Ehrlich Schleicher"
"Sec. Elva Cleaves"
"Sec. Ethan Chasteen" []
"Sec. Eva Aceves"
"Sec. Fran Frances" []
"Sec. Frith Fritsche"
"Sec. Hai Chiesa" []
"Sec. Hair Chaires" []
"Sec. Hans Sanches"
"Sec. Harp Schaper" []
"Sec. Hart Charest"
"Sec. Hartl Schlater"
"Sec. Herma Marchese" []
"Sec. Herr Scherer"
"Sec. Herrin Schreiner" []
"Sec. Herrod Schroeder"
"Sec. Hilma Michaels" []
"Sec. Hunt Chesnut"
"Sec. Hurst Schuster"
"Sec. Ian Caines"
"Sec. Iona Asencio" []
"Sec. Kali Cieslak" []
"Sec. Karon Ackerson" []
"Sec. Karr Rackers"
"Sec. Kay Caskey" []
"Sec. Kell Selleck"
"Sec. Kerin Ericksen" []
"Sec. Kort Stocker"
"Sec. Kory Croskey"
"Sec. Kurt Stucker"
"Sec. Lahr Charles" []
"Sec. Larae Escalera"
"Sec. Leta Casteel" []
"Sec. Li Celis"
"Sec. Link Nickles"
"Sec. Lisa Scalise"
"Sec. Lita Castile" []
"Sec. Lo Coles-Close"
"Sec. Lory Crosley"
"Sec. Lou Clouse" []
"Sec. Loura Lacourse" []
"Sec. Luna Clausen" []
"Sec. Luther Schlueter" []
"Sec. Mara Maresca" []
"Sec. Maren Cremeans" []
"Sec. Marna Creasman" []
"Sec. Meehan Cheeseman"
"Sec. Mink Mickens"
"Sec. Mo Cosme" []
"Sec. Natale Escalante" []
"Sec. Neal Senecal"
"Sec. Nina Encinas"
"Sec. Noah Acheson" []
"Sec. Null Cullens"
"Sec. Ora Rascoe" []
"Sec. Pal Caples"
"Sec. Parson Casperson" []
"Sec. Port Spector" []
"Sec. Rae Ceaser"
"Sec. Rains Narcisse" []
"Sec. Rap Casper"
"Sec. Ray Searcy"
"Sec. Raye Creasey" []
"Sec. Reade Decesare" []
"Sec. Rhodes Desroches"
"Sec. Rink Resnick" []
"Sec. Ro Secor-Crose"
"Sec. Rod Cordes"
"Sec. Rohr Schroer"
"Sec. Ron Cosner"
"Sec. Roni Ericson-Recinos" []
"Sec. Rother Rochester-Schroeter" []
"Sec. Rudd Scudder"
"Sec. Sal Cassel" []
"Sec. Sara Casares"
"Sec. Sher Chesser"
"Sec. Sherrod Desrochers"
"Sec. Shirl Schisler"
"Sec. Shon Chesson" []
"Sec. Sol Scoles"
"Sec. Sorin Cisneros" []
"Sec. Speed Cespedes" []
"Sec. Ta Cates"
"Sec. Tal Castle" []
"Sec. Tao Coates"
"Sec. Tay Stacey"
"Sec. Trinh Christen" []
"Sec. Trish Sechrist"
"Sec. Trojan Castrejon" []
"Sec. Trower Worcester" []
"Sec. Usha Chausse"
"Sec. Vera Versace" []
"Sec. Verena Severance"
"Sec. Whitner Winchester" []
"Sec. Yoko Cooksey"
"Sec. Zahn Sanchez"
"Sec. Zona Cosenza"
"Sera 'Buy' Seabury" []
"Serene Gil Seelinger"
"Serene Hugo Greenhouse" []
"Serina 'Top' Petrosian" []
"The Serina Eisenhart" []
"Shane 'Top' Stanhope" []
"Sick MBE Simbeck"
"Silk-PUA Pulaski" []
"The Simona Mathieson" []
"Sir Alden Sindelar" []
"Sir Allec Carlisle" []
"Sir Beech Scheiber" []
"Sir Bennet Bernstein"
"Sir Benton Bronstein-Bornstein"
"Sir Bert Brister"
"Sir Charon Richarson"
"Sir Dana Sardina" []
"Sir Demeo Medeiros" []
"Sir Demko Skidmore" []
"Sir Ed Dries" []
"Sir Ely Risley" []
"Sir Emory Morrisey"
"Sir Engel Eslinger" []
"Sir Enoch Richeson" []
"Sir Evon Iverson" []
"Sir Ewen Wiesner-Weisner" []
"Sir Golson Rossignol" []
"Sir Hank Harkins" []
"Sir Harp Parrish"
"Sir Jame Mijares"
"Sir Kao Sikora"
"Sir Kent Kistner" []
"Sir Lee Seiler-Leiser"
"Sir Les Sisler"
"Sir Lou Soluri"
"Sir Mozee Sizemore"
"Sir Nat Strain-Sartin" []
"Sir Natt Tristan" []
"Sir Neal Linares" []
"Sir Ned Snider"
"Sir Noah Harnois" []
"Sir Peter St. Pierre-Priester" []
"Sir Rod Dorris" []
"Sir Rogan Garrison"
"Sir Slate Lassiter" []
"Slick 'Buy' Cybulski" []
"Snob Cleta Constable" []
"Snob Cutler Culbertson"
"Snob Doty Boydston"
"Snob Eula Banuelos" []
"Snob Gent Bengtson"
"Snob Greer Rosenberg-Bergerson" []
"Snob Kori Brookins"
"Snob Mara Abramson" []
"Snob Mario Ambrosino" []
"Snob Mauer Rosenbaum" []
"Snob McRae Branscome" []
"Snob Ola Bolanos" []
"Snob Rae Seaborn" []
"Snob Roger Rosenborg" []
"Snob Ron Bronson"
"Snob Roni Robinson"
"Snob Tierra Barrientos" []
"Snob Torre Robertson" []
"Snob Ulmer Rosenblum"
"Snob Zane Bezanson"
"Sol 'Yep' Posley"
"Solon Chin Nicholson"
"Solon Dan Donalson" []
"Solon Felt Tollefson"
"Solon Mo Solomon" []
"Solon Ned Donelson"
"Solon Zora Solorzano"
"Son 'Top' Poston" []
"Spry Elite Priestley" []
"Spy Adler Spradley"
"Spy Cher Cyphers"
"Spy Coe Copsey"
"Spy Dee Speedy" []
"Spy Earl Parsley" []
"Spy Ella Lapsley" []
"Spy Elma Sampley"
"Spy Elser Pressley"
"Spy Ethan Stephany" []
"Spy Gal Glaspy"
"Spy Kera Repasky"
"Spy Kin Pinsky"
"Spy Lea Pasley"
"Spy Leah Shapley" []
"Spy Len Pensyl"
"Spy Leo Posley"
"Spy Mae Sampey" []
"Spy Nine Spinney" []
"Spy Pal Slappy"
"Spy Ree Peyser"
"Spy Rees Pressey"
"Spy Renato Petrosyan" []
"Spy Rock Prysock"
"Spy Telma Stampley" []
"Su 'Yep' Pusey"
"Super Don Pounders"
"Super Ly Pursley" []
"Super Ngo Spurgeon"
"Super Phil Pulsipher"
"Super Tia Pusateri" []
"Super Tod Sperduto" []
"Supt. Call Stallcup"
"Supt. Diener Turnipseed" []
"Supt. Heck Huckstep" []
"Supt. Linda Duplantis" []
"Supt. Re Petrus" []
"Supt. Rehm Shumpert" []
"Supt. Ro Stroup" []
"Supt. Roe Stroupe" []
"Tam 'Yes' Stamey"
"Tera 'Hup' Haupert"
"Teri 'Top' Piotter" []
"Terri 'Top' Perrotti"
"The Tori Theriot" []
"Tran 'Yep' Paynter"
"Tran 'Yes' Stayner"
"Tricia 'Top' Capriotti" []
"Val 'Yes' Leyvas"
"Vanita 'Yes' Avetisyan"
"The Vi Veith"
"VP Antle VanPelt"
"VP Claire Percival" []
"VP Corine Province" []
"VP Earle Peavler" []
"VP Isa Spiva"
"VP Kali Pavlik"
"VP Leo Volpe"
"VP Leonardo Vanderpool" []
"VP Ona Pavon"
"VP Oster Prevost" []
"VP Rina Parvin" []
"VP Ruis Purvis"
"VP Rule Pulver" []
"VP Toni Potvin"
"The Weston Whetstone"
"The Wiley Whiteley"
"Will 'Yes' Swilley"
"Winner Bo Winborne" []
"Winner Bost Brownstein"
"Winner Cathell Lichtenwalner"
"Winner Dese Neiswender" []
"Winner Edgar Winegardner"
"Winner Eva Vanwieren"
"Winner Gose Neiswonger" []
"Winner Greta Weingartner"
"Winner Nga Wanninger"
"Winner Ott Winterton"
"Winner Sage Swearingen"
"Winner Tom Wernimont"
"Wise Al Wailes"
"Wise Anna Waisanen"
"Wise Art Waiters" []
"Wise Beulah Wiebelhaus"
"Wise Dodo Woodside" []
"Wise Edith Whiteside"
"Wise Erma Wiersema"
"Wise Ethan Nesheiwat" []
"Wise Garth Seawright"
"Wise Gent Sweeting"
"Wise Gran Wasinger" []
"Wise Link Lewinski"
"Wise Lon Lewison" []
"Wise Merchant Schwieterman" []
"Wise Sal Swailes"
"Wren 'Buy' Newbury" []
"Yan 'Top' Payton" []
"Zane 'Top' Potenza"
"The Zelina Hazeltine" []

table of real estate ads [xxv9]
blurb
"A-Clan Canal"
"Ace-Pal Palace"
"Ah, Acute Chateau" []
"Aliv-Vail"
"Amoretto's Stateroom"
"Arid-Envy Vineyard"
"Armani Airman Marina" []
"Avert-Public Private Club"
"away from Drag-grad-gard" [x] [p]
"away from Mo-Hut-Mouth" [x] [p]
"Bayes-by-Sea" []
"Benbow's Snob Web"
"Bloats Oblast"
"Bogus-Lawn Bungalows"
"Camus's Sumacs"
"Capel Place" []
"Capella LaPlace"
"Cary Tudor's Courtyards"
"Casandra's Sandaracs"
"Celebrity Rebel City"
"Clean Epic Clan-Piece Nice Place"
"Covered Red Cove" []
"Coy Slots So Costly"
"Crime-Pays Pricy Mesa"
"Curb-Yon-Cult Country Club"
"Dampier's Emir Pads"
"Dates-Stead"
"De La Pena's Esplanade" []
"Dear Only Royal Den"
"Desirable Idler Base"
"Dig-Long Lodging" []
"Doc Harr's Orchards" []
"Eminence-Emcee Inn"
"Epic Clean Nice Place"
"Evans Rad Verandas"
"Full Spot Plus Loft"
"Furman's Sun Farm"
"Gold-Sign Lodgings" []
"Got-Caste Cottages"
"Hedge Manor Garden Home" []
"High-Set Heights"
"Hope Sunset Penthouses"
"I-Add-Play-Daily Pad"
"I-Arrive Riviera"
"I, Empress Premises"
"I'm-Docile Domicile"
"Icon-Set Section"
"Idle-Cat Citadel"
"Insulated Deals Unit" []
"Insulated Land Suite" []
"Interred Trendier"
"Is-Vast Vistas"
"La Paz Plaza"
"Lake Big Bilkage"
"Lancaster Ancestral Rest-Canal" []
"Last Elite Satellite"
"Le God-Lodge" []
"Leroux Luxore"
"Live at IT-Vale" []
"Liveliest-Site Ville"
"Lo-Meh-Holme"
"Log Cabin on Lac Big"
"Look-Fine-Life Nook"
"Loose Lips Pool Isles" []
"Lowenthal Lawn Hotel"
"Lustre-Ulster" []
"Macy's YMCAs"
"Marson Manors" []
"Me-No-Scum Communes"
"Monsour's Sunrooms"
"Most Value-Some Vault"
"Mr. Snoot-Morton's"
"Ms Heritage Hermitages"
"New Smooth Townhomes" []
"Nice Sled Declines" []
"Nice Solo Colonies" []
"Nicest Tonier Intersection"
"No-Law-Bug Bungalow" []
"No-Quarters-Torn Square"
"No-Recluse Enclosure"
"No-Rube-Bourne"
"Not-Cheap Cenotaph"
"Notice-Us/Cut-Noise Counties"
"NOW St. Towns" []
"Often-Lark Lakefront"
"Okay-Now Nookway"
"One Patch Not Cheap"
"Ooh, Spot Too Posh"
"Opulent Lout Pen" []
"Overland Rondavel" []
"Pad on a Pond"
"Pad-to-Adopt"
"Paquita's Aqua-Pits"
"Pascale Palaces"
"Pastore Seaport" []
"Patent Arms Apartments"
"Pay-WHAT Pathway"
"Pays-How Shopway"
"Peon-Dream Promenade" []
"Peralta's Palestra" []
"Perma-Cool Room Place"
"Petralli's Tall Spire"
"Piccadilly Idyllic Cap"
"Piers-Spire" []
"A Place-Palace" []
"Planned-Pen Land"
"Pleasant Pat's Lane" []
"Pleasant Platanes" []
"Plow Into Owl Point Twin Pool"
"Pod at Da Top" []
"Potherthorpe" []
"Poulson's Sun Pools"
"Prepaid Pier Pad"
"Priess Spires" []
"Private Trip Ave"
"Promotion-Point Room"
"Really Good Royal Lodge"
"Relog-Focus Golf Course"
"Republic's Club Spire"
"Residual Rule Dais"
"Rest Homes Most Sheer"
"Riverside Rise Drive"
"Rope Vista So Private" []
"Rose-Theme Tree Homes" []
"Rosendale Oleanders" []
"Saccharine Chic Arenas"
"Sales-Paid Palisades/Ideal Pass"
"Security-Cry Suite"
"Ship-Fond Fish Pond"
"Show-More Homes Row"
"Sighshire Highrises"
"Silenus's Sun Isles"
"Sin-Mason Mansions"
"Singular Snug Lair" []
"Slap-Ennui Peninsula"
"Snoot-So-Ton" []
"Snotston" []
"Social-Pro Acropolis" []
"Solved-it-All Oldest Villa"
"Some Niche Nice Homes"
"A Spot So Pat" []
"St. Care-Caster" []
"St. Eli Islet"
"St. Pierre Rest Pier" []
"Stafford Fad Forts"
"Stephen's Hep Nests" []
"Stetler's Trestles"
"Stonesmere: Remoteness"
"Sue Ho's Houses"
"Sullivan Sun Villa" []
"Sunshine Hues Inns"
"Tannest-Tenants St. Annet"
"Tastee-Estate"
"Ten-Days-Stay Den"
"Thompson Posh Mont"
"Three-Magi Hate-Grime Hermitage" []
"Tons-Hep Hot Pens"
"Tons New Now Nest"
"Too-Plush Pool Huts"
"Top Dens to Spend"
"Top-Floor Roof-Plot/Pool-Fort"
"Trop-Port"
"Truco Court" []
"Ultra-Fine Fruit Lane" []
"Un-Bore-Bourne" []
"Vibeway Bay View"
"Villa Valli"
"Warm Mawr"
"Way-Nice Icy-Anew Wine Cay"
"West-End Dew-Nets New Dest"
"Western St.: Newer"
"Wonder Den Row" []
"Zelinsky Skylinez"

table of self-help bestsellers [xxv0]
blurb
"[if player is male]Fears, Mr[else]Fear, Mrs[end if]? Torn? TRANSFORMER[r], by Storm Ferran"
"Able to Be a Lot[r], by Beata Botello"
"Absolutely All-Best You[r], by [if player is male]Les Baluyot[else]Betsy Ulloa[end if]" []
"Accused of Aced Focus[r], by Doc Su Face"
"Aches: To Teach So[r], by Chet Sao" []
"Acin[']: I Can! I Can![r] by Nica Cain"
"Ad of Bein['] Bona Fide[r], by Fae Bodin" []
"Add Moil, Old Maid[r], by Dido Lam"
"Adulting[r], by [if player is male]Nat Guild[else]Gita Lund[end if]"
"Aggression: Greasing So[r], by [if player is male]Sergio Gans[else]Agnes Goris[end if]" []
"Ah, I Prep: Happier[r], by Rip Heap" []
"Ah, Loom, Moolah[r], by [if player is male]Hal Moo[else]Ola Ohm[end if]"
"Ah, Spur Us: Harp[r], by Pa Rush"
"Ahh, I, At It[r], by Hai Hiatt"
"Aided Anew, Win[r], by Edwina Wieand"
"Aim More: a Memoir[r], by Emma Rio & Mia Rome"
"Aim, Plod, DIPLOMA[r], by Pam Idol" []
"Aim Top Greed: Get Paid More[r], by [if player is male]Moe Patridge[else]Madge Prieto[end if]"
"Al, Be Able[r], by [if player is male]Abe Beall[else]Lea Babel[end if]" []
"Alimony: Any Limo[r], by Loni May"
"All-Glib-Now Lowballing[r], by Will Galbon"
"Also Gilt Goal List[r], by Lola Gist"
"Anchoring No Chagrin[r], by Rina Chong"
"And Gee, an Edge[r], by [if player is male]Ed Egan[else]Dee Ang[end if]" []
"And Lose No Deals[r], by Sane Old [if player is male]Ed Sloan[else]Dena Sol[end if]" []
"Angst? I'm-Me Magnetism[r], by Gena Timms"
"Another Sale: Also Hearten, Sane Loather[r], by [if player is male]Seth Leanora[else]Sheena Toral[end if]"
"Anti-Leprosy Personality[r], by [if player is male]Troy Espinal[else]Alison Petry[end if]"
"Anxiety's Tiny Axes Ain't-Sexy[r], by Tex Yasin"
"Any Greed? Green Day[r], by Randy Gee & Dean Grey" []
"Any Modem? Mad Money[r], by Mandy Moe"
"Any Schmoe a Mensch, Yo[r], by May Schoen"
"Aplomb, Po['] Lamb[r], by Bo Palm"
"Ar, Get Great[r], by [if player is male]Garrett Age[else]Tara Eggert[end if]" []
"Arlen, Laren, LEARN[r], by [if player is male]Allen Raner[else]Lala Renner[end if]"
"Astuter Stature: Treat Us[r], by [if player is male]Rus Tate[else]Sue Ratt[end if]" []
"Attain Indeed[r], by Denita Tienda" []
"Autonomy to YOU, Man[r], by Una Mooty" []
"Aw, Don't be Beat Down[r], by Dan Tebow" []
"Aw, Rump, Warm Up[r], by Pa Wurm"
"Back Up to Pot a Buck[r], by Pat Kubco"
"Bad Diets, Dead Bits[r], by Addi Best"
"Banjo Gipsy? Paying Jobs[r], by Gaby Jipson"
"Barest Ego, Be So Great[r], by Tresa Boge"
"Be a Thing: in the Bag[r], by Beth Nagi" []
"Be a Tot to Beat[r], by Abe Ott & Bo Tate"
"Be-Ampler Preamble[r], by [if player is male]Al Pember[else]Pam Rebel[end if]"
"Be Busy, Bub: YES[r], by Sebb Yu"
"Be Doing: Big Done[r], by Ed Bogin" []
"Be Gutsy, Get Busy[r], by [if player is male]Guy Best[else]Betsy Gu[end if]" []
"Be Loud: DOUBLE[r], by [if player is male]Bud Leo[else]Deb Lou[end if]"
"Be-Pro Probe: Bop [']Er, Po['] Reb[r], by Beppo Rober"
"Be Rotted? Do Better[r], by Dot Ebert"
"Beat, Dim, Bad Time[r], by Tim Bade"
"Beat Down a Debt Now[r], by Tad Bowen" []
"Beat Them? That Be Me[r], by [if player is male]Matt Heeb[else]Bette Ham[end if]"
"Bed-Weak? Be Waked[r], by Kade Web"
"Being First: Fringe Bits[r], by Brigit Fens"
"Belay No Baloney[r], by [if player is male]Al Boyne[else]Bea Lyon[end if]"
"A Bench Gig? Big Change[r], by Gabe Ching"
"Bent, Rote? On, Better[r], by [if player is male]Brett Eno[else]Rene Bott[end if]"
"Best-Dug Budgets[r], by Deb Gust"
"Best Way: by Sweat[r], by Ty Swabe"
"Bet, Gain: Begin at Beating[r], by Ben Taig" []
"Big Ones: Being So[r], by Bo Gines" []
"Big Truth, But Right[r], by Britt Hug"
"Biography Hip? Go, Bray[r], by Gia Brophy"
"Birth of a Habit for Faith, Bro[r], by Tobi Fahr"
"Bitter? Me? I'm Better[r], by [if player is male]Tim Ebert[else]Mei Brett[end if]"
"Bleh, Toss the Slobs[r], by Bess Holt"
"Blight: a Big Halt[r], by Gil Bath"
"Blinder Nerd-Lib[r], by Len Bird"
"Boil Down, Blood, Win[r], by Dion Blow"
"Bold Cue? Could Be[r], by Luc Bode" []
"Bonfire for BEIN['][r], by Rob Fine" []
"A Bonnier Neo-Brain[r], by [i-n] Ebron"
"Book List to Bilk So[r], by Otis Kolb"
"Boom, Jack! Mojo Back[r], by Jacob Mok"
"Bouts to Bus Out BS[r], by Tubbs Souto" []
"Bribe, Cuss: Subscribe[r], by [if player is male]Bruce Biss[else]Bess Rubic[end if]" []
"Bury the Hurt: Bye[r], by Ty Huber"
"Busy Times[r], by [if player is male]Tim Bussey[else]Betsy Imus[end if]"
"But Stir, Burst It[r], by Su Britt"
"By Gusto, Bot Guys Got Busy[r], by Guy Bost"
"Bye, Harm: My Rehab[r], by Herb May"
"Can You? Ay, Unco[r], by Una Coy"
"Career Goals: Sager Oracle[r], by [if player is male]Roger Casale & Cole Segarra[else]Grace LaRose[end if]"
"A CEO'S So Ace"
"Certainly Learn, City[r], by [if player is male]Nate Cyril[else]Tracy Neil[end if]"
"Change More Among Cheer[r], by Megan Roche"
"Charge It: A Get-Rich Cheat-Rig[r], by [if player is male]Chet Riga[else]Teri Gach[end if]" []
"Chart So to Crash[r], by Star Cho" []
"Choir Troop, Poor to Rich[r], by Rocio Thorp"
"Clean Merit, Mercantile[r], by [if player is male]Ira Clement[else]Teri McLean[end if]" []
"Coaching: Go, a Cinch[r], by Nag Chico"
"Coin [']Em: Income[r], by Nic Moe" []
"Come Fer Me, Force[r], by Mo Creef"
"Comfy? Fie! My Office[r], by Mico Fyfe"
"Common is Bad, Nomadic Mobs[r], by [if player is male]Bascom Dimon[else]Minda Coombs[end if]"
"Compared-Compadre Doer Camp[r], by [if player is male]Pedro Mac[else]Pam Coder[end if]"
"Complain? No, I Clamp[r], by Pam Colin"
"Core-Pass: Pa Scores a Process[r], by Ross Pace"
"A Cotton to Act On[r], by Toto Can"
"D'Oh, Runts, Don't Rush[r], by [if player is male]Don Hurst[else]Ros Hundt[end if]"
"Da Next Op: To Expand[r], by Ed Paxton"
"Dang, I Gain'd[r], by Adi Ng"
"Dare Not? Tread On[r], by Ted Roan"
"Dark Hills, Hard Skill[r], by Dirk Halls"
"Darn, Homey: More Handy = Hard Money[r], by [if player is male]Andy Ohmer[else]Norma Hyde[end if]" []
"Dave Can Advance[r], by Ned Vaca"
"Day Job Joy? Bad[r], by AJ Boyd"
"Days Won't Stay Down[r], by [if player is male]Ty Dawson[else]Sandy Tow[end if]"
"Dear, Got Aged? Rot, Do Great[r], by [d-t] Ager" []
"Debt, So Do Best[r], by Ed Bost"
"Despair is Pared[r], by Ed Paris"
"Diplomas Amid Slop[r], by Sid Lampo"
"Dirt Cheap: Adept Rich[r], by [if player is male]Thad Price[else]Adi Precht[end if]"
"Dirty Work? Rot, Wry Kid[r], by Dirk Towry"
"Distance: Ascend It[r], by Ted Cains"
"Do Drop a Poor Dad[r], by Rodd Pao"
"Do-Income-Coin Demo[r], by Nice-Mood [if player is male]Codi Moen[else]Enid Como[end if]"
"Do It, or, Rid, Too[r], by Rod Ito"
"Do My Best By Modest[r], by Ted Mosby"
"Do OK, Grow: Good Work[r], by Og Kor-Dow" []
"A Dog's Hope: Good Shape[r], by Hodges Pao"
"Doing More Mood, REIGN[r], by [if player is male]Ed Mooring[else]Mei Gordon[end if]"
"Don't Fail, Naif Dolt[r], by [if player is male]Don Latif[else]Loni Daft[end if]"
"Doubters, Yo? Do Your Best[r], by [if player is male]Tory DuBose[else]Ruby DeSoto[end if]" []
"Down? Or, Try, Don't Worry[r], by Troy Drown"
"Dr. Be Un-Burned[r], by [if player is male]Bud Ren[else]Deb Nur[end if]" []
"Drab Then Bent Hard: the Brand[r], by Ned Barth" []
"Driest, Direst Stride[r], by Dierdre Sitts"
"Driven Dr. Vine[r], by Vi Dern"
"Driven Men Never Mind[r], by Ned Mervin"
"Drone, Gird Derring-Do[r], by Ron Reddig"
"Dueness Needs Us[r], by Su Sneed"
"DynaHour: Your Hand[r], by Randy Hou"
"Earn Top: Part One[r], by Patreon Pat Reno" []
"Earner Gang Range[r], by Regan Agner"
"Edictal Dialect[r], by Ted Laci" []
"Ee, Grant [']Em Agreement[r], by Gene Marte" []
"Effectiveness: Set Five Fences[r], by Venice Steffes"
"Ego Rusty? Get Yours[r], by Roy Guest & Guy Oster" []
"Eh, Target the Great[r], by Garth Tee"
"Eh, Zesty Idea: Seize the Day[r], by Haydee Seitz"
"Ehh, Most Meh-Shot[r], by Thom Esh"
"Elation-Smit Testimonial[r], by [if player is male]Alton Mesiti[else]Mattie Oslin[end if]"
"Eminence's Scene: MINE[r], by Ines Nemec"
"Employed Mo['] Deeply[r], by Dopey Mel" []
"End Goal: Ego Land[r], by Don Gale"
"End the Now, Then Do New[r], by Newt Hoden"
"Energised Reseeding[r], by [if player is male]Sid Greene[else]Desiree Ng[end if]"
"Enter Labs, Learn Best[r], by [if player is male]Ben Slater[else]Elsa Brent[end if]" []
"Entitled? Need Tilt[r], by [if player is male]Ed Litten[else]Enid Lett[end if]" []
"Erg, I Move, Give More[r], by Eve Romig"
"Every Man: Many Veer[r], by Verne May"
"Evolutions Liven Us Too[r], by Lois Venuto"
"Excluded Dud, Excel![r], by Dex LeDuc"
"Exempla-Example[r], by Pam Exel"
"Exert Any Extra Yen Next Year[r], by Rex Taney & Axe Tyner"
"Extol a Merit: Time to Relax[r], by [if player is male]Alex Moretti[else]Tamie Troxel[end if]"
"Extras, Taxers[r], by Rex Sat"
"Fail it New? Win at Life[r], by Twila Fine & Fae Litwin"
"A Fast Yes: Stay Safe[r], by Tessa Fay"
"Fat Funds and Stuff[r], by Stan Duff"
"Fat-Toes: to Feats of State[r], by Stef Tao"
"Fatalism? Flat Aims[r], by Sam Latif"
"Fear-Slant? Learn Fast: Snarl, Fate[r], by Leta Farns"
"Fears Go for Ages[r], by Fae Gros"
"A Fertile Life Rate[r], by Ira Fleet"
"A Fertile Life Rate[r], by Tia Fleer"
"Fie, Trash This Fear: Shift Era[r], by [if player is male]Seth Fair[else]Fae Hirst[end if]"
"Find Out Fun: DO IT[r], by Ino Duft"
"Flowering, Re-Flowing[r], by Inger Wolf" []
"Follow Through: Ooh, Full Growth[r], by Thor Wolfghoul"
"Fond Rec, Doc Fern[r], by Don Cerf"
"Fond Sure Founders: Four Dens[r], by Rod Funes"
"Forge Yen of Energy[r], by Geno Frye"
"Found it Fun? Do It[r], by Di Ufton" []
"Found Tons Soft? Dunno[r], by Donn Fouts"
"Freezing, Grief, Zen[r], by Inez Ferg"
"Frontiers Tons Rifer[r], by Erin Frost"
"Fuel This Life Thus[r], by Ulf Theis"
"Fuels-Self U[r], by Fufu Essell"
"Full Day: Laud! Fly![r] by Ulf Daly"
"Gain-Led Leading[r], by [if player is male]Gil Dean[else]Ida Glen[end if]" []
"Gained Up: oh, Paid Enough[r], by [if player is male]Hugo Pineda[else]Daphne Igou[end if]"
"The Gamut Taught Me[r], by Matt Huge"
"Generally All-Energy[r], by [if player is male]Glen Ayler[else]Lyla Green[end if]"
"Generate, Teenager[r], by Ena Geter"
"Generating Greatening[r], by [if player is male][n-t] Ginger[else]Nina Eggert[end if]"
"Generic? Bah, Begin, Reach, Be in Charge[r], by [if player is male]Brice Hagen[else]China Grebe[end if]"
"Get Done, Teen-Dog[r], by [if player is male]Ted Goen[else]Dee Tong[end if]" []
"Get Lean: a Gentle Neg-Tale[r], by Lee Gant" []
"Get Mo[']? Got [']Em[r], by Meg 'OMG' Otte" []
"Get Money, Net My Ego[r], by [if player is male]Monty Gee[else]Toy Menge[end if]"
"Get More to Merge[r], by [if player is male]Tom Eger[else]Meg Rote[end if]" []
"Get Rare, Greater[r], by Greg Errera-Tate" []
"Gets-Mine Meetings[r], by [if player is male]Gene Smit[else]Meg Stein[end if]" []
"Gil's Hunt: Sunlight[r], by Linh Gust" []
"Give [']Em Vim, Gee[r], by Vi Emge"
"Give a Lot? Vie, Gloat[r], by [if player is male]Vito Gale[else]Leia Vogt[end if]"
"Glad Work Dark Glow[r], by Gord Walk"
"Gloomier, Ergo, Moil[r], by [if player is male]Milo Gore[else]Meg Lorio[end if]"
"Glummest Mugs, Melt[r], by Lemm Gust"
"Go, Fear of Rage[r], by Fae Rog"
"Go Live: a Goal, Vie[r], by [if player is male]Avi Loge[else]Gia Love[end if]"
"Go Potent: Get on Top[r], by Otto Peng"
"Go, Spur Groups[r], by Gus Orso-Grupp"
"Go Trade: Do Great[r], by [if player is male]Tad Gore[else]Georgetta Rodda[end if]" []
"Goal, Gent: Get Along[r], by Teo Gangl" []
"Got Broke? A Great Book[r], by Kao Gobert & Bok Ortega"
"Got Dreams? Rest, Dogma[r], by [if player is male]Edgar Most[else]Madge Rost[end if]"
"Got it Wrong? Grit Won't Go?[r] by Orton Twigg"
"Got Need? Get Done[r], by Ted Goen" []
"Grab Dimes? Big Dreams[r], by [if player is male]Sid Amberg[else]Ma Bridges[end if]"
"Grab It, Big Rat[r], by Graig Rabbitt"
"Grannies['] Earnings[r], by Erin Gans"
"Gratitude's Start-Guide[r], by Edgar Titus"
"The Greatest Targets THEE[r], by Esther Tatge"
"A Greed, Geared[r], by Daggera Deere"
"A Greedy Edgy Era[r], by Gary Dee & Gay Reed"
"Green Book: Grok, Be One[r], by Bo Groenke"
"Greet Mo['] To Merge, Get More[r], by [if player is male]Tom Eger[else]Meg Rote[end if]" []
"Gripe? Aw, No: Gain Power[r], by Gwen Proia"
"Grit-Girt Trig" [x]
"Grow Thin Right Now[r], by Gwin Roth" []
"Guaranteed True Agenda[r], by [if player is male]Ned Argueta[else]Gena Duarte[end if]"
"A Gun, Dice: Guidance[r], by Angi Duce"
"Halfway? Fa-La, WHY[r], by Fay Wahl" []
"Hampering Harping, Me[r], by [if player is male]Hiram Peng[else]Inger Pham[end if]" []
"Hang Once on Change[r], by Noe Chang" []
"Hang Ups? Push, Nag[r], by Gus Phan"
"Harried Hardier[r], by Ira Herd"
"Harried? Nah, Handier? Rah[r], by [if player is male]Darin Hreha[else]Rhea Hardin[end if]"
"Harried? Rah, Ride Hardier[r], by Ira Herd" []
"Haste of The Oafs[r], by Fae Tosh"
"Hater Wile? Healer Wit Wealthier[r], by [if player is male]Earl White[else]Leia Werth[end if]"
"Haters? Eh, Rats[r], by Tre Ash" []
"Haters, Rest, Ah[r], by Tre Ash" []
"He Lacks Hackles[r], by Sal Heck"
"Heat-Flow of Wealth[r], by Flo Wheat"
"Heed, Get the Edge[r], by Ted Ghee"
"Hep, Else Sheeple[r], by Shep Lee" []
"Hi-Fats: a Shift[r], by Si Haft" []
"Hi, So Brave Behaviors[r], by Evia Brosh"
"Hint, Gentlemen: Enlightenment[r], by Gil Menhennett"
"A Hire With White Hair[r], by Ira Hewith"
"His Loud I Should[r], by Lu Doshi"
"His Two So With-it Hows to Wish[r], by Otis Show-Whit" []
"His Urgent, Hungriest Sure Thing[r], by Sig Hunter" []
"Holier? Cruder, Louder, Richer[r], by [if player is male]Ulrich Roeder[else]Corrie Hurdle[end if]"
"Hone Best: Be Honest[r], by [if player is male]Seth Bone[else]Beth Enos[end if]" []
"How-Tiny Whiny to Why Not I[r], by Hoyt Win" []
"How to Ask OK, So What[r], by Hawk Soto"
"Hun, I Can Unchain[r], by [if player is male]Ian Chun[else]Anni Chu[end if]"
"Hup! Rise, Pushier[r], by Pei Rush"
"A Hustler Thus Real[r], by Lea Hurst"
"I Bash Po['] Phobias[r], by Pia Bosh" []
"I Down the Done-With: Hide, Town[r], by Don White"
"I, Flat: a Lift[r], by Laila Tifft"
"I, Fun Teen, Fine-Tune[r], by Tennie Fu"
"I Go Far Figaro[r], by Giorgio Raffa"
"I Gotta Go at It[r], by Gia Ott" []
"I Groan or Gain[r], by [if player is male]Graig Noorani[else]Irina Gongora[end if]" []
"I Hone Us in-House[r], by Ione Shu" []
"I Kept ETA. Keep At It[r], by Tate Pike"
"I, Me, XO Moxie[r], by Moe Xi"
"I Must Bed Dumb Ties[r], by Tim DeBus" []
"I On Top Option[r], by [toti] Po"
"I, Once on Ice[r], by Connie Ocie"
"I Pelt on at Potential[r], by [if player is male]Eli Patton[else]Leona Pitt[end if]" []
"I Preach: a Cipher[r], by Pia Cher"
"I Prod, O Drip[r], by Dodo Pirrip"
"I Pry at Parity[r], by Art Yip"
"I Represent Enterprise[r], by [if player is male]Rene Priest[else]Erin Peters[end if]"
"I Slave to Save Toil[r], by Elsa Voit"
"I, Smoker, Irksome[r], by [if player is male]Moe Risk[else]Kim Rose[end if]"
"I Snag Gains[r], by Ana Siggins" []
"I Sow There Otherwise[r], by Theo Swire"
"I, Spry, OK Risky Op[r], by Roy Skip"
"I Stall at Ills[r], by Al List" []
"I, Tot, To It[r], by Titi Otto"
"I-Try-Each-Year Itch[r], by [if player is male]Ty Archie[else]Traci Yeh[end if]"
"I'd Org, Rig, Do[r], by Rodd Giorgi" []
"I'm-Pert Permit: PR Time[r], by Emmitt Ripper"
"I'm So Tired? Mister I DO[r], by [if player is male]Si Ditmore[else]Dorie Smit[end if]"
"I'm Stoked: Smoked It[r], by Kit DeMos"
"I'm Stuck? Um, STICK[r], by [if player is male]Stu Mick[else]Kim Cust[end if]" []
"I'm Told Mold It[r], by [if player is male]Old Tim[else]Dot Lim[end if]"
"I've WIN in View[r], by Vin Wei"
"Icon Revamp: Can Improve[r], by Ervin Campo & Marvin Cope"
"Ideals: Sad Lie[r], by Dessie Dalila & Alesia Siddle" []
"Ideas Open: an Episode[r], by Sandie Poe"
"If in Lag, Failing[r], by Gil Fina"
"If Met of Time Off[r], by Tom Fife"
"If Short, Jam: Major Shift[r], by Jim Hofstra"
"Ignored, Eh? Doing Here Reigned, Ho: Hired, Gone[r], by Erin Hodge"
"Ill Mews? I'm Swell[r], by Slim Lew" []
"Imagine: Me, I Gain[r], by Mia Inge" []
"Imposs.? So Simp[r], by Pi Moss"
"In a Fog of GAIN[r], by Gio Fan"
"In Her Guts, Sure Thing[r], by Signe Ruth" []
"In My Head's Mind, Ah, Yes[r], by [if player is male]Sidney Ham[else]Mindy Ashe[end if]"
"In Too Lamely? Emotionally[r], by [if player is male]Elliot Mayon[else]Toni O'Malley[end if]"
"Income Nut? Count Me In[r], by [toti] Munce"
"Increased Ardencies[r], by [if player is male]Eric Snead[else]Enid Cesar[end if]"
"Inept Force, Frenetic Op, PERFECTION[r], by Pierce Font"
"Inkblots Bilk Tons[r], by Link Bost"
"Inmost-Yet Testimony[r], by Toni Tymes"
"Intend Bow? I Won't Bend[r], by [if player is male]Ben Dowtin[else]Deb Winton[end if]"
"Interesting Intense Grit[r], by Erin Gittens"
"Into Hell? Eh, I'll Not[r], by Lon Leith"
"It Hones to Shine[r], by [if player is male]Theo Sin[else]Tish Eno[end if]" []
"Itch, Chit[r], by Tic Hitch"
"Itch Hums This Much[r], by Mitch Shu"
"Joy: Nab Any Job[r], by Jon Bay"
"Keenly, Keenly[r], by Kenley Yenkle"
"KO Lies Like So[r], by Kellie Ososki"
"La, Be Able[r], by [if player is male]Abe Beall[else]Lea Babel[end if]" []
"Lame List? Slim Tale: All Smite[r], by Mei Stall"
"Last Once, Can't Lose[r], by Stan Cole" []
"Late? Preyed Repeatedly[r], by Dee Tarpley"
"Laws: Do Sow, Lad[r], by Sol Daw" []
"Lazinesses, Sleaziness[r], by [if player is male]Zane Sissel[else]Inez Elsass[end if]"
"Lead Yon: No Delay[r], by [if player is male]Dean Loy & Leo Nady[else]Ola Endy[end if]" []
"Learn Now, Wan Loner[r], by Len Rowan"
"Led of Ego? Feel Good[r], by Flo Goede" []
"Legit to Let It Go[r], by Egil Ott"
"Legs of Self, Go[r], by Egloff Goessl"
"Let's Tag Gestalt[r], by Sal Gett"
"Leverage! Rave! Glee[r], by [if player is male]Lee Grave[else]Eve Agler[end if]"
"Lie, Wreath: The Wailer, Wealthier[r], by Earl White" []
"Lo, and We Deal Now[r], by Lon Wade"
"Lo-Debt: Be Told[r], by Deb Olt" []
"Lo! Snap! On, Pals[r], by Sol Sapp-Nolan" []
"Lo, Woken! New Look![r], by Ken Wool"
"Lobby Oddly[r], by Dolby Bloyd-Oldby" []
"Locked in: Licked? NO[r], by Don Klice"
"Log a Goal[r], by Olga Lago" []
"Loiter? Er, Toil[r], by [if player is male]Elliot Tierro[else]Lottie Lorrie[end if]"
"Losers or Less[r], by E. L. Ross"
"Lost, Cat? Act Lots[r], by Al Scott"
"Luck is Fate? Suck at Life[r], by [if player is male]Alf Stuckie[else]Staci Fluke[end if]"
"Luddites['] Dud Islet: Idle Dust[r], by Tedd Luis" []
"Ma's Top: a Stomp[r], by Pam Tso"
"Machines: I Can Mesh[r], by Mica Shen" []
"Make a Splash? Alphas, Ask Me[r], by Kasha Maples & Shameka Pals"
"Make Grit [']N Marketing[r], by [if player is male]Mike Grant[else]Kim Garnet[end if]"
"Many Plot Not Amply[r], by [if player is male]Tony Lamp[else]Pat Lymon[end if]"
"Mastery: Same Try[r], by Ty Mears" []
"Me and Un-Mundane[r], by Ed Numan"
"Me, I Plot to Impel[r], by Tim Opel & Tom Pile"
"Me, or More[r], by Em Romero" []
"Me? Or MORE[r], by Moe Romer" []
"Meaningful Gainful Men[r], by [if player is male]Miguel Fann[else]Una Fleming[end if]"
"Means to Steam On[r], by [if player is male]Stan Moe[else]Noe Mast[end if]" []
"Meek Bile? Be Like Me[r], by [if player is male]Mike Leeb[else]Mei Belke[end if]"
"Meek, Fair? Make Fire[r], by Mika Reef"
"Melt, Heap: Leap Them[r], by Pam Theel"
"Menial Diet: Eliminated Ailment, Die[r], by Mindi Teale"
"Mentors Need Endorsement[r], by Ed Mortensen"
"Mere Oops: Some Rope[r], by Esme Poor"
"Mid-Range Dreaming[r], by [if player is male]Ned Grima[else]Meg Randi[end if]" []
"Mind, Heart, Third Name[r], by [if player is male]Tim Harden[else]Enid Marth[end if]"
"The Mind's Mend: This[r], by Ned Smith"
"Miss Life if I'm Less[r], by Simi Self"
"Mo['] Money Memo Yon[r], by Emmy Ono"
"Mojo, Mr. Raja['][r], by Major Major" []
"Money, Power: Weeny Promo, Weepy Moron[r], by Ewen Pomroy"
"Mooninesses['] Noisomeness[r], by [sim] Esson"
"Moored? Demo or Do More[r], by Rod Moe" []
"More To It: Merit, Too[r], by [if player is male]Otto Meir[else]Tori Mote[end if]"
"Motiv-Vomit[r], by Vi Tom"
"Motivation: Vitamin Too[r], by Tito Aminov & Matt Iovino"
"Muddled Dud, Meld[r], by Del Mudd"
"My Idea May Die[r], by Ami Dey"
"My Neo-Money[r], by Emmy Nooney" []
"My Road's Mad Rosy[r], by Rod Mays"
"Nail Down an Old Win[r], by [if player is male]Lon Dwain[else]Diann Low, Dawn Olin & Nona Wild[end if]"
"Naivete? Lo, Live, Atone, Elevation[r], by [if player is male]Vito Neale[else]Eve Latino[end if]"
"Nearly Earn, Yen, Rally[r], by Arlyne Larney"
"Need Wiz, Wizened[r], by Inez Dew"
"Nepotism-Smit? Nope[r], by Tom Pines"
"Net Trust, Stern Tut[r], by Stu Trent"
"New Book: Be OK Now[r], by Bo Keown"
"New Haters: the Answer[r], by Stew Ahern"
"New Life? Few Line[r], by Ewin Elf" []
"A New-Old Deal Now[r], by [if player is male]Dan Lowe & Lon Wade[else]Lea Down[end if]"
"New Pal, We Plan[r], by Lew Pan"
"New Ploy: We Ply On[r], by Lyn Powe"
"New, Tried, Rent Wide[r], by Ed Winter"
"Nice Plan: Pinnacle[r], by Laci Penn"
"No Acne: One CAN[r], by Ann Coe"
"No Habits to Banish[r], by [toti] Bash & [if player is male]Ash Tobin[else]Sion Bhat[end if]"
"No-I-Won't Into NOW[r], by Noni Two"
"No Joy? Resume Some Journey[r], by Jon Seymoure"
"No, Oldest Don't Lose[r], by Ted Olson" []
"No Place Once, Pal[r], by Al Ponce"
"No Spite? So Inept! To Spine[r], by Tippie Ostenson" []
"Nomadic I-Can-Dom[r], by Mac Dion"
"Not Enough? On, TOUGHEN[r], by Teno Huong"
"Not Huge? Toughen[r], by Geo Hunt" []
"Not-Scary CAN Story[r], by [if player is male]Ron Stacy[else]Caryn Tso[end if]"
"Not Sure: to Nurse One's Rut[r], by Ron Suet" []
"Now Let's: Lots New[r], by Lon West" []
"O, Retrain: Intro, Era Anterior[r], by Trina Roe"
"The Odds: a Dead Shot[r], by Todd Shea"
"Oftener, I Grip Profiteering[r], by Rini Goepfert"
"Oh, Acuter Outreach: Euro-Chat, a Retouch[r], by Hector Au" []
"Oh, Get the Go HE Got[r], by Theoto Hegg"
"Oh, Them's Meh-Shot[r], by Thom Esh"
"Oh, To Stay Too Hasty[r], by [if player is male]Otto Hays[else]Toya Tosh[end if]"
"Oi, to It[r], by Tio & Toi Ito"
"OK, Cream a Mocker[r], by Mark Coe"
"OK Fills of Skill[r], by Flo Silk"
"OK, Glide Godlike[r], by Ed Golik"
"OK, Stir to Risk[r], by Kristo Kortis"
"OK Tips to Skip[r], by Kip Tso"
"Ol['] Law of Low Loaf[r], by [if player is male]Al Woolf[else]Ola Fowl[end if]"
"Old Tramp's Smart Plod[r], by Lord Stamp"
"Omni-Range Enamoring[r], by Mina Rogen"
"On Flaps of Plans[r], by Flo Span"
"On Relief: Info-Reel[r], by Len Fiore"
"On Spicier Precision[r], by Iris Ponce"
"On the Path: Ahh, Potent[r], by Ethan Hopt"
"On Turgid Doing-Rut? Grind Out[r], by [if player is male]Rudi Tong[else]Tori Gund[end if]" []
"Once, Louts Uncoolest[r], by [if player is male]Leo Counts[else]Su LoConte[end if]"
"One Dream, Enamored[r], by [if player is male]Ramon Dee[else]Dena Rome[end if]"
"One Grail, Regional: I, on, Regal[r], by [if player is male]Earl Goin[else]Lani Gore[end if]"
"One Hot To-Hone Note, Oh[r], by Theo Eton-Hoon" []
"One Lag? Go Lane[r], by Angelo O'Lange" []
"One Must: Us, Not Me[r], by Su Monet"
"One Raise: No Easier[r], by [if player is male]Rao Niese[else]Iona Rees[end if]"
"One's Rant, Resonant: EARN TONS[r], by [if player is male]Art Sonne[else]Rose Tann[end if]" []
"Ooh, Weep: Woe, Hope, Whoopee[r], by Howe Poe"
"Oops, Hello Loopholes[r], by Loo Heslop"
"Open Path to Happen[r], by Theo Napp" []
"Or Thrice to Richer Rhetoric[r], by [if player is male]Eric Hort[else]Terri Cho[end if]" []
"Organized? Zing! A Doer![r], by [if player is male]Ezra Godin & Edgar Zion[else]Zoe Gardin & Zona Ridge[end if]"
"Other Guys: Huge Story[r], by Gus Yother"
"Out, Grhh, Through[r], by [if player is male]Hugh Ort[else]Ruth Goh[end if]"
"Out, Man! AMOUNT![r] by Mo Tuan"
"Outings, I? No Guts[r], by [tt] Sung"
"Outpouring Our Pouting: Guru Option[r], by Puig Toruno"
"Outraced, Educator[r], by Ace Tudor" []
"Overcome-More Cove[r], by Em Coover & Eve Croom"
"Overmatched? Devote Charm[r], by Ahmed Vector"
"Oy, Retail's Royalties Rot Easily[r], by [if player is male]Tory Elias[else]Lori Yates[end if]"
"Pad, Pen and Pep: Append[r], by Dan Epp"
"Paid, Stud: It Adds Up[r], by Tadd Pius"
"Panaceas: a Sane Cap[r], by Asa Capen"
"Panic to Top, I Can[r], by Nat Pico"
"Parasite? Aspirate![r] by [if player is male]Asa Tripe[else]Pia Tesar[end if]" []
"Parkings? Sparking[r], by [if player is male]Kip Garns[else]Kris Pang[end if]"
"Part-Time Trip, Team[r], by Matt Peri"
"Past Seen? Step Sane[r], by Tess Pena"
"Patience, Inept Ace[r], by Pete Cain"
"Peers Got Proteges[r], by Peg Oster"
"Performance Free: No Cramp[r], by Franco Rempe"
"Persisting Springiest[r], by Tessi Pring"
"Pertain, Repaint[r], by Art Pine"
"Petulant? Up, Talent[r], by [if player is male]Paul Nett[else]Lupe Tant[end if]" []
"Phat Me: the Map[r], by Empath Hammett Happe" []
"Pierre's Net Enterprise[r], by [if player is male]Rene Priest[else]Erin Peters[end if]"
"Piles of Life-Ops[r], by [if player is male]Si Pfoel[else]Flo Sipe[end if]"
"Pivot to VIP[r], by Viv Pipo-Ott"
"Pivotal Vital Op[r], by Val Poti"
"Plain Zeroes, Lazier Peons: Personalize[r], by [if player is male]Zino Perales & Ron Speziale[else]Roseline Paz & Alison Perez[end if]"
"Plan Oft, Flap Not[r], by Flo Pant"
"Plan This: Hip Slant[r], by Phil Nast"
"Play [']Em: My Leap[r], by Pam Ley"
"Ply a Play[r], by Lyla Yapp"
"Ply Tenser Presently[r], by [if player is male]Ernst Pyle[else]Lyn Streep[end if]"
"Po['], Shot to Posh: Photos[r], by Otto Hoss-Hopp"
"Poke: Do OK, Dope[r], by Ed Koop"
"Poor's Wack: Swap, Crook[r], by Crow Pasko"
"Pop Diets I Stopped[r], by [d-t] Pepis"
"Posit Goal, Apologist[r], by Gita Sloop & Gail Spoto"
"Positive Tip: Vie So[r], by Vito Sipe"
"Pot O['] Gold: Good Plot[r], by [d-t] Ploog"
"Pout, Men? Put [']Em On[r], by Moe Punt"
"Power Plays, Lawyer Opps[r], by Apryl Swope"
"Preps to Pre-Post[r], by Tor Epps" []
"Presume Supreme[r], by Sue Prem"
"Proactive or Captive[r], by [if player is male]Victor Pea[else]Tova Price[end if]" []
"Profitable: a Brief Plot[r], by Felipa Bort"
"Profiteers['] Ripe Fortes[r], by Ferris Pote"
"Prone? Rep On[r], by Noreen Ropp"
"A Proper Prepar-O-Paper or Rare Opp[r], by Rae Orpp"
"Prosper, Perps or Propers[r], by Pop Serr"
"Pure Chaos? Shop a Cure[r], by [if player is male]Pace Roush[else]Porsha Cue[end if]"
"Purpose So Upper[r], by Sue Ropp" []
"Push Old Hold-Ups[r], by Su Dolph"
"Rah, Boss, So Brash[r], by Ash Bors"
"Rank Cot to Crank[r], by [if player is male]Nat Rock[else]Cat Korn[end if]" []
"Re-Adjust, Adjuster[r], by Stu Jared"
"Re-Plumb a Real Bump[r], by [if player is male]Paul Brem[else]Prue Lamb[end if]"
"Reaching? In Charge[r], by [if player is male]Ari Cheng[else]Geri Chan[end if]"
"Reactive? CREATIVE[r], by Traci Vee" []
"Real Life's Feral Lies[r], by Arlie Self"
"Reavowing Overawing[r], by Gavin Rowe"
"Redeem? No, Need More[r], by [if player is male]Nemo Reed[else]Renee Dom[end if]" []
"Redeem Yon More Needy[r], by [if player is male]Reed Money[else]Doreen Mey[end if]"
"Repeatedly Type A Elder[r], by Peter Daley"
"Resign? Hut! Hungriest![r] by Inge Hurst" []
"Resolve So: Revel[r], by Lev Rose" []
"Resonate So Neater[r], by Antos Ree" []
"Richen Up, Punchier[r], by Rupe Chin"
"Right Stuff: Turf Fights, Guff, Thirst[r], by Griff Shutt"
"Risk on or Sink[r], by Rossini Kronk"
"Rote Then Not There[r], by [if player is male]Rene Toth[else]Noe Rhett[end if]"
"Rotting-Not Grit[r], by Tri Tong"
"The Rules Hurt, Else[r], by [if player is male]Rush Leet[else]Hester Lu[end if]" []
"Rules of Our Self[r], by [if player is male]Ulf Rose[else]Flo Sure[end if]"
"Run With Hurt, Win[r], by Huw Rint"
"A Rut On To a Run[r], by Nat Ruo" []
"Sad Lie: a Slide I'd Seal[r], by Des Ali"
"Salaries Assailer[r], by [if player is male]Les Arias[else]Ali Sears[end if]"
"Same Old Lame Sod[r], by Del Amos"
"Saving Vs. Agin['][r], by Vi Gans" []
"See a Lot to Lease[r], by Leo East"
"See Bills: Less Bile[r], by Lee Bliss"
"Self Hate? Heal Fest[r], by Seth Leaf"
"Self Made Def Males[r], by Sam Felde"
"Sell-By? Yell BS[r], by Sy Bell"
"Sell Hard, Shred All[r], by Red Halls" []
"Sell More Junk? More Sullen (J/K)[r], by Joker Mullens"
"Semi-Private Imperatives[r], by Mavis Petrie"
"Servitude Divesture[r], by Trudi Eves" []
"Set Moods So Modest[r], by [d-t] Moses"
"Set, Pup? Step Up[r], by Stu Epp" []
"Set Time, I Test Me[r], by Tim Tees"
"Shaky? Ah, Sky[r], by Sy Kha"
"Shlep-Helps[r], by Shepp Shell"
"Shortage, So Gather[r], by [if player is male]Ash Grote[else]Sage Roth[end if]"
"Shoulds-Do Slush? Duh, Loss[r], by Sol Dush"
"Showy Trade: Say the Word[r], by [if player is male]Thad Rowsey[else]Sade Worthy[end if]"
"Shun a Cold Can/Should[r], by [if player is male]Claud Nosh[else]Luna Dochs[end if]"
"Shunt or Rush Not[r], by Stu Horn"
"Shy? Up! Pushy[r], by Sy Phu" []
"Sicker to Stockier[r], by [if player is male]Erik Cost[else]Kris Cote[end if]"
"Sing Wealth With Angels[r], by [if player is male]Ewing Stahl[else]Twila Sheng[end if]" []
"Sit Averse? Assertive[r], by [if player is male]Travis See[else]Tess Viera[end if]"
"Sit Free? Sir, Feet: Set Fire[r], by Seifert Siefert" []
"Skate Not, Take Tons[r], by Nate Kost"
"Skating, Staking[r], by Kit Gans"
"Slip [m-e] Simple Impels[r], by [if player is male]Emil Lepp-Sims[else]Ms. Millie Epps[end if]" [x]
"Slouch-Free, So Cheerful[r], by [if player is male]Les Foucher[else]Loree Fuchs[end if]"
"Slouch to a Holocaust[r], by Loo Tausch"
"Slow Mind? Slim Down[r], by Don Wilms"
"Slow-Pace Cope-Laws[r], by Lew Pasco"
"Smarting Wit, Arm Twisting[r], by Matt Wirsing & Grits Witman"
"So Can't to Cans[r], by Scot Castanon"
"So Meek? Seem OK? Seek Mo['][r], by Em Seko"
"So Plan On, Pals[r], by Pop & Son Llanas" []
"So Preach, Poachers[r], by Sharp Coe"
"So Risk KO's, Sir[r], by Si Kros"
"So Told, Do Lots[r], by [d-t] Los" []
"So, Wealth: Steal How? Late Show[r], by [if player is male]Theo Laws[else]Tosha Lew[end if]" []
"Soap, Stone, Teaspoons[r], by [if player is male]Enos Patos[else]Tessa Poon[end if]"
"Soar Beyond Body, Reason[r], by [if player is male]Enos Broady[else]Sonya Dober[end if]"
"Soar, Taken on a Streak[r], by Kara Stone"
"Sob-Mire? Be Mo['], Sir[r], by Rob Mies"
"Soft Rut to Turfs or Tufts of Trust[r], by [if player is male]Stu Fort[else]Ros Tuft[end if]"
"Some Trips to Impress[r], by Tom Spiers"
"SOS, Frets of Stress[r], by Stef Ross"
"Soul, Attain Salutation[r], by [if player is male]Saul Tonita[else]Alina Stout[end if]"
"Souls, Attain Salutations[r], by [if player is male]Austin Sloat[else]Alisa Sutton[end if]" []
"Sow, Push: How Puss Shows Up[r], by Huw Poss"
"Spray Out Your Past[r], by Rusty Pao"
"Spriteful Uplifters[r], by Lupe Frist & Lu Pfister"
"Spur, Spur[r], by Russ Rupp"
"Start Well: Let's Trawl[r], by Wert Stall"
"Stat, Be at Best[r], by Betta Bassett"
"Stony Chap? SYCOPHANT[r], by Patsy Cohn"
"Stop Being Inept Gobs: Bingo, Step[r], by Pet Gibson"
"Storing Grit, Son[r], by Ron Gist"
"Stratagem: A Smart Get[r], by [if player is male]Matt Sager[else]Meg Sattar[end if]" []
"Stringiest Grittiness[r], by Stig Estrin"
"Stuck In? Un-Stick[r], by Nick Tsu" []
"Suck, Pal? Up Slack[r], by Cap Lusk & Luc Spak"
"Suffice, Pep: Puff Pieces[r], by Effie Cupps"
"Sullen? Un-Sell[r], by Les Lun"
"Sure Got to Surge[r], by Gus Rote"
"Sworn: DO. No Words[r], by Don Swor" []
"Symbolic Climbs, Yo[r], by Sim Colby & Lim Cosby"
"Sync Amid Dynamics[r], by Cindy Sam" []
"Task on Me: Make Tons[r], by [if player is male]Kent Amos[else]Mena Kost[end if]"
"Task Romp: Top Marks[r], by Tom Parks"
"Task-Worth That Works[r], by [if player is male]Hawk Trost[else]Kath Worst[end if]"
"Tell So to Sell"
"Tenacity's Intact, Yes[r], by [if player is male]Tiny Cates[else]Stacy Tien[end if]"
"Thee, Pop: Pet Hope[r], by Theo Epp"
"Then Bag the BANG[r], by Ben Gath"
"Then Risk, Thinkers[r], by [if player is male]Seth Rink[else]Tish Kern[end if]" []
"THEO's Ethos[r], by Hoot Sheets" []
"This Boy: I Shot By[r], by Toby Hsi"
"This Wait: What It Is[r], by Isa Whitt"
"Thrice So to Riches[r], by [if player is male]Seth Rico[else]Trish Coe[end if]" []
"Thus, Be In, But Shine[r], by Nib Shute"
"Thy Self Felt Shy[r], by Fly Seth"
"Time off of Fit, Me[r], by [if player is male]Tom Fife[else]Tiff Moe[end if]"
"Timorous? I Roust Mo['][r], by Otis Orum"
"Tiny Doubt? Don't Buy It[r], by Tito Bundy" []
"Tip, Mac: Impact-It Camp[r], by Taci Timm-Capp" []
"Tips to Stop It[r], by Si Pott"
"A Titan in Attainin['][r], by Tina Tian" []
"To Apply Top Play[r], by Plato Py"
"To Bash Bathos[r], by Bobo Hass-Hatt" []
"To Crunch No Crutch[r], by Curt Noch"
"To Husking Tough Skin[r], by King South"
"To Impugn Gumption: Mug Point[r], by Tomi Pung"
"To Levying Yet Loving[r], by Tiny Vogel" []
"To-Master-Most Rate[r], by Matt Rose"
"To Plans: No Splat[r], by Sal Pont"
"To Resign One's Grit[r], by Rose Ting" []
"To Scry Yr Cost[r], by Sy Cort"
"To Share the SOAR[r], by Sethora Hartsoe" []
"To Shine, This One: I, Honest[r], by [tt] Shen" []
"To Shirk Hot Risk[r], by Kit Shor"
"To Spawn Past Now[r], by Pat Snow"
"Toady Today[r], by Dotty Yadao" []
"Toil, Lad, Do It All[r], by [ta] Doll"
"Tons-Real Learns to Earn Lots[r], by [if player is male]Art Olsen[else]Ola Stern[end if]"
"Too Blah? Boo, Halt[r], by Hal Boot"
"Too Nervy to VERY ON[r], by Troy Evon & Roy Vento" []
"A Top Duet, Up to Date[r], by Ed Tatupo"
"Torn Kids Don't Risk[r], by Dirk Nost"
"Tradin[']: Dart in, Darn it[r], by Dr. Tina Ridant" []
"Train On: an Intro[r], by [if player is male]Nat Niro[else]Roni Tan[end if]"
"Trained in Trade[r], by [if player is male]Ira Dent[else]Tia Dern[end if]"
"Trend Up: Prudent[r], by Red Punt" []
"Try Love Overtly[r], by Tory Lev"
"Try Out as You Start[r], by [if player is male]Ray Stout[else]Toya Rust[end if]"
"Tuna Fish: I Shun Fat[r], by Faith Sun"
"Tussler Results: Rutless[r], by Les Rust"
"Type A's Apt, Yes[r], by Pattey Passey"
"U Sad Bro? Soar, Bud[r], by [if player is male]Rob Suda[else]Ros Daub[end if]"
"Ugly Pride Purge Idyl[r], by Gil DuPrey"
"Um, Cope Come Up[r], by Moe Puc"
"Um, Efforts Must Offer More Stuff[r], by Smet Ruoff" []
"Un-Robust Burnouts[r], by [if player is male]Stu Bourn[else]Su Burton[end if]"
"Unaware? New Aura[r], by Ranae Wu" []
"Up, Lead: Due, Pal[r], by Ed Paul" []
"Up, Slam, Um, Slap a Slump[r], by [if player is male]Al Sump[else]Su Lamp[end if]"
"Up to Par? Pop a Rut[r], by Art Pupo"
"Up Well for Full Power[r], by Wolf Ruple"
"The Urges Gust Here[r], by [if player is male]Gus Ereth[else]Ester Hug[end if]"
"Using Suing[r], by Suggins Niu" []
"Very Nice Icy Nerve[r], by Vic Neyer" []
"Vie, Each: Achieve[r], by Evie Cha"
"Vows: Duel Would'ves[r], by Ev Sudlow"
"Wait'N? I WANT[r], by Wanita Wint"
"Waste Less, Sweet Lass[r], by Stew Sales"
"Waste Life? Fail, Sweet[r], by [if player is male]Lewis Fate[else]Fleta Wise[end if]" []
"The Way Is Easy With Wits, Yeah[r], by Isa Whyte & Tisha Yew"
"We All Can Claw, Lean[r], by Lance Law" []
"We'd Hate the Awed[r], by Ed Wheat"
"Weak No More: O, Remake Now[r], by Ewen Koroma"
"Wealth I'd Deal With[r], by [if player is male]Thad Weil[else]Edith Law[end if]" []
"Wealth, Power: a Whole Twerp[r], by Lew Peaworth"
"Wealth: the Law[r], by Al Thew"
"Wealthy Fame: Meet Halfway[r], by [if player is male]Mathew Faley[else]Fleta Mayhew[end if]"
"Weary Might: Why I'm Great[r], by [if player is male]Gary Withem[else]Margy White[end if]"
"Wee Man? A New Me[r], by Mae Wen"
"Weepy Moron? MONEY! POWER![r] by Ewen Pomroy" []
"Wellness: New Sells[r], by Wes Snell" []
"A Whap, Icy: Chip Away[r], by Yip Wacha"
"What-Ifs? Aw, Shift[r], by Tish Faw"
"Whiner Oft For the Win[r], by Hew Fortin" []
"Whittle the Wilt[r], by Lew Hitt" []
"Whole Heart Wealth Hero[r], by [if player is male]Lee Horwath[else]Heather Low[end if]"
"Why Me: a Meh Way[r], by Wm. Haye-Mayhew"
"Will Not, Till Now[r], by Lon Wilt" []
"Win, Dog: Now, Dig?[r] by Di Wong-Godwin"
"Wins Erase Weariness[r], by [if player is male]Wes Raines[else]Erna Weiss[end if]"
"Wins Logo: Goin['] Slow[r], by Lois Wong" []
"Wintery-New, I Try[r], by Ty Erwin"
"Yah, Opps! Posh Pay: So Happy[r], by Ash Yopp" []
"Yay, Buds, Busy Day[r], by Dy Sauby"
"Yeah, So Easy, Oh[r], by Ash Yeo"
"Yen, Tot? Not Yet[r], by Ty Eton"
"Yes, [']Bout Best You[r], by Sue Toby"
"Yes, Re-Bid by Desire[r], by [if player is male]Sid Beery[else]Edie Brys[end if]"
"Yessy-Do Odyssey[r], by Syed Soy"
"Yo, Bend Beyond[r], by Boyden Dobney" []
"Yo, Click Cockily[r], by Colicky Coy Lick"
"Yo, Meek Man, Make Money[r], by Yankee Mom Emmy O'Kane"
"Yo, Mild, My Idol[r], by Milo Liddy-Moy"
"Yo, When? Now, Hey![r] by Hy Owen"
"You Mo['] Often Out of Money?[r] by Mouton Foye"
"Your Mistake: a Tourism Key[r], by [if player is male]Seymour Taki[else]Yuriko Samet[end if]"
"Yup, Now a Way on Up[r], by Wu-Yan Po"
"Yup, Roast Your Past[r], by Ray Toups" []
"Zen for Frozen[r], by Oz Fern"
"Zen, Hit Zenith[r], by Heintz Hintze"
"Zone time? MONETIZE[r], by Onie Metz"
"Zooms! She Shmoozes[r], by Shomo Sze"

table of songs you could write [xxvx]
blurb
"[if player is male]She,[else]He's[end if] My Base: Shames, Bye"
"A-Holes So Hale"
"A-One St.: So Neat" []
"Ace, Pine in Peace"
"Ach, Gut-Caught" []
"Achin['], Mr. Rich Man" []
"Ad Men's Amends" []
"Aging Bod Going Bad"
"Ah, Dolts Had Lots" []
"Ah, Gutty, That Guy"
"Ahem, Try My Heart" []
"Aid Me, Media"
"Alive [']N Leavin[']" []
"All I Do: Ail, Old"
"Alone by Baloney" []
"Alone by Yob Lane" []
"An Alto, Atonal"
"Amity is no Animosity"
"Amity, it May, My Tia"
"And Low Now Lad"
"And Soul Unloads"
"Anthem for on the Farm"
"Any Ode One Day" []
"Arty Mr. Martyr"
"As I Hung Anguish"
"As I Sow, So I Was"
"Askin['], I Sank"
"At Her Heart, Eh, Rat"
"Auldest Saluted"
"Aw, a Fray Far Away"
"Aw, Ah, Fly Halfway" []
"Aw, Borin['] Rainbow"
"Aw, Busy Subway"
"Aw, Gee, We Age"
"Aw, Life, We Fail"
"Aw, Offer, Wear Off"
"Bad Loss, Sad Slob"
"Bad Luck Duck Lab" []
"Bar Scene, Beer Cans" []
"Barer Ol['] Laborer, Real Bro"
"Be Dear, Beer Ad"
"Be Lame, Blamee"
"Be Like Bilkee Kilbee"
"Be Weird, Wee Bird"
"Belt Coy Jive Objectively"
"Belt Our Trouble" []
"Blessed Bedless"
"Blighted Bedlight"
"Bloody Ol['] Body, Old Boy" []
"Blue Jam: a Jumble"
"Bolder Old Reb" []
"The Bones Been Shot" []
"Boney Al, Lean Boy" []
"Bonus Sun Soon, Bub"
"Boosts to Sobs"
"Boredom's Somber Do"
"Boss, Lend Boldness" []
"Bottlers['] Blotters" []
"Bred to be Trod"
"Bum-Self Fumbles"
"Bummed, Dumb Me"
"Bump on, Po['], Numb"
"The Bums Hum Best" []
"The Bus Be Thus" []
"Bus Ride, Bruised"
"But [']S OK to Busk"
"By a Glad Bald Gay Bag Lady"
"A Cad To DataCo"
"Cads Won't Cast Down"
"Cafe Ad Facade" []
"A Call Went Can't We All"
"Can't Do Dat Con"
"A Cancer Can Care"
"Canned [']N Caned"
"Capitol Coal Pit"
"Carsize Crazies"
"Casino is a Con" []
"Cave and Advance" []
"Certainly Neat Lyric" []
"Chafe-Song of Changes"
"A Chance Can Ache"
"Changes-to-Teach Song"
"Chap, I'm No Champion" []
"Chap, in a Pinch" []
"Charmin['] Rich Man" []
"Cheap St. Hep Cats" []
"Cheater [']Til Athleticer"
"Chew Fat? Few Chat"
"Chubby Ole Cubbyhole"
"City Runs on No Scrutiny"
"Clochard Doc Crahl" []
"Cloud, Sky, Lucky Sod"
"Club Woes, Blue Cows"
"Clunk, Ego, Luck Gone"
"Co-Try to Cry"
"Coal Miner Marcelino" []
"Codas O['] Cads"
"A Cog in GainCo"
"Cold Night Doth Cling"
"A Cold Ol['] Cad" []
"Cold Ones Consoled"
"Cold Row Old Crow" []
"Come On, OmenCo CEO, Mon" []
"Compose Mo['] Copes"
"Con Has No Cash" []
"Continuing Unnoticing"
"Could Be Blue, Doc" []
"Country, Cry Unto RuntyCo"
"Croon on, Orc"
"A Crumb-Bum Car"
"Cry On Corny Crony"
"Cute Lorn, Not Cruel"
"Cymbals by Calms"
"Daily I'd Lay" []
"Daily Lady I" []
"Damn Toil's Not Dismal"
"Darcie, I Cared"
"Dark Times['] Risk Tamed" []
"Darn Squat Quadrants"
"Dating, Dang it" []
"Deck Full, Luck Fled"
"Delia's Ideals Sailed" []
"Dental Work, Don't Re-Walk"
"Depressing Pre-Designs"
"Dereg Greed"
"Derek's Skeer'd"
"Dim Hearts, Hard Times, This Dream" []
"Dinners of No Friends"
"Discharge-Cash Dirge" []
"Do-OK-Rec Rock Ode" []
"Do Soul, So-Loud Sod Lou"
"Do Stay, Todays" []
"A Dodgy Day, Dog"
"The Dog He'd Got" []
"Dog, I Moon, I'm No Good"
"Done a Fib, Bona Fide"
"Doodles, Old Odes"
"Double, Ole Bud" []
"Down, Burden, Rundown Bed"
"Dreadfully Dull, Frayed"
"Drier, Direr"
"Drudge On, Underdog" []
"Dryest Red Sty"
"Dud Fate, Fat Dude"
"A Dude's Sad Due" []
"Duet So Used to Ousted"
"DuSable's Sad Blues"
"Each Ache"
"Eh, Tragic Grit-Ache" []
"Embellish Le Blemish"
"Empty Nest Sty: Me, Pent"
"End Right the Grind"
"End, Smit Mindset" []
"Enfettered Tender Feet"
"Environs Riven, Son"
"Ever Mo['] Over Me"
"Evictors['] Vortices" []
"Evolve, Ol['] Love" []
"Ex-Hopin['] Phoenix" []
"Fanboys of Any BS"
"Far Out of a Rut"
"Fastin['] Faints" []
"Father, Mother, From the Heart"
"Feelin Po['], Peon Life"
"Few Poor of Power" []
"Filing a Failing" []
"Fine Bog of Being"
"Flail Song: Falling So"
"Flawed, We Laf'd"
"Flirt So, Florist"
"Flo, Send Fondles"
"Foe, Doing Good, Fine"
"For Hats of Trash"
"Forbear Fear, Bro" []
"Forgot to, Frog"
"Formal Ol['] Farm" []
"Frail Skin, Final Risk"
"Free Heart Hereafter" []
"Free Song of Greens"
"Frets of Efforts" []
"Frown to Front, Ow"
"Fun, Mild, Mindful"
"Fundamental Mundane Flat"
"Gad if IDGAF"
"Gamblin['] Ma Bling" []
"Gas Bill, All's Big"
"Gas On: a Song"
"Gasberg Beggars"
"Gauchest Gut-Aches"
"Gaudy Ad Guy" []
"Gee, Dr. Greed" []
"Geein['] Genie"
"Gen-Bliss Blessing"
"Gin Ached, I Changed"
"Glow Any Long Way" []
"Gnashing, Hangings"
"Go, Hours So Rough"
"Go in, Doom, I'm No Good" []
"God, Sir, Grid So Disorg" []
"Gold Coast a Clod's Got"
"Gone Lorn No Longer"
"Gone, Tot, Too Gent to Get On"
"The Gongs Gents Hog"
"Good News Owed Song"
"Good Start Got So Drat"
"Goodness-Dose Song" []
"Goosed-Ego Sod"
"Got Blue to Bugle" []
"Got No Ire to Ignore"
"Got Numbed, Don't Bug Me"
"Got There Together"
"Graft Ran Fragrant"
"Grand Equal Quadrangle"
"Granma/Ragman" []
"Graspin['] a Spring" []
"Greed Log Doggerel"
"Greeed Degree"
"Grim-Hit, I'm Right"
"Grim, Tiny, I'm Trying"
"Grime and Dreaming" []
"Grimly, My Girl"
"Grit, Him? Grim-Hit" []
"Grodiest Stodgier Grist Ode"
"Grooved-In Overdoing" []
"Grouses Surge So"
"Grubby By-Burg" []
"Grumble, Mr. Bugle"
"Grungy RNG, Guy"
"Ha, I Levy Heavily" []
"Had Now and How" []
"Handsomely Deal So: Hymn" []
"Handsomest Homestands"
"Hangouts So Naught"
"Hapless Plashes"
"Harp on, Orphan"
"Harsh Dip, Hardship"
"Haste, Go, Age-Shot Hostage"
"Hating a Night" []
"Hating on a Nothing" []
"Her Po['] Hoper"
"Hereto Conman, More Than Once" []
"Hermits['] Mithers" []
"Hiatus Is a Hut" []
"High-Rise Heir Sigh"
"His End Up, Pushed In, Uh, Sniped, Hide-Spun" []
"His New Whines" []
"A Hit Off of Faith"
"Hollywood, Lowly Hood"
"Hope for Proof, Eh"
"Hopes, Eh, Sop"
"Hot Soup: Oh, to Sup" []
"How it Hit, Ow"
"Howl, Bard, Blow Hard"
"A Humble Hale Bum"
"Hunting Nuthing"
"A Hut's Owed, Washed Out"
"I Admit it, Maid" []
"I Almost Lost Aim"
"I Always Sail [']Way"
"I, Another Antihero"
"I, Bland, a Blind Baldin Bin Lad"
"I, Bogged on Being Good" []
"I Can Feel a Fleecin[']"
"I Care, Erica" []
"I Cure, Hop, Euphoric"
"I Drag Da Rig" []
"I Dream, Am Dire"
"I Dream I'm Dear" []
"I, Dreg, Re-Dig"
"I, Earful, Failure"
"I, Fellow Lowlife" []
"I, Fired Up, Purified" []
"I Fomented: End of Time"
"I, Going Hurt, Roughing It"
"I, Honest, to Shine" []
"I Hung in, Ugh"
"I, Infected, Deficient"
"I Label a Libel Liable" []
"I Made a Dime" []
"I Mull Ill, Um"
"I, Nasty, In a Sty, Stayin[']" []
"I, Now Owin['], Wino"
"I, Once On Ice"
"I Phone in Hope" []
"I, Plenty Ineptly"
"I Raged: a Dirge" []
"I, Runt, in Rut"
"I, Sad One, No Ideas"
"I, Shabby, Babyish"
"I, So Flat, to Fails"
"I-Sob Bios" []
"I Strove. It's Over" []
"I Swear to Wait, Sore"
"I, Tepid, Pitied"
"I Thought it, Though"
"I Trace No Reaction"
"I, Un-Rapt Puritan" []
"I Zest Here, Size Three"
"I'd Inspire Insipider"
"I'm Dying in My Dig"
"I'm Past Tips, Ma" []
"I've Arts, I Starve: Veritas"
"I've Loot Too Vile" []
"Iceless Siecles"
"Icy Heart City, Hear" []
"If All Flail, I Fall"
"If Friends Find Fires"
"If I Snort, Iron Fist"
"If I'm Thrown From Within"
"If Named Am Fined"
"If NSF, Sniff"
"If Only I Fly On"
"If Worn, I Frown"
"Ill-Wed, I Dwell"
"Implode, Limp Ode"
"Importunes['] Resumption"
"In Awe, I Wane"
"In Lack I Clank"
"In Task I Stank" []
"Indeed Not, I Don't Need"
"Inked-Over, Reinvoked"
"Instanter Transient Tenant, Sir" []
"Intern, Rentin['] [']N Inert"
"Ire Tons Stonier" []
"Ireful, a Failure" []
"Ironclad Cold Rain" []
"Is Acne As Nice"
"Is Candor So Rancid"
"Isle Dome Melodies"
"It's Bound in Doubts"
"It's Cool, Ol['] Stoic"
"It's Hell Still, Eh"
"It's How to Wish" []
"An Item I Meant"
"Jab on, Banjo"
"Jacob's Co-Jabs"
"Jalopy Joy, Pal"
"J/K Yer Jerky"
"Jokey Stuff Just Off-Key"
"Kept Pals['] Pep Talks"
"The Late Athlete"
"Late Shift: That's Life" []
"Lazy Song, Zany Slog"
"Le Bum [']Umble" []
"Le Bus Blues"
"Learning to Go Internal"
"Leave Now a New Love"
"Leet Song So Gentle" []
"Left Sans Flatness"
"Let-Down, Dwelt-On" []
"Levantine Valentine" []
"A Lie Story: Year's Toil, Royalties" []
"Lies Sung, Ugliness"
"Life-Sunk Flunkies"
"Life, Woman, Fail Me Now"
"Life's Ol['] Follies" []
"Lifespan Self-Pain Fail Pens"
"Like I'd Lie, Kid"
"The Line in Lethe" []
"Listen Mr. Minstrel"
"Live Now, Win Love"
"Live on in Love" []
"Lo, Cares So Clear"
"Lo, Others Lost, Hero"
"Lo, Snap, No Pals" []
"Loafing's Fail Song"
"Log Mo['] Gloom"
"Long Lost Song, Toll"
"Long Runs, Sung Lorn"
"Loser Roles, Loser Lores" []
"Lostling Gots Nill"
"Lots Bet, Bottles"
"Lou's Soul"
"Loud Aw, Woulda"
"Lovelorn? Aw, All Over Now"
"Lovin['] as Novalis" []
"Low Clerk Rockwell"
"Low-Fear Ear Flow"
"Low Note, Ole Town"
"Lucky Bad Bulky Cad"
"Lure, Faint Ultra-Fine Frail Tune" []
"Mac, Uplift Impactful"
"Mailings Misalign"
"Makes Me Ask" []
"Mama, Why a Whammy"
"Man's Dire Dreamins[']"
"Many Debts? Stand By Me" []
"Mate, She Hates Me The Same" []
"Maundering Undreaming"
"Max Spite Mix Tapes"
"Me, a Blot to Blame" []
"Me: a Runt, True, Man" []
"Me, Ills I Smell" []
"Me Most Caged, C'est Dommage"
"Me-Too'd, Mooted"
"Measly Mealys" []
"Mediocre Crime Ode" []
"Mensches, Chessmen"
"Mere Rad Dreamer"
"Merrily I Rely, Mr"
"Midwife, if I'm Wed"
"Might Be Big, Them"
"Millstone Still on Me"
"Min-Age Enigma" []
"Minded, I'd Mend"
"Minus Sun I'm Musin[']" []
"Miscoiled Domiciles"
"Mo['] Frailty: Formailty" []
"Mo['] Pads So Damp"
"Mo['] Ruin I Mourn"
"Mold It, I'm Told" []
"Moldering Gold Miner"
"A Moment Meant Mo[']" []
"Moneybags-Maybe Song"
"Monroe, Mooner No More" []
"Moodier, I Do More"
"Moon Sets, Mootness"
"Moonstone Monotones"
"Moot-Hewn Hometown" []
"More, Less, Mere Loss"
"More Me or Rome" []
"More My Memory"
"A Most Fine Manifesto"
"Most Grin I'm Strong"
"Motherland Enthraldom"
"Mouth to Hum Um Tho" []
"Move Along Among Love"
"Mr. Fear Farmer"
"Mr. Gable, Gambler" []
"Mr. I-The-Hermit" []
"Mr. Safe Frames"
"Mundaner, Under, Man"
"Mush-Hums"
"Mustier Semi-Rut" []
"Mute by My Tube"
"My Cove McEvoy"
"My Horn: a Harmony" []
"My Lone Melony" []
"My Nature Army Tune"
"My Place: Calm, Yep"
"My Po['] Bus So Bumpy"
"My Sub-Bum Sy"
"[']N Swim On, Minnows"
"Nag to Tango"
"Near Bed and Beer" []
"Neat Ol['] Lean-To" []
"Neg-Life Feeling" []
"Neurosis Sure is On"
"New Aims, Wise Man"
"New Hi When I Whine" []
"New Shirt Wish Rent"
"Nice Slow Scow Line"
"No Cars or Cans" []
"No-Cash Nochas" []
"No, Ego's So Gone"
"No Gas: a Song"
"No-Gem Gnome" []
"No-Goal Lagoon"
"No Heart on Earth" []
"No Map? Po['] Man"
"No Mo['] Moon"
"No Smiles, Lone Miss" []
"No Time to Mine Into Me" []
"No Win in Now"
"No Wiser, I Worsen"
"No Worth: How Torn"
"Nobody's Bonds, Yo"
"Nod Yea, Any Ode" []
"Nor Fret for Rent"
"Nor Hate Another" []
"Not Small Tolls, Man"
"Now I Slog, Solo-Wing" []
"Now Tour Our Town, Worn Out"
"Numb Loose Blue Moons"
"Numb'd [']N Dumb"
"O-Bla-Di, Diablo"
"O Cheer, Cohere, Re-Echo"
"O Clear RealCo Oracle" []
"O Crafty Factory" []
"O, Find No Dif"
"O Sing Them Something" []
"O Wired Weirdo"
"Oaf, Pry for Pay" []
"Of Stolen, Left Soon"
"Oft Nil, No Lift"
"Oft-Poor Rooftop"
"Oh Daily Holiday" []
"Oh, Dirty Thyroid"
"Oh, Mantra Marathon" []
"Oh, Me, TRY to Rhyme" []
"Oh No, Gouged Good Enough"
"Oh, Seeing He is Gone"
"Oh, Skint, Think So"
"Oh Slave a Shovel"
"Oi, Sad Adios"
"Ok, Pal, POLKA"
"OK Town to Know" []
"Ol['] [a-b] Ebola" []
"Ol['] Alec's Locales" []
"Ol['] Doc's So Cold"
"Ol['] Gent, Mr. Long-Term"
"Ol['] God O['] Gold"
"Ol['] Gut to Lug"
"Ol['] Kept Klepto"
"Ol['] Sod So Old"
"Ol['] Times to Smile" []
"Old, Beat, Bloated" []
"Old Horse, He Drools"
"Old, Lean, All Done"
"Old Money, Moldy One" []
"Old Relics['] Dice Rolls" []
"Old-Side Idle Sod"
"Old Town's Down Lots"
"Older Now, New Dolor, Lord Owen"
"Oldest, Losted" []
"Ole Guy Eulogy" []
"Ole Music Coliseum" []
"On, Lower, Woe-Lorn" []
"On Sub-Rut Burnouts" []
"On the DL, Then Old"
"Once-Caring Carcinogen" []
"Once-Phat Cenotaph" []
"One Clod Old Once"
"One Day Done, Ay" []
"One Dog's Song Ode"
"One Goth, He Got On"
"One Mad Ode, Man" []
"One Memory: More Money"
"One Sky, No Keys"
"One Ugly Lone Guy"
"One Way Now, Aye"
"One Week, Keen Woe"
"One With the Wino" []
"[']Onest Tones" []
"Only Le Lonely" []
"Open it to Pine" []
"Opulence Clue? Nope"
"Or Punt, Torn Up"
"Outsider Dries Out" []
"Over-Sad Sod-Rave, Savored"
"Own'd, Down"
"Oww, Li'l Willow"
"Oy, Dat Toady" []
"Oy, Moil'd Moodily, Doomily"
"Paction to Panic" []
"Pain, to a Point" []
"Pal, It's a Split"
"Pal of a Flop" []
"Par No Mo['], Poor Man"
"Parceled, Replaced"
"Partitioned Trepidation"
"Passion, Pain, SOS" []
"Paw, I'm a Wimp" []
"Paydirt? I'd Party"
"Pens O['] Peons"
"Penthouse Hopes Tune" []
"Pert Old Droplet"
"Pet Hit the Pit"
"Phoebe, Be Hope"
"Piny Heart in Therapy"
"Pisser Spires" []
"Placity? Typical City, Pal" []
"Plow, Plow, LWOP"
"Plug on Up Long"
"Ply Tales, All Types" []
"PM, Dude Dumped"
"Po['] Hero Hooper" []
"Po['] Lean Pa Noel" []
"Po['] Me Mope-Poem"
"Po['] Nigh Hoping"
"Pointiest Petitions"
"Poor, New, No Power" []
"Poor, New, Ow, Prone" []
"Poorest Stooper" []
"Pre-Senile, Spleenier"
"Pre-Sliced, Respliced Lip Creeds"
"Prime Agony: Paying More"
"Promiscuous Porous Music"
"Promise, Po['] Miser" []
"Prosaic Ol['] Acropolis"
"A Prude's Sad, Pure Rues-Pad" []
"A Pudgy-Guy Pad"
"Purg'd, I Gird Up"
"Push Back, Busk-Chap"
"Pushover Hovers Up"
"Ramen Ran Me" []
"Raw-of-Gut Tug-of-War"
"Raw Smog Grows, Ma"
"Re-Naying, Yearning"
"Rec Loves So Clever"
"Refuge's Free, Gus"
"Remiss Misers"
"A Repo Opera"
"Ride it Off Fortified" []
"Rife Sad Far Side"
"Rigid, I Gird"
"Roamed on Marooned"
"Rube, I'd Buried Ire, Bud" []
"Rube St., Buster"
"Rum-Hit, I'm Hurt"
"A Runt Life, Real Unfit" []
"Rush Past, Thrupass"
"Rushier Hurries"
"Rust Ruts"
"Rustin['] in Ruts"
"Rut-Hit, I: Truth"
"Sack-y Yacks" [p]
"Sad Icky Acid Sky" []
"Sad Lore Reloads" []
"Sad Mop So Damp" []
"Sad Pay Day Spa"
"Sad, Rotten, Don't Stare"
"Sadly Sly Ad"
"Sage, Never Save Green as Revenge"
"Said My Dismay" []
"Sal's Lass"
"Sanity in a Sty" []
"Say-a-Word Roadways"
"Say Lovin['] So Vainly"
"Scarce if I Sacrifice"
"Scum, Ere I Use Crime, I'm Secure"
"See, Fret, Set Free"
"Semi-Ragin['] Migraines" []
"Send Ma Amends" []
"Sentimental Entailments"
"Serf-Chain Franchise" []
"Shocking Hick Song" []
"Shoogled Dogholes"
"A Simple Smile, Pa"
"Sing Thru Hurtings"
"Singables, a Blessing"
"A Singer Regains"
"A Singy Saying" []
"The Six Ex-Hits"
"Size-Two Zits, Woe"
"Sky Mo['] Smoky"
"Slated by Bad Style"
"Slug on So: Soul Song"
"Slumberg Grumbles" []
"Slung for Furlongs"
"Sly Ode Yodels" []
"SMH, Acne? A Mensch Can Mesh" []
"A Smooth Sham Too" []
"Smug Arty Smart Guy" []
"A So-Cruel Carousel" []
"So Dire I'd Rose"
"So-Empty Mope Sty" []
"So Find No Difs"
"So Go Run: Our Song"
"So Hip-Hop Is"
"So Lame? Me Also" []
"So Long, No Slog"
"So, Maker, Ask More"
"So-Mangy May Song"
"So Many May, Son"
"So Simple Spoils Me" []
"So Suffer Off Ruses"
"So We Walk, Weak, Slow"
"So Well-Off Fools Flew"
"So When Now He's News, Oh"
"So, Young Guy, Soon"
"Sob Not, Boston, No Bots" []
"Sob Truly Robustly" []
"Sob, Zip Biz Ops"
"Sod, Un-Sound"
"Sol's Loss"
"Solitaire Oralities"
"Some Drunk Rude Monks"
"Some Hick, Homesick"
"Some Idle Melodies" []
"Some Long Englooms" []
"Some Ruin, Monsieur" []
"Someone's Moon Sees"
"Somewhere Homes Were" []
"Somnolescent Consolements"
"Son, Ain't No Saint" []
"Song for No Frogs"
"Song of No Fogs"
"Sonless Lessons"
"Soon Guy So Young"
"Soul Be Un-Nebulous"
"Soul-Took Lookouts"
"Southern Unrest, Ho" []
"Sowin['] Winos" []
"Squatter Quartets"
"Staph Paths"
"Staring at Rings" []
"Stay Long, Stony Gal"
"Stayed Steady Yet Sad" []
"Stern Man Remnants"
"Still I Sit Ill"
"Stop Each Ache Spot"
"Streety Syrette, Rest Yet"
"Sullenness, Nullnesses"
"Sunset Sent Us"
"Suntime Minutes"
"Swallow All Wows" []
"Team, I'd Made It" []
"Tearstain Attainers"
"TGIF Gift"
"Tha Raw Hat War"
"That Tune Then Taut"
"Them of Mo['] Heft"
"Theology Got Holey"
"There Dip the Pride"
"There, Miss Hermitess"
"A Third Hat Rid" []
"This City, It's Itchy"
"This Dang Sad Thing"
"This Desk the Skids"
"This Go: to Sigh"
"This Kid's Skids-Hit"
"This Load I Had Lost"
"This Pledge Light-Speed" []
"This Rote Theorist"
"This Rut, It Hurts"
"This Un-Shut-In" []
"Tho['] Open, Hope Not to Phone"
"Those Lost, Toothless Hotel Sots"
"Thy Harm a Rhythm"
"Time-Rid, I'm Tired" []
"Timid, Gone, Doing Time"
"Tiny Hero in Theory" []
"Tipsier Pitiers"
"To Cut a Cat Out"
"To Dads at Odds"
"To Emo, Me Too"
"To Fail Flat, Oi" []
"To Figure Grief Out" []
"To Find Din Oft"
"To Find it, Fond"
"To Find No Dif't" []
"To Find Not Dif"
"To Incur Coin Rut in Court"
"To Know OK Town" []
"To My Uncle: Contumely Money Cult"
"To Own Nowt, O" []
"To Pup Up Top"
"To Savor a TV or So"
"To Stay at Toys, Ay, Tots" []
"To-Write-It Tower" []
"Toiled/Lied-To Lit-Ode"
"Toils--I Lost" []
"Tomorrow's Rootworms"
"Tone Deaf Note, Fade" []
"Too Down to Do Now"
"Too Heavy, Yo, Have To" []
"Total Ills: Lost it All"
"Toutatis Sat it Out"
"A Town O['] Want"
"Towns O['] E-Z Tow Zones"
"Tributes I'd Distribute"
"Tried, Let, Retitled"
"Trite Games, Great Times"
"Tru-Rut"
"True I'm So Sour, Time" []
"Tsk, Hide the Kids"
"[']Tude Duet"
"Two Legs Get Slow" []
"Ug, Fired? Figured"
"An Ugly Any-Lug"
"Um, Depths, the Dumps" []
"Um, Earn Manure" []
"Un-Rich Urchin, I Churn"
"Underdog, Dud, Goner" []
"Undoable Alone, Bud" []
"Unions['] Unison"
"Unmarried, Murrained"
"Unsofter Fortunes" []
"Unsweet [']Tween Us"
"Up Last: St. Paul"
"Up, Spare Paupers" []
"Us, Bitter Tributes" []
"Vagabonds['] Sad Van Bog"
"Vain Mr. Marvin" []
"A Vendor Raved On and Over"
"Virtues? I've Ruts"
"Visored Voiders" []
"Wail for Air Flow"
"Was Foul, So Awful"
"Was Not Watson A Town's Wan Sot"
"Way Sore, So Weary"
"The Way, Yet? Haw" []
"Wee Gutsy Sweet Guy"
"Weirdly Wry, Idle"
"Went for Fret Now"
"Went Old, Let Down" []
"Went Up Unwept"
"Wet, Sad, Wasted" []
"What Form of Warmth"
"When I Win, Eh" []
"When Y'Are Anywhere"
"Whiny, I Whinny Why"
"Whosoever, Howsoever"
"Why Not Thy Own"
"Win Not in Town"
"Win Now, Oi? Owin[']" []
"Wince Not, New Tonic, Nice Town"
"Wind On Down In"
"Wish Ren Her Wins" []
"Wishbone When I Sob"
"Woe, Hurt: How True"
"Woesmith Showtime" []
"Woman Mo['] Wan, Man. Ow"
"Won't Lose Low Notes"
"Working King Row" []
"A Worldly Droll Way" []
"Worn-Out-Now Rout" []
"Worries-Rise Row" []
"Wow, Men Now Mew"
"Wrote Rot, Ew"
"W/Scorn I'd Crown-Dis In-Crowds"
"Wyoming on My Wig"
"Yawl'n Wanly"
"Ye Shady Heydays"
"Ye Taxin['] Anxiety"
"Years-Old Loser Day"
"Yep, Lorn, No Reply"
"Yo, Drab Byroad" []
"Yo, I Map Myopia"
"Yon Lone Only One"
"Yow, Shill, How Silly"
"Yule Boss By Louses" []
"Yup, Bro, Mad Bumpy Road"

book presto

table of bedding brands [xxp1]
blurb
"[if player is male]Mr. Blue's[else]Ms. Ruble[end if] Slumber"
"Artiste Mr. A's Air Mattress"
"Bastien's Bassinet"
"Best-Rig Big Rest" []
"Big Nedd's Beddings"
"Blessing-Page Sleeping Bags"
"Bo's Famed Foam Beds"
"Bodett Tot-Bed"
"Bold-Fest Loft Beds"
"The Cap'n's Nap Techs" [p]
"Chiesa Chaise" []
"Comfier Eco-Firm"
"Comfort-Form Cot" []
"Contempo-Coopment"
"Conway YawnCo"
"Copycats['] Spacy Cot"
"Cot-Is-Stoic" []
"A Cot Me-So-Comatose"
"Count's Sun-Cot"
"Coy-Nap Canopy"
"Davenports Dat's PROVEN"
"Davin Divan"
"Dweeb-Arts Waterbeds"
"E-Z Do Doze"
"EconFits Fine Cots"
"Enteric's Rest-Nice" []
"Flee-Bads Leaf Beds" []
"Get-Close-Glee Cots"
"Gold Zone Long Doze"
"I-Am-Spent Naptimes"
"I Catnap Captain" []
"Keep-Warm Meek Wrap"
"Knaub-Kuban A-Bunk"
"Know-Rest Nest-Work"
"LAZ-E-BOD DOZABLE"
"Lee's Top-To-Sleep" []
"Let's-Cope Sleep Cot"
"Low-Slip Pillows" []
"Mom-Shack Hammocks"
"Mr. Cot-of-Comfort" []
"OTC Cot"
"Pan-Nap"
"Panache-Each-Nap"
"PEERLESS SLEEPERS"
"Poseur-Fort Four-Poster (for POSTURE)"
"Prep-Now-a-Power-Nap"
"Repiner-Ripener"
"Rest-O-Store"
"Restster" []
"Safe-Bod Sofa-Bed"
"Sal Pelt Pallets"
"Seed Bay Easy Bed"
"Sertin-Restin['] Insert"
"Sleep Time Slim Tepee"
"Slob-Daze Dozables"
"Slumber Lumbers"
"Snap-Span-Naps"
"SNOOZE-EZ-SOON" []
"Soft Cold Fold Cots"
"Spartan-Art Naps"
"Sundberg Rung-Beds"
"Sure-Lie Leisure" []
"These-Plus Sleep Huts"
"To-Snore-on-Store"
"A Tuck-So Sack-Out"
"Tucson SunCot" []
"Us-As-Top Pass-Out"
"Uvsted Duvets"
"Wear-Debt Waterbed"
"Willsop Pillows"

table of catechism pages [xxp2]
blurb
"A 'touching' article: our kids, Rod, Suki, UI dorks risk duo." [x]
"'817351837 bites I bet' is written on a blank page." [p]
"An ad for Algebra Lab Gear." [x]
"An ad for Hi-Res Shire, which has the lean trim terminal for YOU." [x]
"Add-ins I Disdain, on third-party software." [x]
"Advice from a sod tent and tot dens: don't set dot-nets." [x]
"Ah, info's FASHION." []
"Ah, tinker! Harken it! I Rethank a Thinker." [x]
"Alerting! Triangle Altering? Integral Relating? Tanglier, tanglier!" [x]
"Analysis of the Carter Crater Tracer." [x]
"Another page referring to the seminal work [i]Equations: A Question[r], by Otis Quane." [x]
"Aplomb, regrets, great problems, leet BS program."
"An article called [i]RSI, Sir[r]: Tips on being by a computer too long." [x]
"An article called Recent Net-Rec Center." [x]
"An article on the founding of the Kent's Row Knowster Networks." [x]
"Back, HALT, black hat!"
"Basic regular expressions from [i]I Grep to Grope It[r], by Rog Piet." [x]
"Blame lag? Ballgame!" [x]
"Blather about UserLoc Closure: our cels." [x]
"Boggling blogging: both good and bad." [x]
"Brigit's Bit Rigs: big stir!"
"A bro cues some programming language's obscure sub-core."
"'C is OK? Sicko!' is written in the margins." [x]
"A cartoon: by the way, why a byte?" [x]
"A cartoon: hangs, gnash [']n gash." [x]
"A cartoon: I Dub a bad UI, bud, ai!" [x]
"A cartoon is captioned 'Logout, lout! Go!'" [x]
"A cartoon of administrative mistakes called Duos of Doofus of Sudo." [x]
"A cartoon: Psh, I C his PC Chips." [x]
"Cartoons about software personal relations, featuring Emo OEM Moe." [x]
"Catchier true architecture. Itch, creature."
"A cautionary tale of a beery eBayer." [x]
"A cautionary tale of the last boor who programmed toolbars on a barstool." [x]
"A chapter begins: sir, compel compilers!" [x]
"A character named Senor Uric exclaims 'Us, Cornier?' as he explains recursion." [x]
"A character named Winko Owkin shows how saying 'I KNOW' helps you win, ok?" [p]
"Chi-Spy's Physics." [x]
"Chips Reed deciphers hip creeds." [x]
"A codec ace-doc."
"Coed? Flog code golf!"
"A comic: [i]Online Lonnie, El Nino[r], by Noe Lin." [x]
"A comic poem: Yelp! Shrink! Hyperlinks!" [x]
"Comparisons of NetBios: Ben Tsoi or Bo Stein?" [x]
"Confused? Code's Fun! So fecund!" []
"A confusing example of the TreksCo Rockets Stocker."
"A cool fig of logic."
"Cope, sod: scooped opcodes!"
"Cosine, E-coins: So Nice!" []
"A creed, so: Ed's Core Recodes."
"The debate: piracy v. privacy." [p] [x]
"Debugger buggered? Begrudge!"
"A deconstruction of the elitism of [i]Boolean Loon [a-b][r], by Bo O'Neal." [x]
"Dig now. Godwin? WIN, dog!" []
"A dip paid. iPad?!" [p]
"Discussion of a game of GPS'in pings." [x]
"A discussion of pluses and minuse of the major EOLNs: Olsen, Slone, and Noles."
"A discussion of whether [i]Pa Huck's Hack-Ups[r] was actually written by Cap Husk."
"Dos, eh? Hosed!"
"Dr. Coe's coders['] credos: recs, do!"
"Drivel from Fact-Born Bancroft." [x]
"E-trash haters? Eh, rats."
"Ed Hart endorses Red Hat, noting the rad hatred thread dearth." [x]
"Ed's GUI Guides come recommended." [x]
"A Ego-Log of LeGoGo's dominance as a search engine over SlyCo and OohYa." [x]
"Electric atrial article recital. Critical! Relate!" []
"Enumeration mountaineer? Mean routine!"
"An essay on looking to the future asks, programs or Gramps?" [x]
"Examples of bad UI from Dubai to Baidu."
"Excerpts from [i]Open Source Uprose Once[r], by Enos Couper & Ponce Rouse." [x]
"Excerpts from Pa Grin's [i]Graspin['] Parsing[r], and an opposite view, [i]Sparing Parsing[r] by Paris Ng[r]." [x]
"Exponential explain-note."
"A fascinating recap of the most recent Math Cup Matchup."
"Flaccid generalities and aphorimsms under 'Resigned? Re-design, designer!' It credits Sid Green and Desire Ng." [x]
"Found imp. info dump? Fun, dim op." [p]
"'FTP? PFT! HTTP? THPT!'"
"Gee, wanna slug new languages? Engage un-laws. Wangle, nag, use."
"The geein['] Eigen-Genie describes how formulas can't figure ANYTHING." [x]
"Globals? BS! All go!" [x]
"Grampa's Pragmas."
"Hark Dat Dark Hat, a section on hackers." [x]
"Header Adhere, eh? Read."
"Here's why plugins (GNU, LISP) shouldn't cause gulpins." [x]
"Hitman-in-Math-am hint."
"How to be Cred-Rec'd, by Dr. Deccer." [x]
"How to detect a lurid URL ID." [x]
"How to inspect pectins['] net pics." [x]
"How to put hefts in if-thens." [x]
"How your firewall will fare." [x]
"A howlcraft flowchart."
"I, Barny, binary-brainy."
"'I cap a pic,' advice on Internet memes." [x]
"If STR first, RTF is siftr." []
"'Is derpin['] inspired?' An interesting discussion." [x]
"It's crocked. Direct sock? Doc Rickets['] code tricks/edicts rock!"
"Know, wonk, know!"
"Knuth-Thunk, a pompous biography of computers." [x]
"Lemmas: slam [']em!"
"The life story of Sabermetrics Master Scribe [if player is male]Crabtree Sims[else]Cassi Rembert[end if]." [x]
"A list of Elkins-Lenski-Klein's E-Links." [x]
"List-Op Pilots['] Spoilt Ol['] tips to slip." []
"A lo-tech ol['] etch."
"LocalAlloc: All Cool, Cal."
"Log off of golf!"
"Login lingo oglin[']."
"A long remade readme by Ma Reed. Dear, me!"
"Lord Howell's Hello Worlds."
"Malaise as email: on Internet addiction."
"Mentions of tweest tweets."
"Messy lab assembly may bless? Bye! (SLAMS)."
"The Misc. Chemist Techism explores how computer science applies elsewhere." [x]
"More reference from [i]To Happen on the App[r], by Pop Neath." [x]
"A MS Paint rendering of a spam tin." [x]
"MS Paint tips, man!" [] [x]
"Murals of Formulas, drawn by Rolf Maus." [x]
"My VM: YMMV."
"New shill: 'WinShell?! Hell wins!'"
"'No dice?!' One dic, coined in code."
"Notes from Le Prof of Perl, Pop Rolf Freel." [x]
"Notes on webring brewing." [x]
"Notes scrawled: Duke CS sucked." [x]
"Nyan So Annoys a Sonny." [x]
"Oi! I/O!"
"On the fall of the Richest Itchers, a computer game company." [sir-tech, heh]
"On the Snafu as Fun." [x]
"One page claims to have a radioactive advice ratio." [x]
"One picture of a man trying to out-sprint printouts is actually kind of funny stuff." [x]
"Ops for pros of proofs." []
"Ouch, a grisly tale of a hardcore'd hardcoder." [x]
"An overview of U-Bag-a-Bug software tracking." [x]
"Overviews of Rex Gee's Regexes." [x]
"Pam Gror's programs."
"Parts of an advice column: Go To Dr. Dot-Org." [x]
"A picture of the broad ROM motherboard." [x]
"A picture of the original Vicuna Univac." [x]
"Pip's Nets Snippets pop up in several places." [x]
"Plotnik's Top Links: lots, pink."
"Power is ripe. Sow, wise pro!"
"A primer on OOP, which has been vandalized."
"A print-how section on the Pinthrow-Nipworth-Twiphorn Whiptron." [x]
"A profile of PC Ham, HP/MAC Champ." [x]
"A profile of the computing genius ENIAC Caine." [x]
"Pros of proofs for ops: so, Prof." [x]
"Race-smit? Mistrace Matrices."
"Ragged? Ref: defragger."
"A rant for Fortran."
"Raster Starer? Err, rats, tears."
"Re-deriving, given drier."
"Red? Cope. Pre-code. Proceed." []
"Redef, deref, defer...freed!" []
"Refute a feature, rue fate."
"Reproduce Procedure, Dour Creep! Purer code."
"A review of [i]APIs, APIS[r], by Issa Paip."
"A review of [i]Fathom of Math[r], by Mo Fath."
"A review of [i]Mr. Gee's Merges[r], by Ms. Eger."
"A review of [i]Reborn AI, Airborne[r], by Robin Rea."
"A review of Ow to Woot, Yorpwald's seminal book on programming tricks."
"Samples from the decoding bible Bug Tiffs: Big Stuff." [x]
"Scribbling: U dig GUID I dug?" [x]
"A section labeled Doran's And-Ors." [x]
"Semaphores: ahem, posers phears [']em so." [x]
"A short RHost guide." [x]
"Slashdot? Old stash."
"Slur-URLs: LULs? Urrs..."
"So, input spin out? Point us. Sit up on..." []
"Some neat [']PuterSci Pictures." [x]
"Some semi-mathematical proof piles on epsilon." [x]
"Something about bitmaps baptism." [x]
"Something about to BinHex in the box." [x]
"Sourced ur-codes so crude? Us, decor." []
"StatLib's last bits."
"Step on NetOps? No, pest!"
"Sysadmin says mind, Many Diss."
"The tale of one OS's SOS." [x]
"Tautologies tautologise."
"Tend to Dot net? Not Ted! -- reads some anti-Microsoft propaganda." [x]
"There is a warning against creating a bogus GOSUB or worse, an OS bug." [x]
"A thorough smackdown of [i]Ifdefs? DIE, FFS[r], by Ed Siff." [x]
"Tips for recognizing a hax-o-hoax." [x]
"Tips on not losing logins." [x]
"Tips to avoid the Same Bug Mega-Bus." [x]
"To and-or tornado." []
"A tribute to Odd Hack Haddock." [x]
"A tribute to Rox Fife, fixer of Firefox." [x]
"A tutorial cartoon! Igg Did Dig GDI!" [x]
"A unit for 'No fruit: info rut? Or unfit?'"
"User ruse? Sure, sure."
"The virtues of process scopers, whatever those are." [x]
"We'll love low-level!"
"What's more evil: Prada? DARPA?"
"Why not to dis STDIO do-its."
"Why to consider coders in Doc Erin's." [x]
"Why WLAN care is trickier than lawn care." [x]
"Word processing reviews from [if player is male]Neil[else]Elin[end if] Le In-Line." [x]
"WTF FTW: on creativity and coding." [x]
"Ye algebra agreeably? Garble, aye."
"You flip through multiple instances of someone named Garj on Jargon. JR Noga, too." [x]

table of Leo-Rand chitchat [xxp3]
blurb
"[l-n-r] begin construing trouncings, but not anyone. Just abstractly." [x]
"[l-n-r] discuss the wrestling event: Mean Nils's Nine-Slams Manliness." [x]
"[l-n-r] figure at least they tried, unlike Quit-Goon Quitongo." [x]
"[l-n-r] grit flesh so. 'Fight losers. Griefs. Sloth.'" [x]
"[l-n-r] half-heartedly laugh recounting [i]To Crudest Destructo[r]." [x]
"[l-n-r] half-heartedly recap favorite moments in [i]OK, at a TKO[r]." [x]
"[l-n-r] mention Police Pec-Oil HAS to work." [x]
"[l-n-r] moan they're no Brooks KO Bros." [x]
"[l-n-r] realize they're no Rad Ryno and Rory." [x]
"[l-n-r] regret picking on Pinko Ann Pankonin."
"[l-n-r] regret picking on Pinko Sal Polanski."
"[l-n-r] regret picking on Pinko Shon Hopkinson."
"[l-n-r] suddenly see the sad side of [i]Sucker-Punch Checkup Runs[r]." [x]
"[l-n-r] suddenly sympathize with the losers in [i]Booyahs: Oh, Ay, Sob[r]." [x]
"[l-n-r] try and fail to make that move from Neat-KO Keaton." [x]
"[l-n-r] wonder if Gus Funk Kung-Fus work THAT well." [x]
"[l-r] admits he couldn't handle the regimen of Thickener Kent Reich-Kitchener." [x]
"[l-r] considers ordering Buffs to Bust Off." [x]
"[l-r] considers re-reading [i]The New You, Thou Weeny[r], by Huey Towne." [x]
"[l-r] considers the methods of Dr. Sweat Steward." [x]
"[l-r] considers the Thin Gym: My Thing workout." [x]
"[l-r] discusses Sweaty-Way Set training." [x]
"[l-r] discusses the plexus-suplex, not willing to practice it on each other." [x]
"[l-r] does a quick-start squat trick to try to get into shape." [x]
"[l-r] feels guilt over goonie-noogie: oi, gone." [x]
"[l-r] flatter Typhoon Tony Pho." [x]
"[l-r] recalls good seats at the Limburger Rumble Rig." [x]
"[l-r] recaps favorite quotes from Steroidal Idolaters." [x]
"[l-r] talk of Huck's Pec Checkups." [x]
"[l-r] talks of working at a tungsten guns tent." [x]
"[l-r] vows to read My Abs By Sam." [x]
"[l-r] wonder about the Of Abs So Fab regimen."
"[l-r] wonders if Invig-Givin['] is too good to be true." [x]
"'Adrena-Andrea? Rad?! Nae!'" [x]
"'Big Nox Boxing?! Bing! XO!'" [x]
"'Capt. Boom Combat-Op Boot Camp? Apt combo!'"
"'Diesel Sid Lee? [']Ed ... lies!'"
"Each recaps favorite books to boost KO." [x]
"Each wishes he were a gung ho gun hog." [x]
"'Eats gum? Me gusta!'"
"'Foremost, smote for foe storm. Foremost.'"
"'Galoots also got gals, too. To goals!'"
"'Gawd, dawg. Gaww, gadd,' they say, still unable to believe their defeats." [x]
"'Glob on a GoonLab Bologna~'" [x]
"'Gonzo-goonz? No-goz!'" [x]
"Grunts, strung."
"'Hamstrings...stings...harm!'"
"'I'm such a booby.' / 'I'm such a yobbo.'" [x]
"'Imma Maim,' says [l-r], but his heart isn't in it." [x]
"'In my gut, I...gym nut.'"
"'Kayo! Okay?!' / 'Ay, ya kook!'"
"'Lard? Blah! Hardball!'"
"'Machado Da Macho?! A ham, doc!'" [x]
"'Machos? A schmo.'"
"'Mo[']-slug moguls? Ol['] mugs!'"
"'More focus...sumo force!'" []
"'My, got to gym.'"
"'Nights of no fights? Soft nigh. Thin fogs.'"
"'Not gross. So strong.' they mutter to each other." [x]
"'Nufyn['] Funny.'"
"'One-Trip Protein? No tripe!'"
"'Ow, my teef!' / 'Ow, my feet!'"
"'Oy. Heck. Hockey.'"
"'So weak now. Knows a woe!'"
"'Solid ol['] Sid?' / 'I'd slid, solo.'"
"A stewing: they reconsider visiting Sweating Wingate's." [x]
"They bemoan being on the wrong side of the GPA gap." [x]
"They both enjoy the Exhil-Helix coaster rides."
"They both recall reading 'Hi-Fat? Ha? FIT' as kids. It givs you faith, that each remembers ... a fith."
"They both reckon they need to do abs so bad." [x]
"They consider applying to the We-Mighty White Gym."
"They consider radico-cardio."
"They cry how they're no Dyna-Andy Nady." [x]
"They discount the side effects of Brain-Rust NutriBars." [x]
"They discuss Bilal's ill abs."
"They discuss favorite flavors of Clobber Cobbler." [x]
"They discuss how to rip mo['] primo."
"They discuss techniques from Strongmen Gent Norms."
"They discuss the training methods of Hard-Way Hayward." [x]
"They discuss Tricep-Rip Tec." [x]
"They discuss what to buy from the Sporty Pro Sty." [x]
"They discuss whether Alec's Escal-Laces really add 2 inches to your gym shoes['] vertical." [x]
"They discuss working out at Expend-Pex Den." [x]
"They disparage Mo-Funk Monk-Fu." [x]
"They dream of Ole Vince Violence." [x]
"They find the To-Scare Coaster an ace sort." [x]
"They find they both love the song [i]Loud boys? Doubly So, Bold Yous[r]." [x]
"They hear it's really exciting at the Anarch-a-Ranch." [x]
"They know how poor Ted Torpedo felt." [x]
"They know they'll never be Typee Petey." [x]
"They manage to misppel pimples." [x]
"They mention there's something off about Mista Vin Vitamins." [x]
"They mumble about some dim lame dilemma." [x]
"They need U-GOTS-GUSTO for when gusts go out, even if it might cause gouts."
"They pine for Rip-Em-Prime."
"They plot ways from U SOFT to SO TUF." [x]
"They recall friendly dust-ups: Stu, Spud." [x]
"They recap the latest Mach-Boor/Arch-Boom Rochambo tournament, sponsored by Moorbach and won by Hobo Marc." [x]
"They recap the workout routines of Expand-Pex Dan." [x]
"They recap their favorite literary work, Us Was a Wuss." [x]
"They recount pro wrestling triple-wrongs." [x]
"They recount the best of [i]Pissant Pastins[r]. 'It snaps!'" [x]
"They recount the GimpyNet Inept Gym emptying." [x]
"They regret saying yoga's so gay but still won't eat a soggy soya." [x]
"They remember both being despot depots-posted." [x]
"They remember winning their local Turbo-Bruto contests: 'our trot, Bub.'" [x]
"They reminisce of melee fests, of self esteem." [x]
"They reminisce on shmoes['] moshes." [x]
"They rhapsodize about 'I burn' Bruin Rubin."
"They share menmost moments." [x]
"They share the best panels of the comic strip 'U THINK I THUNK' from Ink-Hut." [x]
"They should've gotten a punchage change up or cheap gun from Ape Chung." [x]
"They take time to admire 'Le Plow' Powell." [p] [x]
"They wish for HamCo Macho-Mocha (ach, mo[']!)[line break]" [p] [x]
"They wonder aloud how to exert tidy dexterity." [x]
"They wonder if I'm-Strong-Gro Mints really work." [x]
"They're both glad they didn't grow up in Far Friff with riff-raff."
"'Ugly slam, small guy.' La, smugly? As glumly"
"'Upbeat?! Beat-up!'"
"Urghs. Shrug."
"'Woomph! Phwoom! Mo['] whop!'" [x]

table of Leo-Rand idols [xxp4]
blurb
"[n-t] 'Bam' Bateman" []
"[tt] 'Thud' Douthit"
"Abe 'Grr' Garber" []
"Ace 'Grr' Crager"
"Acker 'Wham' Marchewka" []
"Adam 'Bam' Madamba"
"Adela 'Pecs' Depascale"
"Agile Carl Callegari" []
"Agile Don DiAngelo" []
"Agile Vern Graveline" []
"Al 'Bam' Lamba"
"Al 'Pecs' Caples" []
"Aldo 'Wham' Mahowald"
"Alec 'Bonk' Colebank"
"Ali 'Pecs' Plescia" []
"Aly 'Hook' Holyoak"
"Amazon Ro Zamorano"
"Amie 'Grr' Armiger" []
"Angie 'Grr' Grainger" []
"Ann 'MMA' Ammann"
"Ann 'Smack' Sackmann"
"Anton 'Blam' Montalban"
"Ardis 'Boom' D'Ambrosio"
"Ardis 'Kapow' Paradowski"
"Ariel 'Blam' Mirabella" []
"Aron 'Bam' Boarman"
"Backbone-Conk Babe"
"Baird 'Ouch' Robichaud"
"Bari 'Blam' Brambila"
"Barney 'Grr' Granberry"
"Bart 'Hook' Bookhart"
"Battler Talbert-Barlett"
"Beast Chara Bastarache" []
"Beast Rhine Eisenbarth" []
"Beast Sina Sebastian"
"Beau 'Grr' Burrage" []
"Ben 'Rock' Norbeck"
"Bennie 'Grr' Berninger"
"Bernal 'Zot' Brazelton"
"Bernard 'Hook' Hardenbrook" []
"Bernie 'Grr' Berringer"
"Bert 'Sock' Rebstock-Storbeck"
"Bette 'Grr' Rettberg"
"Blair 'Bam' Brambila" []
"Body Man Dan Moby"
"Bonk-Its Botkins"
"Boomer Lita Bartolomei" []
"Born-Huge Boughner" []
"Brad 'Ouch' Bouchard"
"Brad 'Zot' Dobratz"
"Breana 'Ouch' Charboneau"
"Bree 'Rock' Broecker"
"Brenda 'Ouch' Chadbourne"
"Brett 'Blam' Bramblett"
"Bridget 'Sock' Stockbridge"
"Brodie 'Bonk' Bookbinder"
"Bruce 'MMA' Macumber"
"Brute Al Breault" []
"Brute Annis Braunstein" []
"Brute Caryn Canterbury" []
"Brute Caton Betancourt" []
"Brute Chalk Buckhalter"
"Brute Chet Burchette"
"Brute Ennis Rubenstein"
"Brute Garman Baumgartner" []
"Brute Gil Guilbert"
"Brute Harley Leatherbury" []
"Brute Innis Rubinstein"
"Brute Jo Joubert"
"Brute Lach Culbreath" []
"Brute Mars Burmaster" []
"Brute Miers Burmeister"
"Brute Rhea Brethauer" []
"Brute Ted Burdette" []
"Brute Ty Buttrey" []
"Brute Tyra Atterbury"
"Brute Wray Waterbury"
"Bud Tony, Body Nut"
"Buff Alsteen Stufflebean"
"Buff Dora Bouffard"
"Buff Maltese Stufflebeam"
"Buff Noe Buffone"
"Buff Ro Boruff" []
"Burly Bry Lu"
"Calamity Lita Macy"
"Calamity Tami Clay"
"Caleb 'Grr' Carlberg"
"Cari 'Bam' Cambria"
"Cari 'Boom' Ambrocio" []
"Carlo 'Thud' Coulthard"
"Carn 'Bonk' Brannock"
"Cason 'Zot' Costanzo"
"Chad 'Bam' Dambach"
"Chandler 'Bam' Chamberland" []
"Charline 'Bam' Chamberlain" []
"Chas 'Bonk' Bohnsack"
"Chase 'Grr' Schrager"
"Chen 'MMA' Mcmahen"
"Cher 'Bonk' Hornbeck"
"Cher 'Sock' Schroeck"
"Cher 'Zot' Trochez"
"Cherie 'Bam' Bachmeier" []
"Chet 'Bam' MacBeth"
"Chi 'Blam' Limbach"
"Chin 'Blam' Chamblin"
"Cho 'Blam' Halcomb"
"Chun 'Bam' Buchman" []
"Clem 'Rock' Mccorkle"
"Clobbering Bob Clinger" []
"Cole 'Bam' Lacombe" []
"Coren 'Ouch' Cochenour"
"Curry 'MMA' Mcmurray"
"Curt 'Bonk' Buntrock"
"Dale 'Grr' Gerrald"
"Dan 'Bam' Badman"
"Dan 'MMA' Damman"
"Dana 'Blood' Baldonado"
"Dana 'Grr' Garrand"
"Dara 'Grr' Garrard"
"Darin 'Ouch' Chouinard"
"Daron 'Bam' Boardman" []
"Dean 'Grr' Gardner"
"Debi 'Grr' Bridger" []
"Dee 'MMA' Medema"
"Del 'Sock' Sedlock"
"Delta 'Sock' Stockdale" []
"Denis 'Rock' Dickerson" []
"Devona 'Grr' Vangorder" []
"Devona 'Rock' Vandercook"
"Diane 'Grr' Gardiner" []
"Dina 'Ouch' Chaudoin"
"Dina 'Sock' Dickason" []
"Dina 'Zot' Tiznado"
"Don 'Bam' Bodman"
"Don 'Blam' Boldman"
"Don 'Wham' Downham"
"Dona 'Grr' Norgard" []
"Dora 'Pecs' Pescador"
"Dori 'Blam' Lombardi" []
"Doris 'Guns' Sigurdson"
"Dorla 'Pow' Waldroop"
"Doug 'Blam' Goldbaum" []
"Droppin['] Pip Dorn" []
"Earl 'Ouch' LaRouche" []
"Earl 'Pecs' Placeres" []
"Earle 'Ouch' Rocheleau"
"Eboni 'Grr' Obringer-Broering"
"Ed 'Guns' Sugden"
"Eden 'Rock' Eckenrod"
"Edie 'Grr' Rediger"
"Edie 'MMA' Miedema"
"Eli 'Bam' Mabile" []
"Eli 'Grr' Rigler"
"Eli 'Sock' Solecki" []
"Elia 'Bam' Amabile" []
"Elia 'Splat' Espaillat"
"Elias 'Bam' Lambiase" []
"Elie 'Grr' Riegler"
"Ella 'Grr' Garrell"
"Ella 'Pow' Walpole"
"Ella 'Rock' Locklear" []
"Elma 'Pow' Wampole"
"Else 'MMA' Salemme"
"Elser 'Bam' Belmares" []
"Elva 'Sock' Slovacek"
"Ely 'Blam' Bellamy" []
"Ely 'Rock' Lockyer"
"Em 'Thud' DeMuth" []
"Emma 'Grr' Grammer"
"Emmi 'Grr' Grimmer"
"Ena 'Splat' Pleasant"
"Enid 'Guns' Duensing"
"Enid 'Sock' Dickeson" []
"Ennis 'Rock' Nickerson" []
"Enos 'Bam' Boseman" []
"Enos 'MMA' Moseman"
"Enos 'Whap' Openshaw"
"Erica 'Grr' Carriger"
"Erich 'Guns' Scheuring"
"Erin 'Blam' Liberman" []
"Erin 'Ouch' Icenhour" []
"Erin 'Sock' Erickson" []
"Erinn 'Sock' Nickerson" []
"Erma 'Bonk' Bronkema" []
"Ernie 'Blam' Lieberman" []
"Ernie 'Splat' Pearlstein"
"Erol 'Bam' Lombera" []
"Esther 'Rock' Strohecker"
"Etta 'Grr' Garrett"
"Etta 'Ouch' Teachout"
"Eura 'Bam' Rambeau" []
"Eva 'Grr' Graver"
"Ezra 'Bam' Zaremba"
"Fit Al Latif"
"Fit Andres Standifer" []
"Fit Earl Telfair" []
"Fit Leclair Fraticelli"
"Fit Lon Loftin"
"Fit Lord Tilford"
"Fit Peter Perfetti"
"Fit Rees Seifert-Siefert-Feister" []
"Fit Rene Neifert"
"Fit Ron Fortin" []
"Fit Sean Stefani" []
"Fit Selden Feldstein-Steinfeld"
"Fit-Self Setliff"
"Fit Sol Loftis" []
"Fit Speer Pfiester"
"Fit Welch Leftwich"
"Flexing Glen Fix"
"Friedl 'Boom' Broomfield"
"Gaines 'Blam' Blasingame" []
"Gale 'Bam' Gambale"
"Garth 'Pow' Gawthrop"
"Gary 'Thud' Daughtry" []
"Gaye 'Thud' Daughety" []
"Gene 'Bam' Begeman" []
"Gennie 'Grr' Greninger"
"Geri 'Bam' Brimage" []
"Gia 'Rock' Rogacki"
"Giant Ek Keating" []
"Giant Elser Easterling" []
"Giant LaDue Daigneault" []
"Giant Lene Galentine" []
"Giant Ryles Singletary" []
"Giant Su Agustin" []
"Giant Ula Lantigua" []
"Giant Viola Vitagliano"
"Giant Weller Gillenwater" []
"Giant Werner Weingartner" []
"Gil 'Blam' Gambill"
"Gill 'MMA' Gammill"
"Glen 'Rock' Glockner"
"Gym Rat Ty Gram"
"Hanner 'Bam' Habermann"
"Hardy 'Ouch' Choudhary"
"Harmon 'Pecs' Macpherson" []
"Hecate the Ace" []
"Hegler 'Bonk' Kohlenberg"
"Heide 'Grr' Herridge"
"Hercules 'Crush' Lee"
"Herma 'Sock' Schomaker" []
"Herman 'MMA' Hammerman"
"Huge Ira Higuera"
"Huge Ly Hugley"
"Huge Mccay McCaughey"
"Huge Nat Hungate" []
"Huge Rita Gauthier" []
"Huge Tardy Daugherty"
"Huge Zina Huizenga"
"Hulk Man Kuhlman"
"Hunk Ares Hunsaker" []
"Hunk Cruse Hunsucker"
"Hunk Mal Kuhlman" []
"Hunk Sid Hudkins"
"Hurlbert 'Sock' Brocklehurst"
"Hy 'Blam' Hambly"
"I-Be-Ouch Bouchie"
"I-Mash Misha" []
"Ida 'Bam' Badami"
"Ida 'Grr' Girard"
"Ike 'Grr' Kriger"
"In-Shape Phineas"
"India 'Grr' Girardin"
"Ines 'Rock' Erickson" []
"Ione 'Grr' Roering" []
"Ione 'MMA' Maimone"
"Ira 'Blam' Mirabal"
"Irma 'Sock' Mocarski" []
"Ivy 'Rock' Vickroy"
"Jan 'Sock' Jackson" []
"Jenni 'Bam' Benjamin" []
"Jere 'Guns' Juergens"
"Kali 'Guns' Klausing"
"Kandi 'Rock' Kondracki" []
"Karl 'Zot' Kotlarz"
"Kasia 'Wham' Kawashima"
"Kena 'Bam' Bakeman"
"Kena 'Blam' Blakeman"
"Kersti 'Pow' Petrowski"
"Kirby 'Guns' Kingsbury"
"Kit 'Sock' Kostick"
"KO-Grind King Rod"
"Kristie 'Pow' Pietrowski"
"Laci 'Guns' Clausing"
"LaGarde 'Blam' Gambardella"
"Lan 'Blam' Ballman"
"Lan 'Ouch' Calhoun"
"Lang 'Ouch' Coughlan" []
"Lanita 'Zot' Lattanzio"
"Large Ben Belanger"
"Large Bev Belgrave" []
"Large-Bonk Longbrake" []
"Large Ed Arledge" []
"Large Enid Geraldine" []
"Large Hal Gallaher" []
"Large Lou Arguello" []
"Large Milo Gallimore" []
"Large Ron Loranger" []
"Larsen 'Thud' Sutherland" []
"Layne 'Thud' Delahunty"
"Lea 'Guns' Lagunes"
"Lea 'Sock' Sealock" []
"Lee 'Bonk' Knoebel"
"Leia 'Pecs' Speciale"
"Len 'Blam' Bellman" []
"Len 'Guns' Gunnels"
"Len 'MMA' Melman"
"Leona 'Grr' Loranger" []
"Les 'Bam' Balmes" []
"Les 'Zot' Stolze"
"Leta 'Ouch' Latouche" []
"Letty 'Boom' Bottomley"
"Lev 'Zot' Voeltz"
"Lew 'Bam' Wamble"
"Lin 'Blam' Billman"
"Lin 'MMA' Milman"
"Lin 'Sock' Nickols" []
"Lina 'Guns' Lusignan"
"Lina 'MMA' Mailman"
"Lina 'Sock' Nickolas" []
"Ling 'Bam' Gamblin" []
"Ling 'Ouch' Coughlin"
"Linh 'Bam' Hamblin" []
"Linh 'Splat' Stanphill"
"Link 'Sock' Skolnick"
"Lionel 'Grr' Rollinger"
"Lis 'Kapow' Pawloski"
"Lo-Carb Bo Carl"
"Loma 'Bop' Palombo"
"Loreta 'Boom' Bartolomeo"
"Luc 'Boom' Columbo" []
"Luc 'Splat' Stallcup"
"Luce 'Boom' Coulombe"
"Lucio 'Bam' Columbia"
"Lurie 'Bonk' Kilbourne" []
"Ly 'Boom' Lomboy"
"Lyle 'Sock' Locksley"
"Mabel 'Rock' Blackmore" []
"Mac 'Bonk' Bockman"
"Mac 'Grr' Mcgarr"
"Mace 'Bonk' Boeckman"
"Mack 'Zot' Tomczak"
"Mara 'Guns' Sugarman"
"Marc 'Bonk' Brockman"
"Mason 'Guns' Magnusson"
"Matt 'Sock' Mattocks"
"Maude 'Grr' Magruder" []
"Maul-Bop Palumbo" []
"Maul Giant Manigault" []
"Meline 'Grr' Remlinger"
"Mercy 'Sock' McCroskey"
"Mia 'Pecs' Campise"
"Mina 'Rock' Marcinko" []
"Misti 'Hook' Kishimoto"
"MMA Hood Mahmood"
"Mona 'Guns' Magnuson"
"Ms. Ouch-So-Much" []
"Mustang Stugman" []
"MVP Napier Vipperman" []
"Nat 'Guns' Unangst"
"Nat 'Hook' Khatoon"
"Nat 'Ouch' Cauthon"
"Neal 'Smash' Hasselman" []
"Neal 'Thud' Delahunt"
"Nell 'Guns' Gunnells"
"Nestor 'Blam' Lambertson" []
"Nestor 'Sock' Rosenstock"
"Nettie 'Grr' Rettinger"
"Nice-Wham Wiechman"
"Nick 'MMA' Mcmakin"
"Nina 'Ouch' Counihan"
"Noe 'Bam' Beamon" []
"Noe 'Grr' Groner"
"Noe 'MMA' Mamone"
"Noemi 'Grr' Rominger" []
"Olsen 'Pow' Powelson"
"Oma 'Bonk' Bookman"
"Omar 'Bonk' Brookman"
"Ona 'Grr' Garron"
"Opal 'Bam' Palomba"
"Oren 'Bam' Boerman" []
"Oren 'Ouch' Cohenour"
"Oscar 'MMA' Sammarco"
"Paolo 'Guns' Spagnuolo"
"Plain Stud Duplantis" []
"Pro [n-t] Paterno" []
"Pro Ada Porada"
"Pro Agnus Purgason"
"Pro Aldo Lopardo"
"Pro Ali Priola"
"Pro Alina Apolinar" []
"Pro Alma Palomar" []
"Pro Alta Laporta-Parlato" []
"Pro Ana Napora"
"Pro Art Parrot"
"Pro Asa Raposa"
"Pro Asia Paraiso"
"Pro Bert Probert"
"Pro Cara Capraro"
"Pro Caron Corporan"
"Pro Cher Porcher"
"Pro Chia Porchia" []
"Pro Cora Porcaro"
"Pro Cordie Cooprider"
"Pro Dale Leopard" []
"Pro Dan Padron" []
"Pro Dean Peardon" []
"Pro Dee Peredo"
"Pro Eda Pardoe"
"Pro Ellie Riopelle"
"Pro Elma Palermo" []
"Pro Ena Perona"
"Pro Erin Perrino" []
"Pro Esta Pastore" []
"Pro Ester Restrepo" []
"Pro Gale Pergola"
"Pro Geri Perrigo"
"Pro Ian Arpino"
"Pro Ida Parodi" []
"Pro Isaac Sparacio"
"Pro Kasha Prohaska" []
"Pro Lea Lopera" []
"Pro Leah Harpole"
"Pro Leo Looper" []
"Pro Lila Parillo" []
"Pro Lise Piersol" []
"Pro Lucie Lupercio"
"Pro Meda Padmore" []
"Pro Mona Poorman" []
"Pro Nick Pickron"
"Pro Nigel Oplinger" []
"Pro Omar Ramroop"
"Pro Ona Proano"
"Pro Regine Peregrino" []
"Pro Rene Perrone" []
"Pro Retta Perrotta"
"Pro Rina Parrino" []
"Pro Sade Pedrosa"
"Pro Sana Sparano"
"Pro Santa Pastrano" []
"Pro Sean Pearson" []
"Pro Seth Stopher" []
"Pro Stacee Pescatore"
"Pro Sue Prouse" []
"Pro Tamie Imperato" []
"Pro Tara Porrata"
"Pro Tera Portera"
"Pro Teri Portier"
"Pro Tessa Peatross" []
"Pro Tia Poitra" []
"Pro Tisa Poitras" []
"Pro Tonie Petronio" []
"Pro Tony Portnoy"
"Pro Tyra Praytor" []
"Pro Waldo Waldroop" []
"Pro Wes Powers" []
"Pro Zada Podraza"
"Rae 'Blam' Marable-Malerba" []
"Rae 'Wham' Wareham"
"Rana 'Zot' Tarazon"
"Rees 'Blam' Belmares" []
"Regina 'Grr' Garringer"
"Ren 'Pecs' Spencer" []
"Ren 'Thud' Thunder" []
"Ren 'Wham' Wehrman"
"Rena 'Bam' Bearman" []
"Rena 'MMA' Amerman"
"Rena 'Sock' Ackerson" []
"Renata 'Bop' Bonaparte" []
"Renate 'Wham' Weatherman"
"Rene 'Bam' Beerman" []
"Rene 'Sock' Eckerson"
"Renne 'Bam' Breneman" []
"Renzi 'Blam' Zilberman"
"Retta 'Hook' Toothaker"
"Rey 'Blam' Bramley-Marbley"
"Rey 'Guns' Gurnsey"
"Rey 'Sock' Croskey" []
"Rey 'Splat' Spratley"
"Rhett 'Bam' Trembath"
"Rich 'Guns' Schuring"
"Rita 'Blood' Dibartolo" []
"Rita 'Boom' Morabito" []
"Robt 'Smack' Backstrom"
"Rocio 'Bam' Ambrocio" []
"Rocio 'Splat' Policastro"
"Rod 'Blam' Lombard-Lombard" []
"Rod 'Guns' Grounds"
"Rod 'Pecs' Prescod"
"Roe 'Guns' Surgeon"
"Roe 'Splat' Portales"
"Rollo 'Bam' Broomall"
"Ron 'Bam' Amborn" []
"Ron 'Blam' Lamborn"
"Ron 'MMA' Morman-Marmon"
"Roni 'MMA' Marmion"
"Ronna 'Guns' Gunnarson"
"Ros 'Wham' Worsham"
"Rosa 'Thud' Southard" []
"Rose 'Bam' Boersma" []
"Rose 'Bonk' Brookens"
"Rose 'Splat' Spoelstra"
"Rosie 'Bam' Ambroise" []
"Rosita 'Bonk' Stainbrook" []
"Rough Abe Orebaugh"
"Rough Ben Boughner" []
"Rough-Blam Malbrough" []
"Rough Dan Draughon"
"Rough Ed Dougher" []
"Rough Gene Greenough" []
"Rough Ian Hourigan"
"Rough Lamb Malbrough" []
"Rough Len Loughner"
"Rough Rod Dorrough"
"Rough Tod Thurgood" []
"Rubie 'Bam' Bierbaum"
"Rubin 'Bam' Birnbaum" []
"Ryan 'Bam' Brayman"
"Ryner 'Bam' Berryman" []
"Sal 'Bam' Balsam"
"Sal 'MMA' Malsam"
"Santina 'Wham' Swaminathan"
"Santone 'Grr' Rosengrant"
"Sarah 'Bam' Abrahams" []
"Sarina 'Bam' Barsamian" []
"Sean 'Rock' Ackerson" []
"Sean 'Splat' Pleasants"
"Seldon 'Thud' Huddleston"
"Senior 'Whap' Spainhower" []
"Sera 'Splat' Lastrapes"
"Shane 'Pow' Openshaw" []
"Shaunte 'Sock' Stockhausen"
"Shen 'Ouch' Houchens"
"Sherley 'MMA' Hammersley"
"Shin 'Blam' Shamblin"
"Shin 'Ouch' Houchins"
"Shon 'MMA' Hammons"
"Si 'Wham' Wisham"
"Sid 'Bonk' Dobkins"
"Sina 'Ouch' Chiusano" []
"Sina 'Zot' Santizo"
"Slammer Mel Mars" []
"Smack-Hero Schomaker" []
"Smackin['] Mick-San" []
"Smackin['] Nick Sam" []
"Smash-Tot St. Thomas"
"Snap-Him Shipman"
"So Macho Chas Moo"
"So Macho Mac Shoo"
"So Macho Ms Ochoa"
"Sockiner Erickson" []
"Son 'Bam' Bosman"
"Son 'Blam' Lambson" []
"Sonia 'Grr' Garrison" []
"Soren 'Blam' Lamberson" []
"Stan 'Bonk' Bankston"
"Star 'Hook' Hartsook"
"Stone 'Blam' Bostelman" []
"Stone 'Wham' Mathewson" []
"Strong Beene Engebretson" []
"Strong Em Engstrom" []
"Strong Hal Langhorst"
"Strong Lieb Gilbertson" []
"Strong Mei Motsinger" []
"Strong Mirna Morningstar" []
"Strong Rae Garretson" []
"Strong Rena Rosengrant" []
"Strong Roe Torgerson" []
"Strong Teel Longstreet" []
"Stud Earle Truesdale" []
"Stud Harbor Broadhurst"
"Stud Holden Huddleston" []
"Stud Lon Ostlund"
"Stud Perine Turnipseed" []
"Stud Saul Dussault"
"Stud Tarvin Sturdivant"
"Su 'Bam' Mabus-Busam"
"Su 'Whap' Upshaw"
"Sweaty-Way Set"
"Tana 'Bam' Manabat"
"Tank Earls Stalnaker"
"Tank Elsy Tanksley"
"Tank Emert Ketterman"
"Tank Erwin Warkentin"
"Tank Ison Atkinson"
"Tank Meri Martinek" []
"Tank Ro Kantor"
"Tank Seyler Tankersley"
"Tank So Stanko"
"Tank Spear Pasternak" []
"Tank Tignor Tarkington" []
"Tarah 'Guns' Straughan"
"Ted 'Rock' Dockter"
"Teena 'Grr' Gaertner" []
"Tera 'Blood' DeBartolo" []
"Teri 'Blam' Lamberti"
"Teron 'Blam' Lamberton" []
"Terresa 'Bonk' Stonebraker" []
"Thea 'Grr' Gerhart" []
"Thersa 'Blam' Halberstam" []
"Thorsen 'MMA' Smotherman"
"Thug Arie Gauthier" []
"Thug Earl Laughter" []
"Thug Ena Hungate" []
"Thug Noah Haughton" []
"Thug Nona Naughton" []
"Thug Rene Guenther" []
"Tia 'Guns' Agustin"
"Tina 'Zot' Zanotti"
"Tito 'Thud' Douthitt"
"TKO Alan Kantola"
"TKO Ali Kotila"
"TKO Amos Tomasko"
"TKO Amy Motyka"
"TKO Ana Katona-Takano"
"TKO Annis Atkinson" []
"TKO Ara Kotara"
"TKO Bowers Westbrook" []
"TKO Chausse Stackhouse"
"TKO Cher Eckroth"
"TKO Chet Hockett"
"TKO Elsy Stokely" []
"TKO Ena Keaton" []
"TKO Ensign Stoneking" []
"TKO Hal Kathol"
"TKO Ken Knotek"
"TKO Lea Ketola"
"TKO Len Kelton"
"TKO Lina Antolik"
"TKO Lon Kolton"
"TKO Mei Miotke" []
"TKO Mi Timko"
"TKO Mo Tomko"
"TKO Naoma Nakamoto"
"TKO Noah Khatoon" []
"TKO Oretha Toothaker" []
"TKO Rae Keator"
"TKO Rasch Hartsock"
"TKO Rees Koester" []
"TKO Rosia Kooistra"
"TKO Sal Kostal" []
"TKO Sam Matsko"
"TKO Shera Hoekstra" [] []
"TKO Sima Tomasik"
"TKO Sina Atkison" []
"TKO Son Kontos"
"Tona 'Bam' Boatman" []
"Tone 'Splat' Stapleton"
"Toni 'Ouch' Coutinho"
"Tonita 'Guns' Tousignant"
"Tora 'MMA' Tammaro"
"Torie 'Blam' Baltimore" []
"Tran 'Bam' Bartman"
"Tran 'Ouch' Cauthorn"
"Tran 'Pow' Prowant"
"Trey 'Blam' Lamberty" []
"Trim Agnes Stgermain" []
"Trim Alline Martinelli"
"Trim Ana Martina" []
"Trim Celsa McAlister" []
"Trim Delana Martindale" []
"Trim Diane Demartini" []
"Trim Ella Martelli"
"Trim Evie Metivier"
"Trim Haden Meinhardt" []
"Trim Ian Martini"
"Trim Lea Latimer" []
"Trim Noble Tomberlin"
"Trim Omer Mortimer"
"Trim Sean Martines" []
"Trim Soon Ormiston"
"Trim Stan Stmartin" []
"Trim Tad Dittmar" []
"Trim Ted Dittmer"
"Trim Tora Marriott"
"Trim Zane Martinez"
"Trinh 'Pow' Winthrop" []
"Trish 'Wham' Whitmarsh"
"True Hoss Southers"
"Tse 'Wham' Mathews" []
"Tuf Aron Fortuna" []
"Tuf Auld Dufault"
"Tuf Cate Faucett"
"Tuf Dora Furtado"
"Tuf-Fears Stauffer"
"Tuf Lon Fulton"
"Tuf Lorena Lafortune" []
"Tuf Maas Mustafa" []
"Tuf Nees Fuentes"
"Tuf Olga Falgout"
"Tuf Oren Fortune" []
"Tuf Rosa Frausto" []
"Tuf Shel Shufelt"
"Tuf Sol Loftus" []
"Tuff Celis Sutcliffe"
"Tuff Lis Sutliff"
"Tuff Rose Stouffer" []
"Tuff Sera Stauffer" []
"Ty 'Blam' Maltby"
"Tyler 'Bam' Tremblay" []
"Uhlig 'Bam' Limbaugh" []
"Una 'Zot' Tuazon"
"Vast Ann Vansant"
"Vast Ely Stalvey" []
"Vast Leora Salvatore" []
"Vast Normie Viramontes"
"Vast Nutter Sturtevant"
"Vast Ola Salvato" []
"Vast Rae Tavares" []
"Vera 'Zot' Oravetz"
"Walt of Low Fat"
"Walther 'Boom' Bartholomew" []
"Well-Built Wilt Buell"
"Wham-Hit Whitham"
"Wilmer 'Thud' Wildermuth"
"Wm 'Ouch' Muchow"

table of research topics [xxp5]
blurb
"[if player is male]Craig Abel[else]Alica Berg[end if][']s Algebraics"
"abstrusest substrates"
"Achilles helicals" []
"Acme Bros. Macrobes" []
"Adriance canaried radiance" []
"Adroit Tirado Ardito" []
"adsorb-boards" []
"age-verse veerages"
"Agostinelli's legislations"
"Alison's Sialons"
"Allister Literals" []
"Almeida's Maladies"
"amateur e-trauma"
"Amico's mosaic" []
"Amnestied dementias"
"the ample apple lemma"
"Analogism magnolias" []
"Ann Scott's constants"
"antic frog go-frantic factoring" []
"antimuons['] mountains" []
"Arqua's Quasar"
"Asbury's sub-rays"
"Asperger's presagers"
"Asselin salines"
"assessing gassiness"
"Astorino orations"
"Astrid triads" []
"astringent integrants"
"atom-units mutations"
"Attinger Treating"
"Augustine's Usage Units"
"avant-garde graven data"
"avid protein deprivation"
"Baier's Rabies Ribase"
"Bailly's syllabi"
"Balaguer's arguables"
"Baldwin's Wind Labs"
"Balestra ratables"
"Barbero's absorber"
"Barlage's algebras"
"Bartoli's orbitals" []
"Basinger bearings" []
"Bavaleri's Variables"
"Bellugo's Globules"
"Belmares's assembler" []
"Ben Chu's bunches"
"Bertlesen's trebleness"
"Bessing Bigness"
"Best-Bets Ebbs Test" []
"Blauler Rubella"
"the Blomper Problem"
"bossier riboses" []
"Branco's carbons"
"Brausell rubellas"
"Breault's true labs"
"Briarton brain-rot" []
"Broering's Resorbing"
"Bromsey embryos"
"Bucci's Cubics"
"Bussiere's subseries"
"Butcher's chest-rub" []
"Cabateri bacteria"
"Camillo's localism"
"Camisso Mosaics"
"Canevari Variance"
"Cansino's scansion"
"Cantley latency" []
"Caperton co-parent portance" []
"Caplister Particles"
"Capote's PECOTAs"
"Capsin panics"
"the Capster Spectra"
"Caradine's radiances"
"careerist traceries"
"Carhart's catarrhs"
"Carpenito's recaptions"
"Carthage Chartage"
"Casein as nice"
"cassene encases"
"Casterline centralise-interlaces"
"Castlean analects"
"Catone's octanes" []
"Cavendish Dev-Chains"
"Cedeno's encodes"
"the centroid doctrine"
"Ceramist matrices"
"Ceroli's Recoils"
"Cerrato's reactors"
"Chelsie Schiele Helices"
"Chemists['] Techisms"
"Cindie's indices"
"Cittrano Traction"
"Clasp-Rite Particles"
"Clay's Acyls"
"Clayborn's carbonyls"
"Cletrone's electrons"
"clothiers['] chlorites"
"coarsening ignorances"
"Cocini's Iconics"
"Cofer's forces"
"Colasanti's scalations"
"Columbo's Coulombs"
"Comeau's mucosae"
"Comic Sans scam coins" []
"Consalvo volcanos"
"Contini's nicotins"
"coolant octanol"
"Coombs-Boscom Combos" []
"Coopersmith's mesotrophics"
"Coppinger coppering" []
"Copycats['] coy pacts" []
"cornitude reduction" []
"Cortesian Creations Reactions" []
"cosseted cestodes"
"cotinine/nicotine"
"Coulter's clotures"
"Cox-Epstein Exceptions" []
"the Coxter cortex"
"crampiest impacters"
"Creedon's censored seconder encoders" []
"Crenna's scanner"
"Crevito's Vortices"
"Crevost vectors"
"Crofta's factors" []
"Crombie's Microbes"
"Cudmore's decorums"
"Culligan's callusing"
"Cundrie's inducers"
"Curenton's nocturnes"
"Cureton's Snort-Cue Counters" []
"Cutino's suction"
"Cutrone's counters" []
"cysteines['] necessity"
"D'antonio's donations"
"Dahlheimer's hemihedrals"
"Daidone's anodised adenoids"
"Daigrepont pignorated readopting" []
"Dan Drast's standards"
"Danielson nonideals" []
"Daws wads"
"Dearing's readings"
"Deason anodes" []
"Death-ish Tad Hsieh" []
"Debrosse bedsores" []
"Deighan's headings" []
"DeMarinis meridians" []
"derivational revalidation"
"Deroche's chordees"
"Desanctis distances"
"Dicenzo's zincodes"
"Dingess Designs"
"Disney's endysis"
"distender dendrites"
"Doc Poe's opcodes"
"dorky mean dark money"
"Dorsch chords" []
"Dossiter steroids"
"Dr. Miaga's Diagrams"
"Draggin['] grading"
"Dragonne's Androgens"
"drama pigs['] paradigms" []
"Dreymon's Syndrome" []
"dripstones['] torpidness"
"Droopy's prosody"
"DuBon's Bounds"
"Duerson's sounders" []
"DuFils fluids"
"Easton neatos" []
"Ederra's readers"
"Edilsy's Lysides"
"Edington's denotings"
"Egen's Genes"
"Eisenbarth's breathiness"
"Eisman amines"
"Eison-Trent Retentions"
"Eliason's anisoles"
"Emerson's moreness"
"emigrants streaming" []
"Emmaline's melamines"
"Ennita's nanites"
"Epperson propenes" []
"Epton's NetOps"
"Erickson's rockiness"
"Ericsson-Cisneros necrosis" []
"Escalante elastance" []
"Esposito isotopes" []
"Estragon Orangest Negators"
"Etsui's tissue suites" []
"Euston's outness"
"Evanson novenas" []
"Everard's adverser"
"Exifs['] fixes"
"farmost formats" []
"Fasching chafings"
"faultiest fistulate"
"Feinstein's finiteness"
"Feldhaus headfuls"
"Ferrentino's interferons"
"Ferriera's rarefiers"
"Fessuri's Fissures"
"feudalist disulfate"
"Filbertio's Fibrolites"
"Fingold's Foldings"
"flat-tire filtrate" []
"flouriest fluorites"
"Fraioli's airfoils"
"Frist rifts" []
"fulminous sulfonium"
"Gaiter's Triages" []
"gamma magma"
"the Gant-Hope pathogen"
"Gartman's tangrams"
"Gasconte cognates"
"Gaspari airgaps" []
"Gaucin's Saucing"
"Geiselman's semiangles"
"Gelinas's sealings" []
"genetical clientage"
"genteelish gehlenites"
"the Geothermal Lag Theorem"
"Geremia's gamesier reimages"
"the Germi-Grime-IMGer"
"Gerrindo Ordering" []
"Giancola's analogics"
"Giardini's diarising"
"Giardino-Giordani radioing"
"Gibson boings" []
"gingery greying"
"ginnier reining"
"Girton's sorting" []
"the Gitlin Tiling"
"Gitlin's Listing"
"Glancy's glycans"
"Glassie-Siegal's ligases"
"glutamine emulating"
"goblins['] globins"
"Golic's logics"
"the Gonterman magnetron"
"Goranson argonons['] organons"
"Gosling's glossing"
"Gospodin's spongoids"
"Gosselin lignoses"
"Grady's Dry Gas"
"grained reading"
"Grandinetti denitrating"
"the Greenburg-Gruenberg Grub Genre"
"the Greizman-Mazinger Ring Maze"
"Grinstead astringed gradients-treadings" []
"groats['] gastro-argots"
"Groce-Greco Recog"
"Grote-Trego Ergot"
"Guillermo glomeruli" []
"Guiton's Outings"
"the Gulf Coast focal gust"
"Hardee's sheared headers" []
"Hearns's harness"
"heinous ion hues"
"Heintz's zeniths"
"Hesseltine's lithenesses"
"Hi-Stereo theories" []
"Hilgendorf's fingerholds"
"hive boar behavior"
"hologynic ichnology"
"Hopton's Not-Posh Photons"
"Hort-Meyer rheometry"
"housepainter neuropathies"
"houseplants['] sulphonates" []
"Hruska's Kashrus"
"Huettner's untethers"
"Hussong shoguns"
"hypodorian radiophony"
"Hyppolite's psilophyte"
"ice funnel influence"
"incised indices"
"incognito cognition"
"Infinger refining"
"Interim REM-Init" []
"intersocietal electrisation"
"intrinsic citrinins"
"ion-fuss fusions"
"ion-stop potions" []
"Ion Storm Monitors" []
"ions-races scenarios"
"ions so IN"
"Ipson Pions"
"Iron Facts/Antics For Fractions"
"iso-ether theories" []
"isothermal thimerosal"
"isotropy porosity"
"an isthmian histamin"
"Iversen's inverses"
"Kaelin's alkines" []
"Kaschel hackles"
"Keasling snaglike linkages"
"Keelan's alkenes"
"Keeton's ketones"
"Kenton's nektons"
"the Kiesel-Lieske selkie"
"Klinger-Kringle Link-Reg"
"Kneale's alkenes" []
"Kneisley keylines"
"Koester's restokes"
"Kohlein's Sinkhole" []
"Kugel's Kluges"
"Labarge algebra"
"Labriola's isallobar"
"Lacrosse solacers" []
"Laessig Ligases"
"Lagace's scalage"
"Laing's signal-lasing"
"Lampson's plasmons"
"Lanterni's Internals" []
"Lapointe's sealpoint antipoles"
"Lapsam plasma" []
"Lartigue ligature"
"Lattimer's remittals"
"Lauman's Manuals"
"Lauritsen retinulas" []
"LaVerre's reversal" []
"law of the heat flow"
"Lebo's Lobes"
"LeBrock's Blockers"
"leg-mind melding"
"Leiterman's streamline" []
"Lenker's kernels"
"LeScipio Policies" []
"less-epic eclipses"
"Lessing Singles"
"Levenson's nonselves"
"Leverton's resolvent"
"Lienau's Insulae"
"the Limoges semilog"
"lineman melanin"
"locustal outcalls"
"Lohan's halons"
"Lon's sol'n"
"Lopeman's neoplasm" []
"Losinski oilskins"
"Lucero's closure" []
"the Lucien Clue-in Nuclei"
"luggers['] gurgles"
"Luong's Gluons"
"Lupercio's supercoil"
"lust-gen glutens"
"Macgoula's glaucomas"
"Mackenzie's eczema skin"
"Magi's Sigma"
"Manderson's randomness"
"Mangieri's imaginers['] migraines" []
"Manuelito's emulations"
"Marasco's sarcomas"
"Margarett's Tetragrams"
"Mascioli's socialism" []
"Mathiasen Haematins" []
"Matsui autism"
"Matsui's Autisms"
"Matsuno-Stouman amounts"
"Matteo's stomate" []
"Maturin's naturism"
"Mcaleer's sclerema" []
"McHale alchem"
"McShea's schemas"
"measurings reassuming"
"Mellor-Dowd's world models"
"Menelaus's un-measles"
"mensural numerals"
"Mersereau's remeasures"
"the Mesech scheme"
"Messed-Up Deep Sums"
"micro-sleep recompiles"
"micron gap comparing" []
"Midura's radiums"
"migrations amortising"
"mild case declaims"
"the mind-noise dimension"
"minor scopes['] compression"
"Miramontes monetarism" []
"a modernised endodermis"
"moisture's misroutes" []
"Monasterio's astronomies"
"Monte Xiao's taxonomies"
"the Monterosso Sensomotor"
"moonseeds['] endosomes"
"moorhens['] hormones" []
"More-than-once canon theorem" []
"Morgani's organism roamings" []
"Morganti's stroaming sigmatron"
"Morgassi Isograms"
"Morisset Trisomes" []
"Morneau's neuromas"
"Moses's mosses"
"Moss-Bly Symbols"
"mossier isomers"
"Motte's Totems"
"mouse cell molecules"
"Mr. Poyle's Polymers"
"Mr. Tice's Metrics" []
"Mubsner Numbers"
"a multi-cell clitellum"
"Murata trauma" []
"[']Muricans['] craniums"
"Myla's Amyls"
"myoglobin looming by"
"Naomi's Aminos" []
"Naples planes"
"Napolitan's nonspatial planations"
"Narciso's narcosis"
"Narcisse's scariness"
"narcotised draconites"
"Nattier Nitrate" []
"necrotic concerti"
"Neeson's oneness" []
"Nelfsun funnels"
"neo-virus univores" []
"a neolithic ichnolite"
"Nesheim's inmeshes"
"net-angst tangents"
"neuroleptics['] intercouples"
"Neustadt's unstateds"
"Ney-Nye Yen"
"Nichole's Helicons" []
"Nicknamed Dieckmann"
"Nieland's annelids"
"Nimmo's monism"
"Nissley lysines" []
"Nitroso-Torsion"
"no-spell pollens"
"No-Sum Muons"
"non-sure neurons" []
"nonhistorical chlorinations"
"nonsacred ordnances"
"nonsecretors cornerstones"
"the normative movin['] rate"
"Norris cue recursion"
"Nuge's Genus"
"O'Neill's niellos" []
"Obringer's resorbing" []
"obscurantist subtractions"
"obstruent buttoners" []
"Oetken's ketones" []
"Ogorman's sonogram"
"old rebus boulders" []
"Old Slicer Colliders" []
"Olsen-Slone-Noel's enols" []
"Orangest negators" []
"orientating integration"
"Ornstein ternions" []
"Orton's rotons"
"the Orzinho-Zhirono Horizon"
"Osgood Sod-Goo"
"Osmani-Moisan aminos" []
"Osterlund roundlets" []
"ostriches['] trichoses"
"Ostrum tumors"
"Otremba's bromates"
"Ox Cline's Lexicons"
"oxidised dioxides"
"Palombi's bioplasm"
"Pandey's Dyspnea"
"Paratore's separator"
"party line interplay"
"a pathogen heptagon"
"pathogens['] heptagons"
"Pauleri's spirulae"
"Paup's pupas"
"Pawlenty's yew-plants['] lawn types"
"Peatross protases" []
"Peccton's concepts"
"Peloni's Epsilon" []
"Pelton's leptons"
"Pendleton's End-Leptons"
"Penrose Openers"
"peptides['] deep pits"
"perigones['] progenies"
"periodontal deploration"
"Perlstein's tripleness"
"permafrost preformats"
"Perret perter"
"Perrino's Prisoner"
"Petry's typers"
"phenocrystic pyrotechnics"
"Philomena-nemophila"
"phonographist phosphorating"
"Pilotto's tool tips"
"Plotkin's slipknot post-link slipknot"
"plushiest sulphites"
"Pomeroy's pyrosome"
"positional spoilation"
"positron portions['] sorption" []
"Poulin's Upsilon Pulsion"
"Poythress's hypostress"
"Preusser pressure" []
"pro-nucleus uncouplers"
"a problematic particle mob"
"protease operates"
"Pusateri's prussiate"
"Raase Areas"
"the Radoncic cancroid draconic"
"rare-site arteries"
"Rascal's Scalars"
"real fun learn-fu"
"Recloseted electrodes"
"ref-space prefaces"
"refringence referencing"
"Regiment Metering"
"Reinoso's erosions"
"Reinsch's richness"
"Reisman's seminars" []
"Reisse Series"
"Remaker Kreamer"
"Respicio's iriscopes"
"Restaino's Assertion" []
"restriven inverters"
"Rezac's crazes"
"rhinestone threonines"
"ride count reduction" []
"Rideau's residua"
"Riese's series"
"rindiest nitrides"
"Ringuette's trusteeing"
"Ripstone Proteins Pointers"
"rites-tiers" []
"Robaina's abrasion"
"Robie's ribose"
"Rocantti Traction" []
"role-choosing chronologies"
"Ron's Logic Closing or Colorings"
"roquet torque"
"Rosalind-Lorinda's Ordinals" []
"Rosati-Sirota-Satori Ratios" []
"Rosenfeld enfolders"
"Rossiter's resistors"
"Rupal's Pulsar"
"the Saito Iotas"
"Salinger-Lerangis aligners" []
"Salminen melanins" []
"Salonga analogs" []
"Sammel lemmas" []
"Sandridge's addressing"
"sanguine Guanines" []
"sanitation in a station"
"sanitizer triazines"
"Sanpedro operands"
"Sardina radians" []
"Sartre raters" []
"Sassone seasons"
"Satcher's starches" []
"Sayles lyases"
"Scalardi Radicals" []
"Scales's classes"
"Scanlon's non-class"
"Scempeidi epidemics"
"scenic e-Science"
"scintigrams['] mistracings"
"Scuderi's discures"
"Seagrave averages" []
"Sealy's Lyases" []
"Seamster steamers"
"Seaton neatos" []
"Sebastian basanites" []
"Seier's Series" []
"Selina's Salines" []
"Semuldo-LeDomus Modules" []
"Serafino's farinoses"
"Serrato's assertor-assorter" []
"set-caps['] aspects"
"Settlemeier telemetries"
"Severin Inverse Veerins" []
"Severin's inverses" []
"Severino's eversions"
"sheltering lighteners"
"Shenefield needlefish"
"shlumpy phylums"
"Shooing Goonish Ion Hogs"
"Shreiker Kreisher"
"Sibert Tribes"
"Sid Lamp's plasmids"
"Siegman enigmas" []
"Siegmann meanings" []
"Sigman's massing"
"Sigmint Timings"
"a silicone isocline"
"silkscreen slickeners"
"sincerest secretins"
"Sisemore isomeres"
"Slayden-Danley's adenyls" []
"Sleator's Ore-Salts"
"slick cad ad clicks"
"slipper ripples"
"smithereens['] intermeshes"
"snoop-crimes compression" []
"snooze-ozones"
"solenoid eidolons"
"somatic atomics"
"somitic miotics"
"sonar motif-formations"
"Sonic Boom Ion Combos"
"sonicator consortia"
"Sortino isotron torsion"
"sovereign virogenes" []
"Spavro Vapors"
"Spectral I-Particles" []
"Spheric Ciphers"
"Spitler Triples" []
"spittle pitlets"
"Splitter-Terp List"
"the Spoelstra Laser-Post"
"spoiled dipoles" []
"spurling purlings"
"St. Germaine's magnetisers"
"St Pierre's persister"
"Stacey's cytases" []
"Staiger-Agresti Triages" []
"Stancube's Substance" []
"stankier streakin['] keratins" []
"Staptner trap-nest patterns" []
"static ion citations"
"Steadman mandates" []
"Steagall's stallages"
"Steering Integers" []
"Stegman magnets" []
"Stehling's lightness" []
"Stemping Pigments" []
"Stepanek netspeak"
"Stephany phytanes" []
"Sterger-Grester Regrets" []
"steroid editors" []
"Stineman mannites" []
"sting-mace magnetics"
"Stoffer Efforts" []
"Stoma-Atoms" []
"stone-axiom taxonomies" []
"Straley raylets" []
"Strange Map Pentagrams"
"Stromer Stormer-Tremors" []
"Strosnider torridness"
"Stu Eger's gestures"
"Sturgeman Arguments" []
"the Stymes System"
"sugar-guars"
"sustinent nuttiness"
"Sutliff's fistfuls"
"Szemeny enzymes"
"a tag-once cognate"
"tainted ions['] destination" []
"Tallerico's allosteric"
"tattier titrate"
"teensy-dry dysentery"
"Tercero's secretor"
"Teresa's Tessera"
"the TerraCo Reactor"
"Tessi-Estis sites"
"Tessudi tissued studies"
"Theorist Theriot's thorites" []
"Theropodan parenthood"
"Tiedeman dementia" []
"Tierney's serenity" []
"Timlin's Int-Lims"
"a tint-proof footprint"
"tiny pearl interplay" []
"the Tirolean relation"
"Tiscareno reactions" []
"Tisdale Details" []
"titration attrition"
"Toledano's loadstone"
"toluidin dilution"
"Tomas Stamo-Mota's Atoms" []
"Tomasic's acosmist massicot"
"Tomasic's somatics" []
"Tomasino amotions"
"top-colors cool sport protocols"
"Torenstein Retentions" []
"Toriano's orations" []
"trans-gene generants"
"trans-sonic constrains"
"transition nitrations"
"Tremaine's antimeres"
"Trisano-Santori Rations"
"trismus truisms"
"Trupiano's supinator" []
"Tsiao-Isato iotas"
"Ulf's Flus"
"uncivilnesses['] inclusiveness"
"an undocile nucleoid"
"unlisted diluents"
"unsliced nuclides"
"unstable abluents"
"Urdiales's residuals"
"uremic Cerium"
"urogenital regulation" []
"uterus suture"
"UV-seen venues"
"vain ions['] invasion"
"Vascheri archives" []
"VCR use curves"
"Velton's Solvent"
"verrucose overcures"
"Vitner's Inverts"
"Vlasic Slavic Cavils"
"Waldroup's Proud Laws"
"Wallace's Scale Law" []
"Winkler's Wrinkles"
"Winterstein intertwines"
"Wrightson ingrowths" []

table of smartypants [xxp6]
blurb
"Acute Arlen Laracuente" []
"Acute Rod Courtade" []
"Acute Sal Lacuesta" []
"Adept Euna Patenaude"
"Adept Giron Daigrepont" []
"Adept Lis Plaisted" []
"Amie 'Duh' Duhaime"
"Analytic [if player is male]Ty Lancia[else]Tina Lacy[end if]" [source size >> blue lacuna's]
"Angla 'Duh' Haugland"
"Ard 'IQ' Qadir"
"Art 'Duh' Duhart"
"Art 'IQ' Tariq"
"Ash 'IQ' Ishaq"
"Autodidact [if player is male]Todd Cutaia[else]Dacia Doutt[end if]"
"Baker 'Duh' Burkhead"
"Barb 'Duh' Hubbard"
"Boss Hacker Hassebrock" []
"Buster 'IQ' Berquist" []
"Cami 'Duh' Michaud"
"Cary 'Duh' Chaudry"
"Cecil 'Duh' Delucchi"
"Chiara 'Duh' Chaudhari"
"Collegian [if player is male]Alec Ligon[else]Olga Cline[end if]" []
"Corina 'Duh' Chouinard"
"Craig 'Duh' Guichard"
"Credential-Interlaced [if player is male]Clint Reade[else]Celine Dart[end if]"
"Del 'Duh' Huddle"
"Dev Arlen Lavender" []
"Dev Arvin Vandiver" []
"Dev Callen Cleveland"
"Dev Caren Cavender" []
"Dev Earl Velarde" []
"Dev Elli Deville" []
"Dev Giles Selvidge"
"Dev Huang Devaughn"
"Dev Isa Davies" []
"Dev Leandra Landaverde" []
"Dev Lila Villeda" []
"Dev Lisa Vidales" []
"Dev Loya Loveday"
"Dev Neal Eveland"
"Dev Parton Davenport" []
"Dev Rae DeVera" []
"Dev Raglin Vangilder" []
"Dev Red Vedder"
"Dev Reo Devore" []
"Dev Ro Dover"
"Dev Ronna Vandoren" []
"Dev Sabine Benavides"
"Dev Sal Valdes" []
"Dev Salo Desalvo"
"Dev Sebine Benevides"
"Dev Sera Deavers" []
"Dev Sueann Vandeusen"
"Dev Tia DeVita" []
"Dev Toi DeVito" []
"Dev Tula Devault"
"Dev Verla Valverde" []
"Devster Dr. Steve"
"Dig-Nums Sigmund" []
"Doc Alta Cataldo"
"Doc Arlen Calderon" []
"Doc Arlene Calderone" []
"Doc Arner Dorrance" []
"Doc Atlas Castaldo"
"Doc Audra Cuadrado"
"Doc Azar Cardoza"
"Doc Boar Cordoba"
"Doc Earl DeCarlo" []
"Doc Elli Cedillo" []
"Doc Elma Macleod" []
"Doc Elsa Salcedo" []
"Doc Ena Deacon" []
"Doc Erma Mercado" []
"Doc Eryn Condrey" []
"Doc Esta Decosta"
"Doc Fearn Defranco" []
"Doc Fishel Schofield"
"Doc Fisk Fosdick"
"Doc Frye Fordyce" []
"Doc Gill Cogdill" []
"Doc Irma Dimarco" []
"Doc Kahl Hadlock" []
"Doc Karl Lockard" []
"Doc Keener Eckenrode" []
"Doc Kelm Medlock"
"Doc Kerri Roderick" []
"Doc Kinser Dickerson" []
"Doc Laraine Candelario" []
"Doc Le Dolce" []
"Doc Leaf Defalco" []
"Doc Leah Deloach" []
"Doc Leif Cofield"
"Doc Letha Deloatch" []
"Doc Lira Dicarlo" []
"Doc Lisa Salcido" []
"Doc Lola Collado" []
"Doc Lu Cloud" []
"Doc Ly Cloyd"
"Doc Mae Macedo" []
"Doc Mana Moncada"
"Doc Mary Carmody" []
"Doc Mel Mcdole" []
"Doc Mia Damico-Modica"
"Doc Nee Cedeno" []
"Doc Noemi Domenico" []
"Doc Oma Mcadoo"
"Doc Palen Copeland"
"Doc Rae Decaro" []
"Doc Rana Cardona" []
"Doc Rena Cardone" []
"Doc Rhee Deroche" []
"Doc Roach Corchado" []
"Doc Ron Cordon"
"Doc Rorie Cordeiro" []
"Doc Rosa Cardoso"
"Doc Sherer Schroeder" []
"Doc Stark Stockard" []
"Doc Tresa Decastro" []
"Doc Ute Doucet-DuCote"
"Doc Wehr Cowherd" []
"Doc Wen Cowden"
"Dorla 'Bingo' Longobardi" []
"Dr. [a-b] Beard-Bader" []
"Dr. [if player is male]Enis[else]Ines[end if] Snider" []
"Dr. [if player is male]Euan[else]Euna[end if] Renaud" []
"Dr. [n-t] Arendt" []
"Dr. Abner Bernard" []
"Dr. Ager Gerard"
"Dr. Aguon Garduno" []
"Dr. Ake Drake-Radke" []
"Dr. Akin Kinard" []
"Dr. Alec Calder"
"Dr. Alfon Lanford" []
"Dr. Ali Laird" []
"Dr. Alice Cardiel" []
"Dr. Aline Ireland" []
"Dr. Alla Allard"
"Dr. Allan Randall-Darnall"
"Dr. Allee Delreal"
"Dr. Allen Darnell-Randell" []
"Dr. Allene Allender" []
"Dr. Amee Meader" []
"Dr. Ames DeMars" []
"Dr. Amico Dimarco" []
"Dr. Amie Merida" []
"Dr. Amina Miranda" []
"Dr. Angie Dearing-Reading" []
"Dr. Angla Garland-Ragland" []
"Dr. Anisa Sardina" []
"Dr. Anne Danner"
"Dr. Antone Anderton" []
"Dr. Archie Reichard" []
"Dr. Ater Trader"
"Dr. Aube Bauder" []
"Dr. Aura Arruda"
"Dr. Auten Durante" []
"Dr. Avalos Salvador" []
"Dr. Bade Bedard" []
"Dr. Baer Berard"
"Dr. Baier Berardi" []
"Dr. Bain Bardin" []
"Dr. Banes Brandes"
"Dr. Bao Board" []
"Dr. Barone Bernardo" []
"Dr. Bay Darby-Byard" []
"Dr. Beale Baldree" []
"Dr. Bean Braden-Barden-Bednar-Benard" []
"Dr. Beane Bearden" []
"Dr. Beasley Beardsley" []
"Dr. Beau Bauder" []
"Dr. Bee Breed"
"Dr. Belen Brendle-Brendel"
"Dr. Belin Brindle"
"Dr. Bella Bellard"
"Dr. Benes Berends"
"Dr. Berna Bernard" []
"Dr. Bey Derby" []
"Dr. Beyer Deberry" []
"Dr. Blane Breland" []
"Dr. Bode Debord"
"Dr. Bogan Bragdon" []
"Dr. Bogen Brogden"
"Dr. Bolan Borland" []
"Dr. Borgen Nordberg"
"Dr. Bower Browder" []
"Dr. Briana Brainard" []
"Dr. Brose Borders"
"Dr. Buono Bourdon"
"Dr. Cale Calder" []
"Dr. Calvo Colvard"
"Dr. Cane Carden-Dancer"
"Dr. Cano Conrad" []
"Dr. Cao Acord" []
"Dr. Cari Ricard"
"Dr. Casi Sicard"
"Dr. Ceola Decarlo" []
"Dr. Chanel Chandler" []
"Dr. Charis Richards" []
"Dr. Chiles Childers"
"Dr. Chute Dutcher"
"Dr. Clay Clardy"
"Dr. Coates Decastro" []
"Dr. Cole Cordle"
"Dr. Collis Driscoll"
"Dr. Coon Cordon" []
"Dr. Core Corder-Record"
"Dr. Coria Ricardo" []
"Dr. Corie Derrico"
"Dr. Coyne Condrey" []
"Dr. Crea Carder-Crader"
"Dr. Crowe Crowder"
"Dr. Daigle Aldridge"
"Dr. Dara Dardar" []
"Dr. Dawes Edwards" []
"Dr. Dean Darden" []
"Dr. Deana Andrade-Dandrea" []
"Dr. Deann Dennard"
"Dr. Deems Medders" []
"Dr. Delfina Friedland"
"Dr. Deon Rodden" []
"Dr. Dille Riddell" []
"Dr. Duell Ruddell"
"Dr. Eagle Arledge" []
"Dr. Ebling Lindberg" []
"Dr. Ed Redd"
"Dr. Eden Redden"
"Dr. Edington Reddington"
"Dr. Edy Reddy" []
"Dr. Efren Redfern"
"Dr. Elena Learned" []
"Dr. Eli Riedl" []
"Dr. Elie Riedel" []
"Dr. Ella Allred-Ellard" []
"Dr. Elli Diller"
"Dr. Elsa Sadler" []
"Dr. Else Elders"
"Dr. Ena Nader-Arden-Arend" []
"Dr. Engel Dengler" []
"Dr. Enid Reddin" []
"Dr. Eric Crider"
"Dr. Erick Derrick-Redrick" []
"Dr. Eugena Gendreau" []
"Dr. Eun Duren"
"Dr. Eve Verde" []
"Dr. Evin Verdin" []
"Dr. Ewa Dewar"
"Dr. Ewan Andrew" []
"Dr. Eyre Dreyer"
"Dr. Fae Freda" []
"Dr. Fason Sanford"
"Dr. Fay Frady"
"Dr. Fe Fred"
"Dr. Fee Freed-Feder" []
"Dr. Fidel Friddle" []
"Dr. Fonda Danford" []
"Dr. Forde Redford"
"Dr. Franco Cranford"
"Dr. Fricke Fredrick"
"Dr. Gaier Gerardi"
"Dr. Gale Gerald" []
"Dr. Galli Gillard"
"Dr. Gay Grady"
"Dr. Gena Grande" []
"Dr. Genie Deering" []
"Dr. Geno Gorden" []
"Dr. Gerena Gardener" []
"Dr. Geri Grider"
"Dr. Gertha Gerhardt"
"Dr. Gibson Birdsong" []
"Dr. Gilan Darling" []
"Dr. Gile Gilder"
"Dr. Gina Gardin" []
"Dr. Gino Rigdon"
"Dr. Gore Rodger" []
"Dr. Grenier Derringer"
"Dr. Grose Rodgers"
"Dr. Guin Durgin"
"Dr. Habib Hibbard"
"Dr. Hae Heard" []
"Dr. Hager Gerhard"
"Dr. Hain Hardin"
"Dr. Haines Sheridan" []
"Dr. Hance Chenard" []
"Dr. Hanes Dashner" []
"Dr. Hara Darrah"
"Dr. Haro Harrod"
"Dr. Hasan Hansard" []
"Dr. Hay Hardy"
"Dr. Heaps Shepard" []
"Dr. Heitman Meinhardt" []
"Dr. Hertha Ehrhardt"
"Dr. Hoa Hoard" []
"Dr. Hosea Rhoades" []
"Dr. Hua Huard"
"Dr. Huang Draughn"
"Dr. Hye Hyder" []
"Dr. Ian Drain-Nardi" []
"Dr. Idell Riddell" []
"Dr. Ilona Orlandi" []
"Dr. Inge Ginder-Reding"
"Dr. Inger Grinder" []
"Dr. Iona Ardoin" []
"Dr. Isa Ardis"
"Dr. Jae Jared" []
"Dr. Janie Jardine" []
"Dr. Jone Jorden"
"Dr. Juana Andujar"
"Dr. Ka Dark"
"Dr. Kalman Markland" []
"Dr. Kari Rikard"
"Dr. Kate Radtke"
"Dr. Kenna Kennard"
"Dr. Kia Ikard"
"Dr. Kina Kinard" []
"Dr. Kindra Drinkard"
"Dr. Laboy Bolyard" []
"Dr. Laine Ireland" []
"Dr. Lalli Lillard"
"Dr. Lampley Dalrymple"
"Dr. Lance Candler" []
"Dr. Lane Nadler" []
"Dr. Lavigne Vangilder" []
"Dr. Lawson Rowlands" []
"Dr. Lea Adler-Radel" []
"Dr. Leaf Alfred" []
"Dr. Leah Herald"
"Dr. Lee Elder-Edler"
"Dr. Leif Fidler"
"Dr. Lemelin Millender"
"Dr. Leona Leonard-Olander" []
"Dr. Leong Goldner"
"Dr. Leyba Bradley" []
"Dr. Liew Wilder" []
"Dr. Lowe Dowler"
"Dr. Luse Sluder"
"Dr. Lute Trudel"
"Dr. Mae Mader-Demar" []
"Dr. Magali Madrigal" []
"Dr. Maglio Grimaldo" []
"Dr. Malec Mcardle" []
"Dr. Malena Alderman" []
"Dr. Malone Moreland" []
"Dr. Mana Armand" []
"Dr. Manke Denmark"
"Dr. Manno Normand-Nordman" []
"Dr. Masi Simard-Mardis" []
"Dr. Mccay Mccrady"
"Dr. Means Marsden-Manders" []
"Dr. Mena Erdman-Marden" []
"Dr. Mina Minard" []
"Dr. Mirella Remillard" []
"Dr. Mona Damron" []
"Dr. Monay Raymond" []
"Dr. Moon Ormond-Mondor"
"Dr. Mulan Landrum"
"Dr. Mule Mulder"
"Dr. Na Rand" []
"Dr. Nat Arndt"
"Dr. Neal Lander" []
"Dr. Neale Learned" []
"Dr. Nees Endres-Enders"
"Dr. Negri Grinder" []
"Dr. Neil Linder" []
"Dr. Neoma Medrano" []
"Dr. Neyo Rodney" []
"Dr. Nga Grand" []
"Dr. Niesha Sheridan" []
"Dr. Nigel Grindle-Dingler" []
"Dr. Nino Nordin"
"Dr. Nocera Dorrance" []
"Dr. Noe Roden" []
"Dr. Nola Arnold" []
"Dr. Noon Rondon"
"Dr. Nyla Landry" []
"Dr. Oaks Kardos" []
"Dr. Ochs Dorsch" []
"Dr. Oleg Golder" []
"Dr. Olin Ridlon" []
"Dr. Omega DeGarmo" []
"Dr. Ona Doran" []
"Dr. Oren Norred" []
"Dr. Oshea Rhoades" []
"Dr. Oubre Brodeur" []
"Dr. Owen Worden" []
"Dr. Ozie Dozier" []
"Dr. Patti Pittard" []
"Dr. Pease Paredes" []
"Dr. Pei Pride" []
"Dr. Pica Picard"
"Dr. Pine Pinder" []
"Dr. Pinero Perrodin" []
"Dr. Rae Rader"
"Dr. Rager Gerrard"
"Dr. Regan Gardner" []
"Dr. Regina Gardiner" []
"Dr. Regine Redinger" []
"Dr. Reid Ridder" []
"Dr. Rena Renard" []
"Dr. Rene Render"
"Dr. Retha Erhardt" []
"Dr. Rey Dryer" []
"Dr. Rhea Harder"
"Dr. Rhee Dreher" []
"Dr. Rieke Kreider"
"Dr. Rios Dorris" []
"Dr. Riva Rivard"
"Dr. Ro Dorr"
"Dr. Roane Reardon" []
"Dr. Robena Dearborn" []
"Dr. Roesch Schroder"
"Dr. Rube Bruder"
"Dr. Rue Ruder-Duerr"
"Dr. Rutan Durrant"
"Dr. Saenz Zanders"
"Dr. Sansone Sanderson"
"Dr. Sao Rodas" []
"Dr. Savino Arvidson"
"Dr. Seal Sadler" []
"Dr. Seals Lessard"
"Dr. Sean Arends" []
"Dr. See Seder" []
"Dr. Selina Sindelar" []
"Dr. Seto Strode-Doster" []
"Dr. Shana Hansard" []
"Dr. Shane Dashner" []
"Dr. Sharer Sherrard"
"Dr. Shea Dasher" []
"Dr. Shera Shrader" []
"Dr. Shoaf Ashford"
"Dr. Sima Mardis" []
"Dr. Simone Dinsmore" []
"Dr. Slade Saddler" []
"Dr. Slane Randles" []
"Dr. Slate Stadler"
"Dr. Sloane Landeros" []
"Dr. Staley Stradley" []
"Dr. Stan Strand"
"Dr. Steen Stender" []
"Dr. Stefani Standifer" []
"Dr. Ta Dart"
"Dr. Taube Daubert" []
"Dr. Tay Tardy"
"Dr. Thea Dehart-Dearth" []
"Dr. Theola Aderholt" []
"Dr. Tonya Drayton" []
"Dr. Toole Deltoro"
"Dr. Tresa Strader" []
"Dr. Tuan Durant" []
"Dr. Tyesha Hardesty" []
"Dr. Una Duran" []
"Dr. Valene Lavender" []
"Dr. Wade Edward"
"Dr. Way Wydra"
"Dr. Wes Drews"
"Dr. Whalen Landwehr"
"Dr. Willa Willard" []
"Dr. Wonda Downard"
"Dr. Woolf Wolford"
"Dr. Yael Radley" []
"Dr. Yang Grandy"
"Dr. Yee Reedy"
"Dr. Yu Rudy" []
"Dr. Zane Zander" []
"Dunphy Yun, Ph. D"
"Ed 'Bingo' Boeding" []
"Elma 'Duh' Duhamel"
"Enos 'Duh' Housden"
"Erma 'Bingo' Giambrone" []
"Esta 'Duh' Hustead"
"Geek Al Keagle"
"Geek Branch Hackenberg"
"Geek Don Goedken"
"Geek Len Engelke" []
"Geek Lin Keeling" []
"Genius [n-t] Augenstein"
"Genius Bhat Stinebaugh" []
"Genius Brewer Weisenburger"
"Genius Dart Staudinger" []
"Genius Nitta Sanguinetti"
"Gifted Marc McFatridge"
"Gifted Tor Gottfried"
"Gifted Varn Vandegrift"
"Hack Bart Hackbart"
"Hack Bree Habecker"
"Hack Coy Haycock"
"Hack Elston Shackleton"
"Hack Elva Hlavacek"
"Hack Emil Michalek" []
"Hack Joni Hojnacki" []
"Hack Lester Stahlecker"
"Hack Levi Havlicek" []
"Hack Lu Lukach"
"Hack Lyle Chalkley"
"Hack Man Hackman" []
"Hack Mila Michalak" []
"Hack Min Machnik" []
"Hack Pam Packham"
"Hack Paulo Chaloupka"
"Hack Rob Chrobak"
"Hack Robt. Bockrath"
"Hack Ruskin Cruikshank"
"Hack Somer Schomaker" []
"Hack Theron Heckathorn" []
"Hack Verne Chervenak"
"Hack Wes Schwake"
"Hack Yen Hackney"
"Hacker Deb Hardebeck" []
"Hacker Lev Kercheval"
"Hick-Nerd Hendrick" []
"Innovater [if player is male]Ronan Veit[else]Tina Veron[end if]"
"Innovator Nan Rovito"
"IQ-y Bum Quimby" [p]
"Kay 'Duh' Hayduk"
"Kresge 'Bingo' Koenigsberg"
"Lang 'Duh' Haglund"
"Laura 'IQ' Aquilar"
"Laureate Lea Tauer"
"Lea 'Bingo' Belongia" []
"Lenard 'Duh' Underdahl"
"Loftus 'IQ' Lofquist"
"Logan 'Duh' Hougland"
"Long 'Duh' Hoglund"
"Loy 'Duh' Dlouhy"
"Luann 'IQ' Quinlan"
"Luther 'Bingo' Lightbourne" []
"Madge 'Duh' Meddaugh"
"Marie 'Duh' Muirhead"
"Mateus 'IQ' Mesquita"
"MFA Erin Freiman" []
"MFA Kerri Freimark" []
"MFA Latonia Amalfitano"
"MFA Lou Malouf"
"MFA Nell Fellman"
"MFA Oren Foreman" []
"MFA Rene Freeman" []
"MFA Rico Formica" []
"MFA Rina Fairman"
"MFA Rob Fambro"
"MFA Ron Forman-Froman"
"MFA Tia Fatima" []
"Neat Allison Santaniello" []
"Neat Amy Yeatman"
"Neat Bert Barnette" []
"Neat Bo Tabone"
"Neat Celsa Escalante" []
"Neat Coy Coatney" []
"Neat Edgar Teagarden" []
"Neat Elvin Valentine" []
"Neat Flash Shanafelt"
"Neat Gail Tenaglia"
"Neat Grisel Easterling" []
"Neat Guy Gautney" []
"Neat Janis Saintjean"
"Neat Les Alsteen"
"Neat Levi Valiente" []
"Neat Lida DiNatale"
"Neat Lili Litalien"
"Neat Lord Alderton" []
"Neat Lu Neault"
"Neat Ma Eatman"
"Neat Mara Amarante" []
"Neat Marcos Sacramento"
"Neat Margo Agramonte" []
"Neat Min Tiemann"
"Neat Minh Heitmann" []
"Neat Misha Mathiasen" []
"Neat Mort Tramonte"
"Neat Nigel Galentine" []
"Neat Opal Pantaleo" []
"Neat Oscar Castorena" []
"Neat Osmon Montesano"
"Neat Pat Panetta"
"Neat Remi Tremaine" []
"Neat Rey Enyeart"
"Neat Rico Nicotera" []
"Neat Rio Reitano"
"Neat River Tavernier" []
"Neat Rob Boatner" []
"Neat Rose Senatore" []
"Neat Rosi Restaino" []
"Neat Sam Eastman" []
"Neat Sheri Eisenhart" []
"Neat Sid DeSanti" []
"Neat Spiro Petrosian" []
"Neat Su Austen" []
"Neat Tam Manetta"
"Neat Thor Atherton" []
"Neat Trish Steinhart" []
"Neat Vera Navarete" []
"Neat Vern Tavenner" []
"Neat Zia Atienza"
"Nell 'Duh' Hudnell"
"Neo-Smart Osterman" []
"Nerd Abe Bearden" []
"Nerd Abel Breeland" []
"Nerd Ada Andrade" []
"Nerd Al Ladner" []
"Nerd Alec Calender" []
"Nerd Alf Fernald"
"Nerd Ali Ireland" []
"Nerd Alica Cardinale" []
"Nerd Alisa Saldierna" []
"Nerd Alma Alderman" []
"Nerd Amos Soderman" []
"Nerd Angel Greenland-Englander" []
"Nerd Ann Drennan"
"Nerd Asa Andreas" []
"Nerd Ash Dashner" []
"Nerd Aviv Vandiver" []
"Nerd Avon VanDoren" []
"Nerd Bart Bertrand"
"Nerd Barth Bernhardt" []
"Nerd Bee Breeden"
"Nerd Ben Brenden"
"Nerd Beth Behrendt"
"Nerd Bo Broden" []
"Nerd Bray Bernardy" []
"Nerd Brian Bernardin"
"Nerd Cal Crandle" []
"Nerd Ceola Calderone" []
"Nerd Ciara Carradine" []
"Nerd Cora Dorrance" []
"Nerd Coy Condrey" []
"Nerd Dan Dennard" []
"Nerd Eberling Lindenberger"
"Nerd Ed Derden" []
"Nerd Eli Leidner-Reindel" []
"Nerd Ella Allender" []
"Nerd Elma Melander" []
"Nerd Elsa Selander"
"Nerd Elva Lavender" []
"Nerd Emory Nordmeyer"
"Nerd Gage Anderegg" []
"Nerd Gail Aldinger" []
"Nerd Gale Legrande" []
"Nerd Gay Gradney" []
"Nerd Gema Gerdeman"
"Nerd Gerri Derringer" []
"Nerd Gia Dearing" []
"Nerd Gil Dingler-Gildner" []
"Nerd Gita Tangredi" []
"Nerd Hal Handler" []
"Nerd Hawk Handwerk"
"Nerd Helga Engelhard" []
"Nerd Hulda Underdahl"
"Nerd Ian Rendina"
"Nerd Ingalls Slingerland" []
"Nerd Ingold Dondlinger"
"Nerd Iola Leonardi" []
"Nerd Iona Orendain" []
"Nerd Ira Reinard" []
"Nerd Isa Andries"
"Nerd Jetta Dejarnett" []
"Nerd Jia Jardine" []
"Nerd Jo Jorden" []
"Nerd Kalb Berkland"
"Nerd Kasi Iskander" []
"Nerd Keli Elderkin"
"Nerd Laci Calderin" []
"Nerd Lea Anderle" []
"Nerd Ledvina Vanderlinde"
"Nerd Lee Enderle-Needler" []
"Nerd Leo Olender" []
"Nerd LeSage Greenslade" []
"Nerd Letha Thelander"
"Nerd Lew Wendler" []
"Nerd Lila Nardelli" []
"Nerd Ling Lindgren" []
"Nerd Lips Spindler"
"Nerd Lisa Sindelar" []
"Nerd Lizama Almendariz" []
"Nerd Loma Molander" []
"Nerd Lorna Norlander"
"Nerd Lu Rundle"
"Nerd Luisa Lauridsen" []
"Nerd Luke Kluender"
"Nerd Mae Merenda-Deerman" []
"Nerd Marcy Cryderman" []
"Nerd Mason Manderson-Sonderman" []
"Nerd Meta Determan"
"Nerd Milan Linderman"
"Nerd Minella Dannemiller"
"Nerd Mose Densmore" []
"Nerd Nigel Denlinger"
"Nerd Nilsa Sanderlin"
"Nerd Noah Hernando" []
"Nerd Noe Nordeen"
"Nerd Noemi Merendino" []
"Nerd O'Brian Bernardino" []
"Nerd Oda Denardo" []
"Nerd Ola Leonard" []
"Nerd Oleg Del Negro" []
"Nerd Oma Medrano" []
"Nerd Ozie Derienzo" []
"Nerd Page Pergande"
"Nerd Rae Rearden" []
"Nerd Ray Reynard" []
"Nerd Rigel Redlinger"
"Nerd Ro Dorner" []
"Nerd Rob Bordner-Bronder"
"Nerd Roe Orender"
"Nerd Rog Gordner"
"Nerd Rosa Rosander"
"Nerd Rose Renderos" []
"Nerd Sabio Bedrosian" []
"Nerd Sage Snedegar" []
"Nerd Sal Landers" []
"Nerd Sam Manders-Ramsden" []
"Nerd Santa Santander"
"Nerd Schinke Hendricksen"
"Nerd Sean Andersen" []
"Nerd Shane Hernandes"
"Nerd Si Risden" []
"Nerd Sloan Erlandson"
"Nerd Soila Leonardis" []
"Nerd Sona Anderson"
"Nerd Su Sudner" []
"Nerd Tahir Reinhardt" []
"Nerd Tami Demartin" []
"Nerd Tarah Earnhardt" []
"Nerd Tiesha Eisenhardt" []
"Nerd Vi Verdin" []
"Nerd Wei Redwine" []
"Nerd Wilma Wilderman" []
"Nerd Zane Ernandez"
"Nerd Zoe Derenzo"
"Olsen 'Duh' Hudelson"
"Ph. D. Carri Prichard" []
"Ph. D. Coria Pichardo"
"Ph. D. Lorna Randolph" []
"Ph. D. Ola Adolph" []
"Ph. D. Rees Sheperd"
"Ph. D. Sera Shepard" []
"Ph. D. Shera Shephard"
"Ph. D. Shute Hudspeth"
"Problemist Bo Strimple" []
"Problemist Emil Probst" []
"Prof. Ditch Pitchford"
"Prof. Neal Penaflor"
"Ros 'Duh' Rhodus"
"Ruston 'IQ' Norquist" []
"Savant Dorn Vanostrand"
"Savant Les Vantassel" []
"Savant Neil Vanalstine" []
"Savant Ree Vantrease" []
"Savant Sell Vantassell"
"Savant Stein Santistevan" []
"Sean 'Duh' Dushane"
"Seldon 'Duh' Huddleson"
"Sher 'Bingo' Neighbors" []
"Sona 'Duh' Housand"
"Soren 'Bingo' Bonsignore"
"Tony 'Bingo' Boyington"
"Tora 'Duh' Hurtado"
"Trella 'Bingo' Bertagnolli"
"Una 'IQ' Quain"
"Whiz Root Horowitz"
"Whiz Stoker Herskowitz"
"Whiz Tor Horwitz"
"Wiz Amacker Makarewicz"
"Wiz Ament Weitzman"
"Wiz Bolte Lebowitz"
"Wiz Brooks Brozowski"
"Wiz Chester Schweitzer"
"Wiz Earl Walizer"
"Wiz Elswick Wilczewski"
"Wiz Erick Wickizer"
"Wiz Erline Weinzierl"
"Wiz Erma Mierzwa"
"Wiz Ester Sweitzer"
"Wiz Greeson Rosenzweig"
"Wiz Kissel Liszewski"
"Wiz Kissner Wrzesinski"
"Wiz Kraus Zurawski"
"Wiz Reba Wierzba"
"Wiz Ren Winzer"
"Wiz Roth Horwitz" []
"Wiz Ruth Hurwitz"
"Wiz Scheer Schweizer"
"Wiz Ted Dewitz"
"Wonder Geo Greenwood"
"Wonder Sal Rosenwald" []

book oyster

table of aunt tuna chatter [xxy1] [xxtunachat]
blurb
"asks Tortu why she's tough to hug." [x]
"begins anti-aint-atin[']." [x]
"bemoans explosive vile poxes." [x]
"bemoans gift-fair graffiti." [x]
"bemoans kids hooked on DSL these days." [x]
"bemoans she cannot execute a full parent-entrap."
"bemoans the newest latest sugared sea-drug."
"bemoans Tortu's pouter's posture." [x]
"can't afford Hi-LCD like the parents of that Dilch child." [x]
"clucks at what Dustin became." [x: nudist]
"considers her (and Yorpwald's) favorite card game, Spades Passed." [x]
"considers starting an evict-civet petition."
"continues groans or nags." [x]
"cuts down men's ego-genomes."
"details Flo Fink's slink-off." [x]
"explains she can't just go zizap! Pizza!"
"'Eye-sag? Age? Yes. Gee. Say.'" [x]
"fawns over the Buscher cherubs." [x]
"gives a tut, taut." [x]
"gives unhs. 'Shun huns.'" [x]
"has heard bad kids these days snort wasp paws. Apps? Awws." [x]
"hopes she didn't catch fungal nag-flu." [x]
"hopes Tortu can pass the Ax [']Em Exam. Fish schools are so competitive." [x]
"hopes Tortu doesn't become a truant art nut." [x]
"hopes Tortu drinks lots of Generate Green Tea as a teenager." [x]
"hopes Tortu never comes home smelling of caporal crapola." [x]
"is all 'Hormones, eh, morons!' Oh. Sermon."
"is glad Tortu daren't make visiting the Ardent Rat Den a trend."
"is GLAD Tortu has stayed away from the Rapt Prat Tarp."
"jokes, with ego/tact, 'Get coat! Tot cage cottage!'"
"mentions a friend who needs a hernial inhaler." [x]
"mentions her gout: ego hurt, tougher."
"mentions how more can learn what an author Cameron Mancore is." [x]
"moans 'I have told Terrie, RETIRE!'" [x]
"notes it's almost time to watch [i]Wives['] Views[r]." [x]
"offers PTIs, then tips." [x]
"offers Tortu Astro-Roast for dinner if he learns to be like you." [x]
"recites staler alerts." [x]
"scorns scamp-camps['] bad influence."
"'The spine. Tense hip. Eh, instep.'"
"tut-tuts. Severer reserve!"
"uncoops a soupcon: coupons." [x]
"warns Tortu 'No party if profanity!'" [x]
"wonders why Tortu can't have Edgar's grades."
"worries about pliers['] re-slip perils." [x]
"worries about reaching the iffiest fifties." [x]
"worries about Verne's nerves." [x]
"worries over unstable tan lubes." [x]

table of bar dialogue [xxy2] [xxbarchat]
blurb
"'Abnormal ol['] barman!'"
"'Add ale.' / 'La-de-da.'"
"'Addie's is dead.'"
"'Ah, Bert? Re-bath breath!' / 'Eh, Bart?'" []
"'Ah, Leo. A hole? Heal, o! Ale, ho!'"
"'Ah, novices! Have coins, anchovies?'"
"'Ahab? Baha!'"
"'Alco-cola! Loca!'"
"'Alcohol call! Ooh!'" []
"'Alps? Pall, saps!' Pals slap laps."
"'Ante up! Un-tape, Peanut!'"
"'Any tip for profanity?'" []
"'As to a sot, oats!'"
"'Ashtray?! Ray's hat!'"
"'Bar seat abreast Base Art?!'"
"'The bar!' / 'Eh? ... BART!'" []
"'Bart sucks. His coffee shop, too.'"
"'Bear the beer hat.'" []
"'Beer day: be ready!'"
"'Beer? Gin? Re-binge!'" []
"'Beers! Gin! Bring! See?'" []
"'Begin being human? Uh, MAN.'"
"'BEHAVIOR!' / 'Bro, I have!'" []
"A belchy ale belly ache." [x]
"'Bettina's ain't best!'" []
"'Blood sugar? Bogus lardo! Labours, dog!'"
"'Boor! Snub Bourbons?'" []
"'Break up Rake Pub. Puke bar.'"
"'Burbank bunk-bar? Rank, bub!'"
"'Bus stop sots['] pub? [']S sub-opt.'"
"'By darn, brandy!'"
"'BYOBs? SOBby.'" [x]
"'Champagne, chap? Nag [']em!'"
"A chirp: 'I parch!'"
"'A coke OK, Ace?'"
"'Cost us to cuss? Scouts!'"
"'Coward! Raw cod!'" []
"'Crikey! Ickyer Rickey!'"
"'Croissant? No? Racists!'"
"'Dan Klum's slam dunk!'" []
"'Dares? ... Arsed? Er, sad.'" []
"Dolor-drool. O lord!"
"'Don's up pounds.'"
"'Dr. Ice Riced Cider? I cred!'" []
"'Drink to Dirk? Not!'"
"Dronier Orderin[']." []
"'Dungbury Burgundy? Buy gun, Dr.!'"
"'Each gin nice? Agh!'" []
"'Eh, bars basher? BS, hear?'" []
"'Enos Tam? Mean sot. No mates.'" []
"'Er, [a-b]? A beer?'"
"'Ethanols are another sale.'" []
"A factish catfish shows the ladies he's cash-fit."
"'Fashionable abalone fish? Banal! Fies, oh!'"
"'Feel rad, Fred? Ale! Red Leaf Federal!'" []
"'Fine bosh, bonefish!'"
"'A Fish Has Info on Fashion.'"
"A fish in a dirty suit yells 'To bar! Abort!' repeatedly in a funny accent." [x]
"Flirtation filtration." [x]
"'Float to Alf! ... O, flat.'" []
"'Friendly nerd? I fly!'"
"'Fun bile, bluefin?'"
"'Gee! Brave beverage!'"
"'Gin, Brit? Bring it!'"
"'Gin? Fab. Big fan.'"
"'A gin, Gina?'" []
"'A gin. I nag.'" []
"'Gin, Rob? Big Ron?' / 'Boring.'" []
"'Got any not-gay Tang? Oy!'"
"'Grandi Gin? Rad! Gradin[']: daring!'" []
"Grudging drugging."
"'Had enough?' / 'Uhh...no. Egad!' A honed UGH."
"A halibut, habitual ... 'Aha! Built!'" [x]
"'He dreads redheads. Sadder, eh?'" []
"'Healthy?! Hey! Halt!'"
"'Her BEAT beer hat!'"
"'Herbal? Er, blah.'"
"'Hi, not hit-on?'" []
"'Hi-tab habit? Bah, it...'"
"A hittin[']-it hint." [x]
"'Hold! Spin, hind-slop dolphins!'"
"'Hot ale to heal? Loathe a lot, eh?'" []
"'Howdy! A kiss? Soda? Whisky?'"
"'Humbler rum? Bleh.'"
"'I, born free, in for beer!'"
"'I co-opt octopi!' / 'Coop it.'"
"'I sample a simple lame sip.'" []
"'I'd fry if dry.'"
"'I'll bulge! ... Gullible bluegill!'"
"'I'll set a li'l seat.'"
"'In no way--ANY--wino!'"
"'IPAs?' / 'A sip.'"
"'Irksome. Smokier.' / 'Sore, Kim?'"
"'Kilo, Loki?' / 'I? Ill, kook.'"
"Kind grin? Drinking."
"'Konig gin? OK!'"
"'KRASH! Shark!' Harks." [x]
"'Latham's malts? Ah!'"
"'Le Bore, Lo-Beer!'"
"Leering. Reeling."
"Limpest limpets: 'Split [']em!'"
"'Lo-cal? Us? Callous.'" []
"'Lose, sole, lose!'"
"'Low fat? Ow, flat.'" []
"'Man, sick mackins[']!'" []
"'Marc's? Scram!'"
"Marlins snarl 'I'm...'"
"'Martini? Mini-art!'"
"'Martini! Ram it in!'" []
"'Mel's IPA? I sample. Lime sap!'" []
"'Mid-life file? Dim.'"
"'Mo['] rum, yo!' / 'Your mom!'"
"'Mobs o['] moobs? Sob mo[']!'"
"'Monied-up opium den?' / 'Um, nope, I'd...'" [x]
"'Moray Mayor Amory? Oy, mar!'"
"'More beer? Mere bore!'"
"'Mud-bass!' / 'Sad Bums!'"
"'My ale's measly!'" []
"'My bar, barmy Mabry!'" []
"'My pub's BUMPY'S!'"
"'Nice tan, ancient...'"
"'No grog, gorgon!'" []
"'No vibes? Bovines.'"
"'Nor I'm minor, Normi!'"
"'Octo-coot!'"
"'Oft Sly? Fly, sot!'"
"'Oh no! Sick chinooks!'"
"'Oik-Koi! I KO!'"
"'Ok, cry, Rocky.'"
"'Ol['] bar labor...' Oral blab, or...?"
"'Ole Burt Boulter ... trouble.'"
"'Olives? I LOVES! Live so!'"
"One sip. Opines. 'No pies.'"
"'Out-stare a stouter sea trout?' A sore tut."
"'Pabst? A tbsp.?'"
"'Patching nightcap?' / 'Natch.' / 'Pig.'"
"'Peanuts: neat sup? Un. Paste!'"
"Pesty types whisper to beware clingfish filchings."
"'Phony tee. Neophyte.'"
"'Picante nitecap? Ace! PINT!'"
"'Pink gin, Kingpin?'"
"'Plastic catlips? It ... ' Claps."
"Pre-rant: 'Err, pant, partner.'"
"Pub art: abrupt burp at 'Up, brat.'"
"'Qualite-tequila!' / 'Quite, Al!'"
"'Ragtime? I'm great. Migrate.'"
"'Rah-rah!' / 'Har-har!'"
"'Randomly manly, Rod!'"
"A rant by Bryant. 'Ban! Try!'"
"'Rap? Bunk! Punk bar.'"
"'Rec?' / 'Gin.' / 'Cringe.'" []
"A rich sot ostrich claims to own ShirtCo."
"'Root beer? Rote bore.'"
"'Root pie? Too ripe.'"
"'Rulin['] a urinal? La! Ruin!'"
"'Rum? Kind. ...I'm drunk!'"
"'Rum shot hurts mo[']? Mush! Rot!'"
"'Runt egos, sour gent sturgeon?'"
"'Scoot up, octopus?!' Cop-outs."
"Scorn out. 'Croutons? Scoot! Run!'"
"'Seven evens?'"
"'Shout? Sh! Hush, sot!'"
"'Sip on. POSIN[']!'" []
"'Sips, all?' / 'I'll pass.'"
"'Sit up! Tip us!'"
"'Skip Kip's!'"
"'Slim, get gimlets!'"
"'Slow pub blows up!'"
"A smelt melts. 'Elm St.?'"
"'Snafu-hit, tuna fish? Shun a fit thus, naif.'"
"'Sneak in Annike's!'"
"'Sober up? O, pure BS!'" []
"'Sobriety bites, Roy.'"
"'Soda? Whiskey?' / 'Yikes, shadow!'"
"'Some ban?' Bemoans. Sob 'amen.'" [x]
"'Some bar, Ambrose!'" []
"'Sorghum rum? Gosh!'" []
"'Sounds on! Suds!'"
"Sousier, serious 'Sure, so I...'"
"Spry male lampreys fish for companionship." [x]
"'Squalider? Real squid!'"
"'Streak Staker.' ... 'Takers!'" []
"A stringy, straying stingray! It's angry!"
"A strumpet trumpets pert smut."
"'Sturgeon so urgent? Nuts, ogre!'"
"Tacit yen: ''Natty Ice. Neat city tenacity."
"'Tequila be equitable!' / 'Al, be quiet!'"
"'Tip here, prithee!' / 'Eh, tripe!'" []
"'To sip is top!' / 'O, pits!'" []
"'Too drunk! No? OK, turd!'" []
"Train of not fair for/anti ..." [x]
"Tripes['] esprit: 'Ripest spiter!'"
"'Um, Ron?' / 'No rum, Munro. Mourn.'"
"'Um, sir? ... is rum...?'"
"'Umbrella Label Rum? Lure-balm!'" [x]
"'Un-flat? Flaunt!'"
"'Unpert punter, re-punt!'"
"'Up! A PUA!'" []
"Up-bar, a burp."
"'Up, sport! Support! Pros put...'"
"'Upbeat tea pub? BEAT UP!'"
"'Vimto? Vomit.'" []
"'WarpClub Pub Crawl? Claw! Burp!'"
"'Wendi! Wined?'" [x]
"'Wine goblet! Belting woe!'"
"'XX Ale?! Ex-Lax!'"

table of Casper mumbles [xxy3] [xxcasper]
blurb
"[if player is male]Lon Veist[else]Lois Vent[end if], novelist? Vile snot!" []
"Anti-novel? Let on, vain Valentino!"
"Author? Clem Crouthamel?!" []
"Author? Erb Rothbauer?!" []
"Author? Ess Osterhaus?!" []
"Author? Or haut?"
"Bar-Quotes? Art Bosque? Square-bot!" []
"Camus? A scum."
"Crates of farces to forecast oft scare. Sore fact. Cost: fear."
"Decry lit directly!"
"Distraction, sardonic tit? Roast! Indict!"
"Draft? A fat rad art fad."
"Ego attic-cottage. I cogitate." []
"Evocator overcoat...crave too!" [x]
"Extraordinary intro? Dreary. Ax."
"Far better art? BEREFT!"
"Flaubert? Flat rube!"
"A flourish: four hails?! Fails hour!"
"Freudian feud, rain!"
"Genre regen? Er, neg!"
"Grey men, my genre."
"Haiku, pest? Shake it up!"
"Hyperbole: helper? Boy!"
"I draft, adrift..."
"I Snared a Snider Sardine." []
"Many weigh Hemingway. Enigma: why?"
"Max prosy paroxysm."
"Meta-fiction faction time: am I confetti?" []
"Modernism: dim sermon."
"Muser serum...muser serum!"
"My ideas dim easy. I? Mad? Yes!" []
"Narrative, via errant tavern air."
"Not game to nag me!"
"Oy, adverbs? Savored by raved boys? So very bad!"
"Oy, pert tropey poetry. To pyre!" []
"People's purr: proper pulse? Purple prose!"
"Peso for Prose of spoofer. Pro-foes."
"Pinkos['] ink-ops? No. Skip."
"Plot lines, still? NOPE."
"Poems, else sleep some."
"Poetry slam: masterly op? Sporty? Lame. Ample tyros." []
"Poetry? Stop. Potty prose prototypes."
"Prosey Osprey Ros Pye? O, pyres!"
"Punter's pen, RUST!" []
"Rats, naiver narratives."
"Rhett Weir, the Writer: Err, Twit, Eh?"
"Rio Demps? Sid Premo? Dim prose, PROMISED!"
"Riveter Town? Woven triter. Overwritten."
"Sentiment intents? Me?"
"Short yips. This prosy sophistry!"
"Sly tone? Only set. No style."
"Some poets, pose-smote, emote. SOPS!"
"Speak to a pest? OK." []
"Thoreau? Ah, outre!" []
"To parse at prose, prate so." []
"Tom Snider? Snot-mired modernist!"
"Undersea, endure as earn dues."
"Unto epic? Nope, I cut: unpoetic! Pout? NICE."
"Vapid prose? Disapprove!"
"Vigor-lent grit novel? Revolting!" []
"Writing. Wring it..." []
"Yep, so-posey Poesy!" []

table of competing bars [xxy4] [xxcompeting] [xxcompete] [xxbars]
blurb
"[a-b]'s Base" [p] []
"Absorbing Bingo Bars" []
"Abstract Cat Bart's"
"Absurd Sud-Bar"
"Ageless Lesage's" []
"Aimless Ismael's" []
"Ales Dr. Adler's" []
"Animistic Caminiti's"
"Anti-Racist Carattini's"
"Arbitrary Rarity Bar"
"Arsenous Rosenau's"
"Artless Slater's"
"As-Foul Fasulo" []
"Asserter Terresa's"
"Assured Sauder's"
"Assurer Rauser's"
"Awtrey's Wastery"
"BAL Lab"
"Balfour's Foul Bars"
"Barb-O's Absorb-Sob Bar"
"Bawdier Aid-Brew Wide Bar" []
"Beat-Up Eat-Pub" []
"Becky-Sue Buckeye's"
"Bent-Up Pub Ten"
"Best-Ever Vets['] Beer" []
"Bingo's Hot Gin Booths"
"Bird Ave. Dive Bar"
"Blandisher Hildebran's"
"Blase Abel's" []
"Blesser Belser's" []
"Blistering Breitling's"
"Blowers-Breslow Ol['] Brews" []
"Bo Monster-Trombone's"
"Boarded-Up Adored Pub"
"Bod-Surf Buford's"
"Boozing Goon Biz" []
"Brassy Byars's"
"Brit-O's Bistro" []
"Bro Stan Barton's"
"Brownlee's Loners-Web"
"Burnt-Up Runt Pub"
"Burping-Grin Pub"
"Busker Burke's"
"Busy Bee Bub Yee's"
"Charmless Chalmers's"
"Charybdis Shady Crib"
"Cheerless Scheeler's"
"Chipster Pitcher's"
"Clawless Caswell's"
"Codi's Disco"
"Contessa Toscane's"
"Converso Conover's"
"Corsair Carrio's"
"Darned Rad Den"
"Desirer Dreier's"
"Diasporic Dicaprio's"
"Diffuse Duffie's"
"Diseur Rudie's"
"Don Lew's Low Dens" []
"Dork Scum Murdock's"
"Dr. Nik's Drinks"
"Drabbish Hibbard's"
"Droogish Hidrogo's"
"Druggiest Gutridge's"
"Drunkest Kundert's" []
"Duchamp's Chums Pad"
"Dweebish Whidbee's"
"Ebinger Beer/Gin"
"Ed Trunk's Drunk Set" []
"Egg-Stink Kent's Gig"
"Egoless Goslee's"
"Elite Snot Leonetti's"
"Elsy Ley's" []
"Embosser Ormsbee's"
"Ersatz Raetz's"
"Escaper Pearce's"
"Ester-Lin Leitner's" []
"Exister Trixee's"
"EZ-Boro Boozer" []
"Ferniest Infester Neifert's" []
"Fisk [']N Fink's"
"Flask [']N Flanks"
"Flip Side Sip Field"
"Foams of Sam"
"Forrest's Fortress"
"Forum of Rum"
"Four-Eyes Rufe Yeo's"
"Garbless Sal Berg's"
"Gekko's OK Kegs"
"Get-Loaded Date Lodge"
"Ghastlier Iglehart's"
"Gigster Tigger's"
"Glassier Sir Gale's"
"A Glug Gulag"
"Go-Dance/No-Cadge Decagon" []
"Goadster Degroat's"
"Gospeler Ploeger's"
"Governess Vergeson's"
"Greasy Yager's"
"Green-Bread Beer Garden"
"Greenbeard's Beer Gardens"
"Griselda Aldrige's"
"Gritless Stigler's"
"Harp-Lots Lathrop's"
"Hater Su Huerta's"
"Headless Ales Shed" []
"Headstrong Ned Hartog's"
"Heal-Fast Ale Shaft"
"Hip Castle This Place"
"Hirsute Ruthie's" []
"Hitless Stiehl's"
"Homesick Mike Cho's" []
"Hortense Noether's" []
"In Shark Harkin's" []
"Ineptest Spinette Pettine's"
"Insaner Narine's"
"Investor Trevino's" []
"Islander Erlinda's" []
"It's-Free Eifert's" []
"Kate's All-Ale Stalk"
"Kay Pease's Speakeasy"
"Ken's Ribald Drinkables"
"Kick-[a-word-u] Kasick's" []
"LaSalle All-Ales"
"Lawless Sal Lew's" []
"LeBarron's Loners Bar"
"Lefty's Fly Set"
"Leia's Aisle" []
"Leo Oden's Loose Den"
"Less-Down Denslow's"
"Lianne's Ales Inn" []
"Lisbeth Blithe's"
"Listener Leitner's" []
"Local Pub Club Opal"
"Loosener Leonore's"
"Loser [']N Loners" []
"Lossmaker Marsolek's"
"Lost Ray Taylor's" []
"Lugones Lounges"
"Luscious Lucious's"
"Machineless Michaelsen's"
"Mad Swine Weidman's" []
"Matchless Stelmach's"
"May-Lu's Asylum" []
"Meanest Mateen's"
"Measlier Marilee's"
"Mechanist Teichman's"
"Mega-Star Magaret's"
"Minstrel Miltner's" []
"Mintiest Minetti's"
"Miscast Stimac's"
"Miscreant Martinec's" []
"Miscreator Cromartie's"
"Misdealt Matilde's" []
"Misleader Edelmira's"
"Monstrous Snoot-Rums" []
"Moraliser Lairmore's"
"More-Posy Pomeroy's" []
"Mr. Leto's Merlots"
"Ms. Mae-Emma's"
"Ms. Too-Moot's"
"Ms. Top-Con Compton's" []
"Neatest Anette's"
"Newsman Newnam's"
"No-Brats Barton's" []
"No-Class Con Sal's" []
"No-Sides Edison's"
"Nyssa Snay's"
"Ole Sot Toole's" []
"Once-Sly Conley's"
"Outscorning Courington's"
"Over-Sad Devora's" []
"A Palest Palate's Ale Taps"
"Parnaby's Pays Barn"
"Party'n Pantry"
"Pat Ching's Nightcaps"
"Pet Bear Beer Tap"
"Pillburg Pub/Grill"
"Pissy Ev Spivey's"
"Plastic Cal's Pit"
"Plausible Allies Pub"
"Pleasant Pal [n-t]'s" []
"Plenished Delphine's"
"Po['] Blue Ole Pub-Pueblo"
"Politest Pistolet Pilotte's"
"Pollster Portell's"
"Poor-Fish Ship-Roof"
"Porthos Throop's"
"Postable Potables"
"Presidio DiPiero's"
"Pressing Persing's" []
"Primrosed Pridmore's"
"Prisoner Perrino's"
"Pristine Petrini's"
"Prosier Pierro's"
"Prostrate Perrotta's"
"Prostrate Porretta's" []
"Psoriatic Patricio's"
"Pukinest Punk Site"
"Punk-Rid Drink-Up"
"Push-Back Shack-Pub" []
"Quail or a Liquor"
"Quisling Gil Quin's"
"Rainbow Wino Bar" []
"Rammel's Slammer" []
"Rank Scab Snack Bar"
"Rank-Vibes Kevin's Bar"
"Rash Low Warhol's"
"Rasta-Tara's" []
"Really All Rye"
"Reese [']N Renee's" []
"Reinsman Riemann's"
"Reposed Deposer Peredo's"
"Reposer Roeper's"
"Resighted Ethridge's"
"Resigner Greiner's"
"Resister Reisert's"
"Rey's Ryes"
"Risky Ol['] Kilroy's"
"Roadster Rodarte's"
"Robinson Boors['] Inn"
"Rolf-o's Floors" [] [p]
"Rookish Hiroko's"
"Roseline-Elinore's"
"Rosy Roy's"
"Rule-Shy Hurley's"
"Rum-Hit Rim-Hut" []
"Sad Chump Duchamp's"
"Sad Joker Dark Joe's Soda Jerk"
"Sad Lifer Elfrida's"
"Sad Ol['] Aldo's" []
"Sad Tony Dayton's" []
"Safe Fae's"
"Sandy, Sy and Andy's" []
"Santosh Ashton's"
"Sartorian Orrantia's"
"Satanical Catalina's"
"Savvier Viv Rea's"
"Scumlike Mikulec's"
"Sea Hog Hoage's"
"Sea Hound Donahue's"
"Secluded Lee Cudd's" []
"Senhor Rhone's" []
"Sensist Stiens's"
"Sentry Teryn's"
"Seraphim Ephraim's"
"Sez-No Enzo's"
"Shakey Hayek's"
"Shamed Ahmed's"
"Sharon Horan's" []
"Sheer Rhee's"
"Shelterin['] Hertline's"
"Shemeka Hakeem's"
"Sherell Heller's"
"Sherron Horner's"
"Shirley Hilyer's" []
"Shogun Huong's" []
"Shouty Touhy's"
"Shy and Handy's Shandy"
"Sing-Bad Big Dan's"
"Sir Ban-Brain's Sin Bar" []
"Sir Fink Firkins" []
"Sizable Bazile's"
"Sketchy Ty Heck's" []
"Sky Cub Bucky's" []
"Sleepy Epley's" []
"Slouching Coughlin's"
"Sloven Levon's"
"Slumbery Brumley's"
"Slummer Rummel's"
"Sly Cur Curly's"
"Sly Hater Hartley's"
"Sly PUA Pauly's"
"Smacker Cermak's"
"Sneak Kane's" []
"Sneakish Kenisha's"
"Sneako O'Kane's"
"Sneerful Feulner's"
"Snide Maw Wideman's" []
"Sniggerer Geringer's"
"Sniveler Verline's" []
"Sniveller Renville's"
"Snob Cal Blanco's"
"Snobbish Bob Shin's"
"Snobbish Hobbins's" []
"Snootier Tenorio's" []
"Snore-Bar So Barren"
"Snouty Yount's"
"So-Bubbly Sub-Lobby"
"So-Golden Len Good's" []
"So-Lazy Ol['] Yaz's"
"So-Manic Mo Cain's" []
"So-Mental Almonte's" []
"So-Snide Edison's"
"Sobered DeBoer's"
"Sodaless Salsedo's"
"Soggier Georgi's"
"Soggier Reggio's" []
"Solano's Saloons" []
"Soloist Losito's"
"Soulful Foul Lu's"
"Souser Rouse's" []
"Sparkiest Petrakis's"
"Spatulate Pauletta's"
"Spirits of Forti-Sips"
"Spleeny Penley's"
"Sportin['] Ripton's"
"Squinty Ty Quin's" []
"Starchier Reichart's" []
"Steely Ty Lee's"
"Stepping Gent Pip's"
"Stonemason Montesano's"
"Stoner Treon's" []
"Strapping Pip Grant's"
"Stringy Ty Ring's"
"Stubborn Runt Bob's"
"Subprime Miser Pub"
"Swindler Drew Lin's"
"Sy and Andy's" []
"Synergist Ty Singer's"
"T'Niche Ethnic"
"Tarnisher Reinhart's"
"Tarnisher Rinehart's" []
"Tay's Stay-a-Sty" []
"Tetanising Giannetti's"
"Thawiest Thwaite's" []
"Timeless Steimel's" []
"Timothy's Hot Misty Mo-Hit Sty"
"Top-Bucks-Stock Pub"
"Toros['] Roost"
"Trappist Tart Pip's"
"Trash Man Rathman's"
"Trasher Erhart's"
"Tropical Coral Pit"
"Ty Han's Shanty" []
"Ty's Sty"
"Un-Slick Culkin's"
"Un-Smart Truman's"
"Unscarred Durrance's"
"Unscrambled Cumberland's" []
"Unsocial Lou Cain's" []
"Unsocial Luciano's" []
"Unsporting Purington's"
"Up-So-Late Ale Spout"
"Uptight Thug Pit"
"Us-R-Lo-IQ Liquors"
"Very Slick Rick Levy's"
"Wan Gin Awning"
"Wardless Sal Drew's"
"Wastin['] Tawni's" []
"Wastin['] Twain's"
"Wastrel Art Lew's" []
"Webster's Brew Sets"
"Wild Gus Ludwig's"
"Will's Swill"
"Wistful Wilt Fu's"
"Woodbine Wino [']Bode"
"Worthless Elsworth's" []
"Wussy Sy Wu's"
"Ye Keg Geeky"
"Yer Rye"
"Zestful Zufelt's"

table of fish fries [xxy5] [xxfish] [xxfries]
blurb
"'Acne cane? [']E can!'"
"'Ain't Fly, Faintly!'"
"Apin['] pain."
"'Apt rub. Rap, but ... abrupt 'Up, brat!'"
"'Aunt Tuna? A nut!'"
"'Bad short trash-bod!'"
"'Baited, eh?' / 'I...' / 'Be hated!'"
"'Bed-wetter! We'd better...'"
"Beer blurb. 'Reblubber, blubberer!'"
"'Big dork! Borg kid!'"
"'Big head? Bag, hide!'"
"'Bilger Gerbil!'"
"'Boogery ogre-boy!'"
"'Booky boy? KO!'"
"'Bullies? Us? Libel! Li'l [']buse!'" [x]
"'Burnt-out trout-nub!'"
"'Classwork Crosswalk? Slack! Rows!'"
"'Crowd-a-coward, crowd-a-coward!'" []
"'Crud-curd!'" [x]
"'Crumby bum! Cry!'"
"'Cry mum? Crummy!'"
"'Curse, eh? Cheer us!'"
"'D'oh! Cue Ed Chou!'"
"'Darkling Lard King!'" []
"'Darned dander!'"
"'Don't dare, toad-nerd!'" []
"'Don't EVER vote, nerd!'"
"'Dood? Odd-o dodo!'"
"'Dork-KO Dr.!" [x]
"'Dorkiest-Kid Store?' Skit redo."
"'Dull boy? Bully! Do!'"
"'Each op's so cheap, eh, capos?!'" [x]
"'Eco-runt?! Trounce!"
"'Er, books? So broke bores, OK?'"
"'Faky bore! Freak boy!'"
"'Fart? I? No! Not fair!'"
"'Feca-face!'"
"'FFS, joker!'"
"'A fight: fit? Gah!'"
"'FILA? Fail!'" [x]
"'Fit? STFU! Stuff it!'"
"'Flat-out fat lout!'" []
"'Fragile, e.g. frail.'" [x]
"'Friends? Nerds, if...'"
"'Frilly lil['] fry!'"
"'Frowsy sow-fry!'"
"'Fruity!' / 'F U I try!'"
"Ganging, nagging."
"'A gassy gay-[a-word]!'"
"'Gimpy pigmy!'"
"'Go, ya gayo!'"
"'Goonies, noogies!'" []
"'Hate a het?'"
"'Haw-haw.' / 'Wah-wah.'"
"'Hesitant hate snit?'" []
"'Him, spry? Shrimpy. Prim. Shy.'"
"'Hokey worm, homeworky!'"
"Hoodlums['] sumo hold." [x]
"'Hurtins! His turn!'" []
"'Hyurr! Hurry!'"
"'I mean, anime?!'" []
"'I...' / 'Psh, Mr. Shrimp.'"
"'Jerkos? Jokers!'"
"'Jerks? J/k-ers!'"
"'Kendrick nerd-kick deck-rink? Kind rec, [']k?'" [x]
"'Knits stink.' Tskin[']."
"'Le gawkin['] Weakling!'" []
"'Leper-Repel!'" [x]
"'Li[']l guy...' uglily."
"'A lil['] dork! Roadkill!'"
"Lip blast. Spitball."
"'Loner. So?' / 'No! Loser!'"
"Luls by bullys."
"'Math nerd!' Darn them." []
"Mean name. Amen." [x]
"Mean name. Meaner re-name."
"Mo['] nuts um-nots.'" [x]
"'Mr. Not-a-Matron!'"
"'Mr. Those-Smother-Mothers!'" [x]
"Naif pun. Pain. 'Fun!'"
"'A nerd! Read'n!'" []
"Nice-o?! On ice!" [x]
"'Nickname, Manic Ken?' / 'Acne Mink!'"
"'Notorious? No. Riotous!'"
"'Oo! Hm! Homo!'"
"'Out of...? Oo, tuf!'"
"'Pals?! Pals.' ... SLAP!"
"'Pathetic? Teach-tip.'" []
"'Phew, Tim! The wimp wept, him!'" []
"'Pick on cop kin! Poinck!"
"'Pink belly! Blink! Yelp!'"
"'Pinko!' Pokin[']. POINK!" []
"'Ploated tadpole!"
"'P.O.[']ed? Dope!'"
"'Popeyed dope! Yep!'"
"'Punch a paunch!'"
"'Punishment! Nine thumps!'"
"'Queen or queer?' / 'NO!'"
"'Queer-[a-word] squarese!'"
"'Rad! KO a dork!'" []
"'Rad lass, lard-[a-word]?'" [x]
"Rash rahs." []
"'Ratlet! Tatler!' Rattle, rattle." [x]
"'Re-bait, baiter! BEAR IT!'" []
"'A rebel? Be real!'"
"'Retort us? Tortures!'"
"'Rid ya diary!'" []
"'Roast up a Sprout!'"
"'Schnook ... no shock.'"
"'Scholar chorals? Lo, crash!'" [x]
"'School's cool? Ssh.'"
"'Shabby Baby, Sh!'" []
"'Sham ills! Smallish li'l smash!'"
"Shameful, uh, flames." []
"'Shouldn't stun hold? Sold! Hunt!'"
"'Simp! P.S., I'm...' Imps."
"Skeletal eels talk." []
"'Smallest! Let's slam!'"
"Sneeriest interesse."
"Snot-laugh onslaught."
"'So daft, da soft fat sod!'" []
"'Soap a sop! Oops, a sap!'"
"'Sore lad! Real sod!' Reloads." []
"Sorta-Ratso-Roast." [x]
"'Spy, us?'"
"'Surname? Unsamer!'" [x]
"'Swarthy, shy wart!'"
"'Taunted-attuned? End? Tut, a ...'"
"Taunting-attuning." []
"'Tawt!'"
"They mock his computer game Fowl, Wolf, Lowf (lowfat loaf) across the Flow." [x]
"'The toad-head tot!'"
"Tons-loud 'Told on us, lout?' Nods."
"'Too-fat oaf tot!'"
"'Tool-guy! Too ugly!'"
"'Trip-Me Permit? I'm pert!'"
"'A trout? Out, rat!'"
"'Trout? Ur-tot!'"
"'Ugly! Hints: unsightly!'"
"'Un-erotic! Neurotic!'"
"Unstating tauntings. Giant stun."
"'Ur-tyke! Turkey!'"
"'We don't care, coward teen! React? Owned!'"
"'We're in tune, weenie runt!'"
"'Weakling! Like Wang!'" []
"'What a tool! Whoa, total!'"
"'Whip us, mac? Such a wimp!'"
"'Wit at a twit!'"
"'Woe-rid, weirdo? Dire!' / 'Ow!'" []
"'Wotta twat-o!'"
"'Yob-boy!'"
"'Yon kid's so dinky!'"

table of theses [xxy6] [xxtheses] [xxsheets]
blurb
"Ah, tote hate to the tao!"
"Alert, clown: we can troll!"
"All teeth tell hate."
"All We Do: ALLOWED!" []
"Ardent, Rude, Underrated."
"Arg! Woot! Go to war!"
"Arm! Chains! Manic rash anarchism!"
"ARM! RAM! MAR!"
"The ASBO be as hot!"
"AUNT TUNA (an unflattering picture, captioned weight: A TUN)" [p] [x]
"Aw, a creep: peace? WAR!"
"Aw, sock wackos!"
"Aye for year of fear, yo!"
"Bad ones['] ASBO Den!" []
"Bad Rule = DURABLE!"
"Baseline: lies, bane!"
"Be [']wared! We're bad!"
"Be Horrid? Hired, Bro!" []
"Be rotten, no better!"
"Being mean? Binge! Amen!"
"Brutality! Truly, BAIT!"
"But yeah, buy hate!" []
"Chaos? Yep, so peachy."
"Comply with my low pitch!"
"Conk them, then mock!"
"Consider nicer? SOD!" []
"Defense? Send fee!"
"Deny Thee the Needy!"
"Depants pedants!"
"Disputer-prude, SIT!" []
"Do bilge? Bile, dog? Obliged!"
"Do not REVIAL ELVIRA!" [x]
"A doc's got good acts? Gad, scoot!"
"Docile I. E. CLOD!"
"Doctor a card, too!"
"Dorks['] Way: Workdays!"
"Down with the Snuf-Funs league!" [x]
"Drub oafs bad for us!"
"Drugs are rad urges!"
"Eh, mock mo['], heck!"
"Enjoy ireful life journey!"
"Erudite? True? DIE!"
"Ethics are tire-aches. Scathe! Ire!"
"Evil caste? C'est la vie!"
"Exclusivest vices? Exults!"
"A fairy? We fire away!"
"Fib, stump, BUMP FIST!"
"Fie, toss softies!"
"FIND GUN FUNDING!" [x]
"Find mega-defaming!"
"Front us? Snort! F U!" []
"Glock-rid? Gridlock!" []
"Go, filth of light!"
"Go nuclear, rogue clan!"
"Goal Now: GOON LAW!"
"Golden rule? Duller! Gone!"
"Golden Rule? Olden gruel! On, Greed (LUL)!" []
"Good faith? Goof had it!" []
"Grundies? Ding! Sure!"
"Hated? My, THEY MAD!" []
"Haunter? Un-hater!"
"Hell's rad! Hard sell!"
"Here, bad be heard!"
"Ho, conks? No shock!"
"Hologram Harm Logo? Oh, glamor! Gloom! Rah!"
"Hug thee? A huge hate!"
"Huge want? Wage hunt? A new thug!"
"I, a crave: AVARICE!"
"'I donate?' DIE! A TON!" []
"I put down to wind up."
"I support riots, pup."
"Ill tempers melt perils!"
"Inspire sin: I rep!"
"It's our time! Merit is out!"
"Jackboots: jock, boast!"
"Kids, rebel! Risk! Bleed!"
"Kindness-sinks? END!" []
"Know math? WHAM! TONK!"
"Laughably bully a hag!"
"Lawfulness? Fallen wuss!"
"Legalize the Noisier ioniser!" [x]
"The libe BELIETH!"
"Life sucks? Lick fuses!"
"Listen to the Cad-Spot Podcast!" [x]
"Loud music: um, so lucid!"
"Lout, never volunteer!"
"Lout-Set Outlets? Let us TO!" [x]
"Low, shady showy lad? Hold sway!"
"Mafian Infama: I'm a Fan!"
"Maim loser memorials!"
"Mean froth! Harm often! Fear month!"
"Mean seeks make sense!"
"Mean stuff, me: fast fun!"
"Mercy? KO! Mockery!"
"Mervin's Vermins? Servin[']m!"
"Mocked? Deck mo[']!" []
"Moralz? LAMZOR!!!!" []
"Nag thou not: hug a gun-oath."
"New potshot! When to stop? Tenth swoop!"
"Nice? Shoo! Cohesion!"
"Nicer? Got to cringe!"
"No group gun-poor!" []
"No guts? To guns!" []
"No Simple Limp Ones!"
"Not crude? TROUNCED!"
"Note Amply: Meany Plot on my Plate." []
"Novices? Vie, cons!" []
"Nuts: hear haunters? Run! Haste!"
"Obliterate to Liberate!"
"Officials ail! I scoff!"
"Oh, mean's no shame." []
"On, spite! To snipe!"
"Oppression? Props! Noise!" []
"Our 'D': DOUR!"
"OUR DESTINY: IT'S YOUR END!" []
"Our life: foul ire!"
"Our snivel livens our revulsion!" [x]
"Our Trip: Con to Incur Pro-Corruption." []
"Our way: YOU! WAR!"
"Overthink, ho? Vent! Irk!"
"Permit venom? IMPROVEMENT!"
"Pogrom! Go! Romp!"
"Prudes? Us? Derp!"
"Pun, hi? Un-hip!"
"Rise, mock more sick!"
"The rogues, us, go there."
"Roll out our toll!"
"Ron's Den = NO NERDS!"
"Ruffian Funfair? I? Ur-naff!"
"Saint? No! Sin a ton!" []
"Same? No! So Mean = Mo['] Sane!"
"Save foul values of love? Us? FA!"
"Seabed? DEBASE!"
"Shame only holy names!"
"Shove-u! Huevos!"
"Shut off stuff, ho!" []
"Simp, omit optimism!"
"Sir, hate hastier!" []
"So, all get tall egos!" []
"So glum? Slug mo[']!" []
"So, grift? Go first!" []
"Some tact? Tame? COST!"
"Soured? Sure, do so rude. Us: redo!" []
"St. Hug-Thugs!!!"
"Stop being big pest? NO!" []
"Super kind? Pride: sunk! Ride, punks!"
"Super nice? I pen curse!"
"Terrorise, roisterer!"
"A theme: hate [']em!"
"Think free? THERE, fink!"
"THUD! Fear the fraud, Utah Fred."
"Thud-Prime TRIUMPHED!"
"Thug row? WROUGHT!"
"A thump? Um, phat!"
"THUNDER! DETH! RUN!" []
"To envy: yo, vent!"
"Trash pays. Stay sharp, rash patsy!"
"Truer pact? Utter [crap]!"
"Turn away a wary nut!"
"Upright? HUT, prig!" []
"Us? Base? [']S Abuse!"
"Values? Pah! Upheavals!"
"Violence once. LIVE!" []
"Virtuous? OUT, VIRUS!"
"War is hell? Hear swill! [']Ware shill!"
"We fail law, fie!" []
"We HALT the law!" []
"We hate thee? Aw!"
"We post to spew!"
"We, pro-POWER!"
"We rid weird!"
"We Roll Orwell!"
"We toast to waste!" []
"Yo, glug: go ugly!"
"Your ideas? Aye, I'd sour."

table of tuna gossip [xxy7] [xxtunagossip]
blurb
"'About me: a bum toe!'"
"'Ahem. Ah, me!"
"'Annie's insane.'" []
"'Arlette's alertest.'"
"'As to Phil? Hospital!'" []
"Aunt Tuna notes Trina's starin['] strain." [x]
"'Babbly, blabby...'"
"'Bad cons abscond.'" [x]
"'Baking soda? Bad soaking!'"
"'Belinda? Bed-lain!'"
"'Bernice, be nicer!'"
"'Beware Reba. Ew!'" []
"'Birdie? I be rid!'"
"'Body fat? Daft boy.'" [x]
"'C grade is disgrace!'"
"'Cary's scary. Carrie's scarier.'"
"'Catherine's inert aches...'"
"Cathie's achiest."
"'Cats ruin curtains!'"
"'Charmaine? A mean, rich maniac, her!'" []
"Cornelia's censorial!" []
"'Corns?! Scorn!'"
"'Creak, blow, lower back! Rack, elbow!'" [x]
"Cristie's eristics!"
"'Damp Cay Day Camp? Pay'd, mac!'"
"'Demean MANDEE?!'"
"'Diedre, er... DIED!'"
"'Dinkey kidney. Key'd in?'"
"'Discretion. Consider it!'"
"'Dodo's so odd.'" []
"'Doloris's Lordosis...'"
"'Dopy Lora. Poor lady!'"
"'Doreen? Redone.'"
"'Dr. Ace CARED!'"
"'Dreadful, fad-ruled lad, Freud.'"
"'Elma is a slime.'" []
"'Elyisa Easily lies, ay.'" []
"'Evelyn? Le envy, evenly...'"
"'Forty's frosty."
"'Gad, sly Gladys!'" [x]
"'Greasily, Gary lies!"
"'Gro-Vite?! Vertigo!'"
"'Have no oven? Ha!'"
"'Hives on veins, oh!'" [] [x]
"'Hobbled bod. Bleh.'" [x]
"'I am sore! Some air!'"
"'I fear a fire!'" [x]
"'I have a hive!'" [x]
"'I smell ills, me!'"
"'I'd seen Denise denies needs I...'"
"'I've eggs, veggies...'"
"'Ilene's senile.'"
"'Ill-ease, I see all! Lea lies!'"
"'Insole lesion: lies? NO!'"
"'Kari, she...' a shriek."
"'Karine's snakier.'"
"'Lilith's THIS ill.'"
"'Lilo's so ill.'"
"'Lily's silly.'"
"'Lisa ails!'" []
"'Lise LIES!'" []
"'Loud mosh hoodlums. Hum, so old!'"
"'Malaise ails me. A Malaise!'"
"'Maureen's mean, sure.'"
"'Maurine's aneurism.'" []
"'Melodrama?! Alarm mode!'"
"'Mere nag. Ma Green, Ma Green.' Germane near-gem."
"'Meredith mithered.'"
"moans about Crissi and the latest crisis."
"'Mopy, dire period. My!'"
"'Morty's stormy.'" []
"'Mr. O'Steel? Leer-most!'"
"'Ms. Elia is lame.'" []
"'My belief, I'm feebly!'"
"'Napster ENTRAPS!'"
"'Nellie's seen ill.'"
"'Neutral? Un-alert, real nut!'"
"'No Fan of Ann!'"
"'OK, I scold cool kids.'"
"'Old hens?! Sheldon: held, son.'" [x]
"'Oswald was...old.'" []
"'Painful flu! I nap!'"
"'Pains! I snap!'" [x]
"'Patricia's parasitic.'"
"'Perry's spryer.'"
"'Phases pass, eh?'"
"'Phyllis? Shy? PILL.'"
"'Prissy is spry.'"
"'Rant is: rats in trains!"
"'Risk Irks Kris.'"
"'Rita, Trish...ARTHRITIS!'"
"'Ruth's hurts? Rush-thrust.."
"'Sammi, a miasma.'"
"Scareful 'Carefuls.'"
"'Serial, serial re-ails!"
"'Shad or Rod Ash hoards so hard.'"
"'SharkNet Thankers? Ken? Trash!'"
"'Slacken, cankles!'"
"'Slang is sin, gals.'"
"'Snottier is rotten!'"
"'So funny of Sunny!'" [x]
"'So, pigs gossip!'"
"'Stacy? A cyst!'"
"'Stick-up upticks! Tips? Uck!'"
"'Tania's a saint!'" []
"'Tendonitis! Distention!'"
"'Tenser age generates TEENAGERS.'"
"'There's Hester...'"
"'These times hit esteems.'"
"'This ear, it hears.'"
"'Thresa's Rashest.'"
"'Tiffy? Fifty.'"
"'Tonya's a stony nasty-o!'"
"'Traci's racist. Crista...'"
"'Treena? Renate, Neater!'" []
"'Trina's strain...'" []
"'Trista is tart.'" []
"'Trudy's sturdy.'" []
"'Tut! Erin? Utterin['] nuttier!'"
"'Un-zen as Suzanne?!'"
"'Vera's raves...'"
"'Vi's beau: abusive!'" []
"'We note one wet teen, ow! Not wee!'"
"'Wholer Howler? Low, her.'"
"'You can't!' Coy aunt!" [p] [x]
"'Zits care? Craziest!'"

table of unpopular girls [xxy8] [xxgirls]
blurb
"Achier Charie" []
"Acrid Darci Icard"
"Aeriest Teresia"
"Agit-Gita" []
"Ailin['] Liani"
"Aimless Melissa" []
"Alien Aline" []
"All-Sad Dallas" []
"Alpo Opal"
"Anti-Car Catrina"
"Antlike Katelin" []
"Arf'n Fran"
"assumed Medusas" [p] []
"Babyish Shy Abbi" []
"Berintha the Brain"
"Blandie Belinda" []
"Borin['] Robin"
"Brained Brandie"
"Canine Nancie" []
"Carrion Corrina"
"Catarhine Catherina" []
"Creative Traci-Eve" []
"Cross-Eyed Cody Esser"
"Dandruff Fran Fudd"
"Dazed Zedda"
"Dire Deri Reid" []
"Dull-Airs Drusilla"
"Eat'n Tena" []
"Edema Medea" []
"Erratic Terrica"
"Foliate Teofila"
"[']Fraid Frida"
"Frog-Face Off-Grace"
"Gila Gail"
"Greenish Sherie Ng" []
"Haglike Kaleigh"
"Hair-Taken Katharine"
"Hairless Rash Ilse" []
"Hater-Clot Charlotte" []
"Hater Retha" []
"Hazard Zardah"
"Hesitant Tina Tesh" []
"Hi-Fat Faith"
"Hiss-Cry Chrissy"
"Ickier Rickie"
"Irker Kerri" []
"Iron Roni Niro"
"Jello-y Joelly" [p]
"Just-a-Nerd Jean Durst"
"Kate Chow the Wacko"
"Kooky Kyoko"
"Lame Elma"
"Lanky Kalyn"
"Lardo Dorla" []
"Lazy Lyza"
"Leadenly Danyelle"
"Leaky Kaley LaKey"
"Leaky Keyla" []
"Liar-[a-word-u] Larissa"
"Loamier Malorie" []
"Look-Like-Kook Elli"
"Machine Ami Chen" []
"Mailless Mellissa" []
"Manky Mynka"
"Martian Martina" []
"Meager Margee" []
"Mealier Marilee"
"Meerkat Tremeka"
"Menacer Marcene"
"Menial Melani" []
"Middler Mildred"
"Minge-O Imogen" []
"Narker Karren"
"NASA Math Samantha"
"Neatnik Tennika"
"No-Lays Alyson" []
"Odorate Teodora"
"OK Bore Brooke" []
"Oozey Zooey"
"Piggee Peggie"
"Pop-Eyed Edy Pope" []
"Rabid Darbi" []
"Ranker Karren" []
"Reekin['] Kerein" []
"Reeky Kerey"
"Remedial Edelmira" []
"Scarfin['] Francis" []
"Shriller Sherrill"
"Shy-or-Horsy Rosy H"
"Snitchier Christine" []
"So-Scary Coryssa" []
"Stare-e Teresa" [] [p]
"Stenchier Christene"
"Stinkier Kristine" []
"Striky Kristy"
"Tackier Katrice" []
"Tankier Katerin"
"Thyroid Dorithy" []
"Tiring Ingrit"
"Too-Flat Loo Taft"
"Too-Weak Kate Woo"
"Too-Weird Teri Wood"
"Trudger Gertrud"
"Turdy Trudy" []
"Unpopular Luan Roupp"
"Unsocial Nicola-Su" []
"Unstable Luna Best" []
"Viral Avril" []
"Yellowish Holly Wise"

book towers

table of gizmo parts [xxw1] [xxgizmo]
blurb
"a-parted data pre-adapter"
"all-portion pollinator"
"alt-speed pedestal"
"anti-germ-emigrant"
"anti-slam talisman"
"Anytime Amenity"
"balanced lace band"
"be-luck buckle"
"bend-or-bonder" []
"big gig bib"
"Boasty-say bot"
"Boulder Doubler" []
"brindle blinder" []
"bus-pack backups" []
"catch-em-tech cam"
"cel-scan-cancels acc-lens"
"Centroidal Declinator"
"Clasper Placers" []
"clutters scuttler"
"collapse-all scope" []
"a complex exo-clamp"
"coolant loot-can" []
"CoreOps Scooper"
"Corpsman crampons"
"crackle-clacker"
"Daze-Adze"
"dipthong-pod thing"
"displacer-slicer pad"
"dispose-podsies"
"drinkable-bread kiln" []
"dry earth hydrater"
"e-terrain retainer"
"ear-bud dauber" []
"eat-mech machete" []
"Electro-Corelet" []
"ensconce-so cones"
"epic rants print case"
"epic taints-antiseptic" []
"an epulotic poultice"
"err-out router"
"errantries restrainer"
"flatiron inflator"
"fragile leaf rig" []
"funsies-infuses"
"fur/flesh shuffler"
"Gilleran's Allergins Signaller"
"glo-log"
"Graf-Frag"
"Grainless Glariness Signalers"
"gypsum spy mug"
"harmonic ion charm" []
"hi-frets shifter"
"hi-scan chains" []
"hostler holster"
"increm-mincer" []
"inerter terrine"
"Informed-Mo['] Finder" []
"Infra-Depth Pathfinder"
"InReal Linear-Aliner" []
"Knitter Trinket"
"lapsed pedals"
"law awl"
"lightable eight-ball"
"linear nailer" []
"Liters Lister"
"Lo-perish polisher"
"loot tool"
"low-speed seed plow"
"lower-price power-relic"
"masker-makers"
"max-labor alarm box"
"metallic claimlet"
"mis-steered semi-desert"
"mod-me modem" []
"Obtrusive Turbo-Vise" []
"panic-leap appliance"
"Parsley Splayer" []
"passive sap-vise" []
"Pecs-Spec"
"peculiar cure-pail" []
"petroleums pulsometer"
"Pilers['] Pliers"
"pinnacled candlepin"
"platinum lamp unit"
"plus-case capsules"
"porcelain ion placer" []
"posterior repositor"
"pre-war warper"
"precise-op periscope"
"prey-scald clepsydra"
"Prickle Pickler"
"productive crude pivot"
"pulsing plug-ins"
"purpose-use prop"
"quit-errs squirter"
"Rasped Spader"
"raw-prep wrapper"
"reboots-booster"
"recording-decor ring"
"Relics Slicer"
"Replica Caliper"
"rheums-musher"
"rhodium humidor"
"riddled diddler"
"ripples slipper"
"Risk-Tec Sci-Trek sticker"
"roster storer" []
"ruffness snuffers"
"Rusted Duster"
"sapper-papers"
"scalder cradles" []
"scarred carders"
"sectoral locaters"
"sensel lenses"
"senso-noses"
"silence ice-lens" []
"Situ-Suit"
"sleeper-peelers" []
"solid-grasp'n load springs"
"a sorry rosary"
"spares-passer"
"spherical share-clip"
"splatter-platters"
"sprinkle plinkers"
"stacked-up duck-tapes"
"strap-parts"
"surface-car fuse"
"Synchro-chyrons"
"synthetic tiny chest" []
"Tech-Art Ratchet" []
"TeksCorp Sprocket"
"temperate tape meter"
"Test-Case Cassette"
"tetramers smatterer"
"too-small salt-loom"
"tootles toolset"
"top-accy copycat"
"Torque Quoter"
"torques-questor"
"trendi-tinder"
"Trifle Lifter"
"trifling ring lift"
"twistable waistbelt"
"unplumed pendulum"
"wee stark tweakers"
"winged new dig"
"wrest-it twister"
"yarn of no fray"

table of rodney bluster [xxw2] [xxrodney]
blurb
"being as gung-ho as All-In Niall"
"being as wily as, but more loyal than, Varlet Valter"
"being better and more focused without Clowny Colwyn" [x]
"being in better shape than Bloater Alberto" [x]
"being lackluster like Not-Very Treyvon"
"being Le Bad Blade" [x]
"being less demoralizing than Jader Jared" [x]
"being more together than Envier Vernie" [x]
"being ruthless like Levelin['] Neville" [x]
"being sweatier but cleaner than Grody Gordy" [x]
"being team players like Nobler LeBron" [x]
"craving the big time big city unlike Ozark Ozkar"
"deserving a sterling write-up from Plyin['] Pliny"
"doing far better than Dreg Gerd" [x]
"emulating Clasher Charles" [x]
"everyone being a little stouter than Frail Ralfi" [x]
"everyone being more attentive than Lax Axl" [x]
"following the leadership lessons of Steerin['] Steiner" [x]
"getting grittier than Vain Ivan" [x]
"getting out in the real world unlike Cyber-Bryce" [x]
"the guy who called him, Rodney, one dry nerd, yo"
"hanging around unlike Ditchier Dietrich"
"having more discipline than Beerin['] Bernie" [x]
"having more of a clue than Mess-it-Up Septimus" [x]
"having top skills like Eagle Algee" [x]
"keeping in shape unlike Lardo Roald" [x]
"keeping it simple as possible, like Able Abel" [x]
"keeping motivated unlike Jader Jared"
"keeping sharp unlike Mangier Germain" [x]
"labels Fearin['] Efrain naifer. Fainer" [x]
"needing to go all Cursy Cyrus on everyone here" [x]
"nobody escaping through a fuel flue" [x]
"nobody getting all 'Do fly' like Foldy Floyd" [p] [x]
"not backstabbing like Rodent Dontre" [x]
"not being snorin['] Ronins"
"not demotivating the team like Jader Jared" [x]
"not getting Flayer Farley" [x]
"not having to be as brilliant as Dazing Danzig" [x]
"not mouthing off like Crowin['] Corwin" [x]
"not needing the bulk of Frigate Freitag" [x]
"not stepping out of line like Fool Olof" [x]
"not sticking heads in the sand like Ostrich Christo"
"paying more attention than Zonked Zdenko" [x]
"regrets not mandating haircuts like Sheared Rasheed" [x]
"remembering the example of Labor-y Baylor" [x]
"roars they want to stand tall, but not space out like Inert Terin" [x]
"running a tighter ship than Froody Fyodor" [x]
"says it'd be good to be half as brave as Afar Rafa" [x]
"showing the work ethic of No-Flair Florian" [x]
"standing straight like Larchey Charley" [x]
"standing stronger than [']Fraid Farid" [x]
"staying violent unlike Fair Rafi" [x]
"sticking to a regimen unlike Fried Fredi" [x]
"weirdos, rowdies. Ow! [']s dire."
"windbags['] swing-bad big wands"

book otters

table of animal friends [xxt1]
blurb
"acid-snarl cardinals"
"an agreeable bear-eagle"
"an ambient mine-bat"
"ants of no fats" []
"asbo-boas" []
"ashen-pelt elephants"
"aweless weasels"
"a be-a-lug beluga"
"a beer-gut tree-bug"
"bison versus subversions"
"a blague-beluga"
"bold-slug bulldogs"
"a brave ace cave bear"
"a bugle beluga"
"bugs of sub-fog"
"a bust-king stink bug"
"a chained echidna"
"the chase cheetahs"
"a chorist ostrich"
"chump-sink chipmunks"
"clans of falcons"
"clingiest sting-lice"
"a condor cordon"
"a count-toucan"
"a croon-shire rhinoceros"
"crop-ants ([crap]-tons)"
"delta-ops tadpoles"
"dimming-shrub hummingbirds"
"a dominate nematoid"
"a dry enough young herd greyhound"
"a dull-bog bulldog"
"a dyed-armor dromedary"
"eek, smart meerkats"
"end-o[']-sky donkeys" []
"enshrouded deerhounds"
"an ent real eternal"
"epic-nested centipedes"
"a fury-flit fruit fly"
"a giant tiang"
"glad busy ladybugs"
"glint-show sloth-wing night owls"
"a gloating goatling"
"glum noise mouseling"
"go-quash quahogs"
"a go-sure grouse"
"green-forest-gone ferrets"
"green-spire peregrines"
"a greet-egret"
"a gull of full go"
"headstrong gnat hordes" []
"a hero-within white rhino"
"hip [']n old dolphin" []
"hip sad aphids"
"a hoedown woodhen"
"horse-flies so fleshier"
"horsin['] rhinos (horns shorn)"
"a husky shy auk"
"hustling thin slug"
"a hybrid haybird"
"a hymn-mynah"
"a hypnot-python"
"icier-horn rhinoceri"
"an in-place pelican"
"is-queen equines"
"a lakeside-dike seal"
"a lawmonger angleworm"
"a legate-eaglet"
"life-medic field mice"
"a lightning thing-a-ling"
"a linoleum mule-lion"
"a locust, talcous"
"a log-lair gorilla"
"a lone-rook onlooker"
"luster-befit butterflies"
"a malarkey-realm yak"
"a marbled red lamb"
"marrowish hairworms"
"a master-mo['] marmoset"
"mischief fish-mice"
"mo['] smart marmots"
"a mugwort gut-worm"
"mush-den mudhens"
"next-door-trod oxen" []
"a night owl with long thin glow"
"a nip-hold dolphin"
"nosher herons" []
"not-asleep antelopes"
"a not-red not-retrodden trendo-rodent"
"a noticed ctenoid"
"now-starker worker ants"
"an ok-mood komodo"
"an old-timer dirt mole"
"one cold lone cod" []
"an oppo-ires porpoise"
"oscheal-ol[']-aches loaches"
"an osculatory cotylosaur"
"painless spaniels"
"pal-comrades camelopards"
"a peeringer peregrine"
"a pencil pelican" []
"a pest-made stampede"
"a pholdin['] dolphin" []
"pig-nose pigeons" []
"popish hippos"
"a pretty cold pterodactyl"
"a previously lousy viper"
"a pro-wars sparrow"
"a pumpkin mink-pup"
"a pun copier porcupine"
"Quasimodo, a moo-squid"
"a rad-buzz buzzard"
"a rad mime mermaid"
"a rare-show warhorse"
"re-denier reindeer"
"real-wuss walruses"
"recusant centaurs"
"a retirer terrier"
"a riffage giraffe"
"a rip-pounce porcupine" []
"rooster toreros" []
"roostiest tortoises" []
"a rough ur-hog"
"rust-hen hunters" [p] []
"sad sourin['] dinosaurs"
"a salty pup platypus"
"a samurai amauris"
"scolding codlings"
"score-uppin['] porcupines"
"a screwball swell crab"
"a sea urchin sure chain"
"a shellack-clash elk"
"a shocker eco-shark"
"a shrived dervish"
"shy bird hybrids"
"side-armored dromedaries"
"sledging geldings"
"a slim work silkworm"
"a sloggin['] gosling"
"a slowly-sly owl"
"smear-mares" []
"smooth-o-moths" []
"a sneak snake"
"a snipe, sepian"
"snug pine penguins"
"soft warm fat worms"
"solo-ire orioles"
"solve-loves voles"
"some goon mongoose"
"spar-it tapirs"
"stag-o-goats" []
"a stag tags"
"stalker rat-elks" []
"stalling li'l gnats" []
"star-bib rabbits"
"startler rattlers"
"a steed, teased, sedate"
"strategic tiger-cats"
"stulter-turtles"
"sullage seagull"
"a sure-doom dormouse"
"a swollen-lens owl"
"a T-Rex extra-taxer"
"a ten-pieced centipede"
"a tender red ent"
"testudo-duettos" []
"torties so trite" []
"Toto [']n Tonto"
"a trailing ringtail"
"trash-pen panthers"
"a trek-worn worker ant"
"true-sky turkeys" []
"true-song sturgeon"
"trust-belief butterflies" []
"a tsetse sestet"
"turkeys of fury-stoke"
"tuskier turkies"
"an ugly-win wily gnu"
"an un-tame tan emu"
"a very odd dry dove"
"a vestigal live stag"
"a wire-form fireworm"
"a workload woodlark"
"xeno-oxen"
"yearlings, er, slaying searingly"
"a yonked donkey"
"zeal-legs gazelles"
"a zz-more mozzer"

table of ideas aides squabbles [xxt2]
blurb
"[e-m] berates Cauled Claude's magic ability." [x]
"[e-m] berates laymen meanly, namely, Mel Yan." [x]
"[e-m] berates lesser citadels['] dialects." [x]
"[e-m] blabs about the top-secret Infrared DNA Frier at the Nerd Fair." [x]
"[e-m] cackles, 'Son, mini-minions,' before his friend quiets him." [x]
"[e-m] chafes at his Counsel XI exclusion."
"[e-m] claims they're top-stair patriots, not some po['] artist with a riot past." [x]
"[e-m] details more POS ops, like a sop. 'SOS, Pop!'"
"[e-m] gets all 'Is she evil? Is she vile?! She is live!'"
"[e-m] mentions he once liked polarimetry. Temporarily."
"[e-m] mumbles 'Tailor my morality.'" [x]
"[e-m] pours a box of false fleas down his friend's back." [x]
"[e-m] says, 'Add iron: android!'" [x]
"[e-m] snaps his fingers. 'Er, Lem? ... Er, Mel?'" [x]
"[e-m] starts up some fudgein['] feuding."
"[e-m] tries and fails at castin['] antics."
"[e-m] whispers reverentially about the Lab-Gen Bengal Elvira's creating."
"'Ego, twit? We got it!'"
"'Moaner-sty monastery? Yo, smarten! Monetary's yon. Master.'"
"'My tic's MYSTIC!' [e-m] lashes back at his companion." [x]
"'So?! Argument augmentors!'"
"'Solemnity emits only slimy tone!'"
"'Stormy [if player is male]Toys, Mr.[else]Toy, Mrs.[end if]' says [e-m], looking at your inventory." [x]
"Talk stops. Morose Mooers wait for their Romeos, getting mo['] sore then moreso." [x]
"'You [d-word]ed... you demand, you madden!'"

table of Elvira battle cries [xxt3]
blurb
"Arr, aww! Raw war"
"'BAM, to a tomb!'"
"A belting, tangible" []
"Blotted. Bottled"
"'Blundering! Ending blur!'"
"Dead poser! Desperado"
"Defame me? FADE! Mad fee"
"A dirty aid try" []
"Drat. Seem mastered" []
"Drubbing! Burn'd big"
"A duress, assured! Rude [a-word]" []
"Extend furies? Six feet under" []
"'Final piece! Epic finale!'"
"A foe, utmost: out of steam"
"Foul demise, field mouse"
"Grr, an a-ok Ragnarok"
"Hour is come, choir-mouse. Um, so heroic"
"I, intact, TITANIC"
"I, super, rise up"
"Life lost, still foe"
"Life's gone, single foe" []
"Me--super--SUPREME" []
"'Mere rout? True? MORE!'" []
"Mind power! Primed now! Wonder, imp"
"'Mode: Plenty Deployment!'"
"'New sequel: queen slew!'"
"Not enough. One-nought" []
"Oh, boy! A booyah"
"Oh, hateful to out of health"
"Onslaught! Gnash, lout" []
"Pet, not potent" []
"Primo, I romp" []
"Pull off? Flopful"
"R U fab? FUBAR" []
"Ripe now, in power"
"Ruler is surlier"
"Shoo-in is on, ho"
"A sloppy play, sop!"
"Snooper so prone" []
"So-gritty try is GOT!" []
"A surety, too: You're toast"
"Surrender surer, nerd"
"Temporarily tamely, PRIOR!"
"Terminated, inert, tamed" []
"Thrown! Nth row"
"'To aim at MOI?!'"
"Too far! Rot, oaf" []
"A tootle? Too late"
"Toughen? No, not enough" []
"Troublin['] runt, boil"
"Try hovers, very short"
"A try so stray, o! Roasty, roasty" []
"Un-loser rules on" []
"'Way to be beat, yow!'"
"Woo! Tense! Now to see woe onset"
"A worthy try, whoa"
"Yup, scream supremacy!"
"Zaps! Iced! Capsized"

table of Elvira machines [xxt4]
blurb
"all-techs hellcats"
"an amplify-flay imp"
"baser Sabre Bears" []
"a bile-most slimebot"
"a blast-soar albatross"
"a blubber bubbler"
"a boil-em-mobile"
"a caustic accus-it"
"cerebrum cumberer"
"a cut-so scout"
"defensive feed-vines"
"a detain-aid net"
"a doom-angel megalodon"
"doorstep torpedos"
"a DuPont's Stun-Pod"
"a frog-leg flogger"
"gagmost maggots" []
"ghoulish high soul"
"a gloom-gleem golem"
"a gouge-o-gauge"
"a harm-set hamster"
"hassler-lashers" []
"holistic hit-coils" []
"horrendous dour herons" []
"I-stun units" [p]
"less-brat blasters"
"literaliser artilleries"
"a masher-shamer"
"a mend-o-demon"
"mess-tron monsters" []
"a mobile oil beam"
"a mordant mad-tron"
"a morto-motor"
"an oranger groaner"
"pasta-cult catapults"
"a perchin['] phrenic pincher"
"peril-set reptiles" []
"a pink-dots stink-pod"
"a postural pulsator"
"a pound-em-up demon"
"a PrisonCo Scorpion"
"a pro-tec copter"
"a proctal caltrop"
"a pure-snag speargun"
"a purple pulper"
"pushing gunship"
"pyrogen progeny"
"randier drainer" []
"rayless slayers" []
"re-bustin['] site-burn turbines" []
"re-cursed reducers"
"a reloading girandole"
"the Repeatedly-Deplete Ray"
"rifest fister"
"rimless slimers"
"robust ur-bots" []
"sabbath bash-bat"
"a Samsung mass-gun"
"a schmoes-SOS mech"
"scorp-procs"
"shred-herds"
"skanker krakens"
"smashter hamsters" []
"snort-trons"
"snotrag/gas-tron" []
"a sore-rot rooster"
"spam-U pumas"
"a spambot tomb-asp"
"splitter triplets" []
"the Stalnaker LaserTank"
"sting-bad dingbats"
"a stinger-nets rig"
"stubborn burn-bots" []
"a tan-block (not black) clank-bot"
"a tartar rat"
"technos-o-stench"
"termless smelters" []
"torn-tron"
"a turbo ur-bot"
"ultrasound undulators"
"un-gray raygun"
"yitten entity"

table of Elvira taunts [xxt5]
blurb
"'[if player is male]His foot hoofs it[else]Her foot, oft hero of other[end if]!'" []
"'Act bold, bad clot!'"
"'Adroit? Oaf, too afraid!'"
"'Amscray mas racy!'"
"'And we err, wanderer!'"
"'Another go, hater goon?'"
"'At blows? Last bow!'"
"'Avoidant, vain toad!'" []
"'Bad nerves? Send brave!'"
"'Be a hero? Eh, a bore.'"
"'Best pack. Step back!'"
"'Bye, elf! Flee by, feebly!'"
"'Bye now. Web...yon!'" []
"'Cameo mo['] ace!'"
"'Charge in? Ha, cringe!'"
"'Chary? Nice chicanery!'"
"'Cold feet? Lo, defect!'"
"'Come, pet, compete!'"
"'Courage's a scourge!'"
"'Coy AWOL? Way cool!'" []
"'Crisply slip. Cry?'"
"'Cut in, choke, chicken out!'"
"'Dastardly? Drat, sadly.'"
"'Desertin['], nerdiest?'" []
"'Detachin[']? Can't hide!'"
"'A detour?! Our DATE!'"
"'Diligence ceilinged!'"
"'A dodge! A dodge! ... Goaded?'" []
"'Drift away, tardy waif!'"
"'Dry bolt? Bold try.'"
"'Dueler eluder!'"
"'Ego slit? Leg it so!'" []
"'Eh, valour overhaul?'" []
"'Emigrate it? Meager!'"
"'Endsville snivelled!'"
"'Erect nice reticence!'"
"'Escape, remit masterpiece!'"
"'Exit meant a Next Time!'"
"'Fantastic faint scat!'" []
"'Fear nigh? Hang fire!'"
"'Fear on, far one!'"
"'Fear-smit, I'm faster!'"
"'Feint, wail--a fine wilt!'" []
"'Fend! Trot! Don't fret!'"
"'Final-go loafing?'" []
"'A firm I'M FAR!'"
"'Flee! Be feeble!'" []
"'Fleeings-legs? Fine!'"
"'Flight set? Let's fight!'"
"'A foul serf so fearful!'"
"'Free soul, flee, sour!'"
"'Funk it so! Fink-outs!'" []
"'Furtive turf-vie?'"
"'Given war, wavering!'"
"'Goal: hide, dig a hole!'"
"'Going? I gong!'"
"'Gosh, lift flight so!'"
"'Gosh! Ruff shrug off!'"
"'Har, feet! The fear!'" []
"'Hastily alit. Shy?'"
"'A hasty stay, ha!'"
"'Head over, evader! Ho!'"
"'Hero's now no-shower!'"
"'Ho, terminate another time.'" []
"'Honour? Ooh...run.'"
"'A hurry? Hurray!'"
"'I, abler bailer!'"
"'I stunk of fink-outs!'" []
"'I'm scared? Scram! Die!'"
"'In check? Chicken?'"
"'Lay off! Fly, oaf!'"
"'Leavin[']? Venial!'" []
"'A legion? Ego lain! Go alien!'"
"'Lo! Retire, loiterer!'"
"'A low AWOL!'"
"'Magnificent feinting, Mac!'"
"'March out, our match? Macho rut! Humor, cat!'"
"'Must go? Mo['] guts!'" []
"'My foe, mo['] fey!'"
"'My life?  Me, I fly!'"
"'Nearly meet? Later, enemy! Elementary!'"
"'Need a while? Denial! Whee!'"
"'Nerve? NEVER!'"
"'Nice, hack! A chicken!"
"'No courage? Con! A rogue!'"
"'No wit to win? Own it!'" []
"'Not a swell stonewall!'" []
"'Not ready yet? O darn! Tread yon!'" []
"'Not up to it option? Tut!'"
"'O, a runt ran out!'" []
"'O, stinker! On strike?'"
"'Of course! Scour, foe!'" []
"'Oi, stuck? Out sick?'"
"'Ow, danger raged now? Go wander!'"
"'Oy, far foray for ya!'"
"'Part? Truce? Utter [crap-u]!'" []
"'A patsy! We step away!'"
"'A perfect farce, pet!'" []
"'Petulant, late punt!'" []
"'Postponing? No stopping!'"
"'A ramble, yet, bleary mate? Maybe later!'"
"'Ran? Tut! Truant!'"
"'Rat! Quite a quitter!'"
"'Recede-decree?'"
"'Retreat, tree-rat!'" []
"'Retreating? Get trainer!'"
"'Retreating? Inert? Great!'" []
"'Retreats? Rare test? Reset, rat!'" []
"'Return, er, runt!'" []
"'Riddance--and cried! Acid, nerd? Candider!'" []
"'The road? Hater, do!'"
"'The road--or DEATH!'" []
"'Roam on, maroon!'" []
"'A rottener retreat, on!'" []
"'Run, tired intruder!'" []
"'Say, shot so hasty?'"
"'Scape-paces?'"
"'[']Scapin! Panics!'" []
"'Scared now, and cowers? Answer, doc! Awed? Scorn!'"
"'Set you a easy out?'"
"'Shambolic schmo, bail!'"
"'Shred a dasher!'" []
"'Shy way? Say, why?'"
"'Skeer'd? Re-sked!'" []
"'Slip [']way waspily!'"
"'Slog out, sick suck-ologist!'"
"'A smoove vamoose!'"
"'Sneak away, weak as any...'"
"'So, backbone! Be back soon!'"
"'So I fade of ideas...'" []
"'So, pluck locks up!'"
"'Sod's gone. Goodness!'" []
"'Sortie's rosiest!'" []
"'A spurn-run? Sap!'"
"'Stagnation, antagonist?'"
"'A stumble? Stale bum.'"
"'Take us on? Sneak out!'"
"'Taking off? Oft faking!'"
"'Tasked? Skated!'"
"'A throw, or WHAT?'"
"'Time outs? Titmouse!'" []
"'Too scared? Scoot, dear!'"
"'Tough? Shot! Thought so! Thou ghost!'"
"'Toughen? Huge NOT! Uh, get on!'" []
"'Toughness gushes not!'" []
"'Try, fail, frailty!'"
"'Um, be [if player is male]Mr. Bummer[else]Mrs. Bummers[end if]?'" []
"'Un-torn? Run not.'" []
"'Unprepared? Run, dear! Pep!'" []
"'Veritably viable try!'"
"'Walking out? Know a guilt!'"
"'Wary, clod? Cowardly!'" []
"'We gone now, gee?'" []
"'Wheels of flee, show.'"
"'Whoops! Po['] show!'"
"'Win, fool? Low-info foil, now!'"
"'Withdrawal? Rid? Aww, halt!'"
"'Woo, angel, a new logo: gone AWOL! A long woe!'"
"'Ye cards, descry a scaredy!'"
"'Ye fast safety, fayest!'"
"'Yep, a weak keep-away!'"
"'Yes, a fast stay-safe!'"
"'Yo, coot! Too coy!'"

book others

table of political slogans [xxh1]
blurb
"'Bad rule? I, a rebuild!'"
"'Bureaucrat's a curt abuser!'"
"'Coup d'etat pact: outed!'"
"'Darn woeful? A wonderful law founder!'"
"'Dim-led middle? I'd meld!'"
"'Eh, reform from here!'"
"'Ensure it reunites us entire!'"
"'Ever solid, I RESOLVED!'" []
"'Fix-led, I'd flex!'"
"'Go, man. Cheer more change!'"
"'Hear from reform, ah!'" []
"'A hell-proof hope for all!'"
"'Here's my plan. Many helpers?'"
"'His tax: a sixth!'"
"'Hm, we're for reform! Hew! From where? Me! Feh! Rowr!'"
"'I dream! Admire!'"
"'I ran, new, a winner!'"
"'Idle nag? Leading-aligned, I'd angle...DEALING!'" []
"'Inept mop up? I'm no puppet!'"
"'Last, yet STATELY!'" []
"'Leadins[']? Denials and lies is LADEN!'" []
"'Let's be LE BEST!'"
"'Low spar, pols! War!'"
"'The machine hath icemen!'"
"'Me, I'd unite in due time!'"
"'A mention: nominate ME, nation! I, not mean! In, on, team!'" []
"'Mo['] debates: BEAST MODE!'"
"'The party...they TRAP!'"
"The polls help lots? Hell, STOP!"
"'A president? PEDESTRIAN!'"
"'PROMISE SO PRIME!'" []
"'Promissive improvises miss. I PROVE!'"
"'Reamed? REMADE!'" []
"'Redeem? No, need more!'"
"'Reformist firestorm!'" []
"'Resorting to ringers? I: stronger!'"
"'Right off. Fight for...'"
"'Ruinous, yet...unite yours! Rouse unity!'" []
"'Ruling as singular? Urg! Slain!'"
"'Solon? LOONS!'" []
"'Solutions: Toil's on Us!'"
"'Stumpier, impurest imputers!'"
"'Trickless Slickster-Sticklers!'" []
"'Try. Ignite.' You point to your rivals. 'Tiring yet? INTEGRITY!'" [x]
"'The turned need TRUTH!'"
"'Up, not-put-on!'" []

table of selly yells [xxh2]
blurb
"'Abrupter? Up, barter, rapt rube! Perturb a...'"
"'Ach, super purchase!'"
"'Add-ons, yet! Ends today!'"
"'Advertise trades! Vie!'"
"'All deserve deals. Revel!'"
"'App? Yay!' / 'Pay, pay!'"
"'Aw, yep, we pay.'"
"'Banter! Rig bartering!'"
"'The bargain! A breathing... Bah, ingrate!'"
"'Bargain! Baring a grin, baa!'"
"'Be coy? Um, come buy!'"
"'Best price!' / 'Creeps bit!'"
"'Betray me? MY REBATE!'"
"'Bilge as big sale? Base, Gil!'"
"'Boonies! Soon, I be...'"
"'Bulk rates? Talk, rubes! Leak! Burst!'"
"'Buy em!' / 'Um, bye!'"
"'Buy it, me? Yet, I...' / 'Bum!'"
"'Buy, sell? Yes!' / 'Bull.'"
"'Buying? Woo! You won big!'"
"'Cauliflower? Our face will recoil! Awful!'" []
"'Cheap bulk!' / 'Buck, eh, pal?'"
"'Cheap bum! Be a chump!'" []
"'Clean side! Nice deals!'"
"'Conspire on prices? Nice, pros!'"
"'A cushy quilt! Such quality!'"
"'Deal-bot? A bolted, bloated...'" []
"'Deal tough? A huge dolt!'"
"'Dire? Solvent! Deliver tons!'"
"'Each prime!' / 'I'm cheaper!'" []
"'Earnhardt? Trader? Nah.'" []
"'Er, my, vendor! Nerdy mover? Very modern!'" []
"'Ever sold? Resolved.'" []
"'Extra value! A rave! Exult!'"
"'Foul offers? Suffer, fool!'"
"'Freebie beer? Fie!'"
"'Gad, bestir big trades, grit-based!'"
"'He fronts! Not fresh!'"
"'Here, brat breather! Eh, barter the rebar!'"
"'Ho, any hay?' / 'No.' / 'Ah, yon!'"
"'Hog, glean no haggle!'"
"'Honeydew? How needy!'"
"'I brang a bargain!'"
"'I've got more! Go overtime!'"
"Irate bellow: 'Below retail? To ill, beware!'"
"'It's old?! ...Sold it!'"
"'King of deals, doing flakes, faked losing. Goals: KNIFED.'"
"'King of deals! Folks gained!'" []
"'King of deals! Godlike, fans!'" []
"'Lagniappes? Gain apples? Pleasing, Pa!'"
"'Last mogul! All-must-go gusto mall!'"
"'Let's haggle, eh? Tell gags.'"
"'Lo! Best cow below cost!'"
"'Loads new deals now!'"
"'Loaned? No deal!' / 'Lad, one...'" []
"'Lost head? Deal shot!'"
"'Low deal!' / 'Allowed!'" []
"'Low prices relic swop!'"
"'Lower-cost loot, crews!'"
"'Mac, seekin['] nice makes?'"
"'A melon mo['] lean? No, lame!'" []
"'Miss, a free...?' / 'Seems fair.'"
"'Money back!' / 'My, a beckon!'" []
"'Most deal old meats!'"
"'My trade? Dry meat! Try mead!'" []
"'No-credit doctrine, tired con!'"
"'No wallets? STONEWALL!'" []
"'Oafs fled. Deal's off.'"
"'Oh, alfalfa! All off? Aha! Half a loaf!'"
"'On sale!' / 'No seal!'" []
"'Once! Sold! Closed on!'" []
"'One pound's sound?' / 'Nope.'"
"'Onions in soon?' / 'No is no.'"
"'Only today?' / 'No, dolt!' / 'Yay!'"
"'Peaches! See, chap!'" []
"'A pony. Pay? No? Yap on!'" []
"'Preciser re-prices!'"
"'Price up?' / 'No, porcupine.'"
"'Purchase? Sure, chap!'" []
"'Read fail! Fair deal!'" []
"'Ready to trade, yo!'"
"'Resell? Yo, eyerolls!'" []
"'Retro-quaff! Quarter off!'"
"'Rip me off? Fie, Mr. Fop!'"
"'Rip you off? Poof, I: FURY!'"
"'Sale fiend? Fine deals!'"
"'Sale? Rent? Let's earn!'"
"'Sales? Ew! Weasels!'"
"'See if fee is...'"
"'Sharp deal shared, pal.'"
"'Size four fez? I sour.'"
"'Somber again? Bargain some!' / 'More abasing.'"
"'Spex? Lame examples!'"
"'Splendid peddlins[']!'"
"'Spree, per se?'" []
"'Sprocket!' / 'Pet rocks!' / 'Stock rep?'" []
"'Stall gone. Lost, angel. Legal?' 'Tons.'"
"'Stare? Nod? Trade, son!'" []
"'Steadily tidy sale!'"
"'Super deal!?' / 'Sure!' / 'PLEAD.'" []
"'Swap [']n pawns!'"
"'Swap meet map? SWEET!'"
"'Ten pounds?' / 'Dunno, pest.'"
"'That price? Cheat-trip! Trite, chap!'"
"'Thereon, alas, loaners hate another sale.'" []
"'This deal is HALTED!'"
"'This sale is halest!'"
"'Three pounds? Thou spender!'" []
"'Thrice to rote-itch: ethic, rot!'"
"'Top-quality toy? Quit, pal!'"
"'Trade big! Get rabid! ... Tired bag!'"
"'Trade show? Draw those! Haste, word!'"
"'Twist my arm? Smarmy twit!'"
"'Two pounds. Put down, so.'"
"'Un-bilk in bulk!'"
"'Us? Relapsed? Super deals!'"
"'The walls sell WHAT, Stew Hall?'"
"'Well, son? Sell now!'" []
"'What a price!' / 'Ware a pitch!'"
"'What soup, southpaw! Swap thou...?'"
"'Yes, pals! Pay less!'"
"'Yo, um, once you con me...'"
"'Your needs ensured, yo!'"
"'Zero pins! No prizes!'"

Roiling Random Text ends here.

---- DOCUMENTATION ----
