Version 1/180729 of Roiling Tables by Andrew Schultz begins here.

volume main anagram tables

[?? clean/tend/eat/seek/scan]

[ruch.py does general cleanup checks]

[ott.py checks organization order, replacing rorg.py]

[tables are arranged roughly in walkthrough order.]

[pres.py checks to make sure all pre- rules appear in some RBR files.]

[hch.py does help check / anagrammatic guesses. hch.py i q 2]

[hintor.py makes sure the <or> in the hint tables are all formatted correctly.]

book Ordeal Reload

table of Ordeal Reload anagrams
the-from	the-to	taked	hashkey	roomjump	right-word	right-cmd (topic)	pre-rule	post-rule	the-msg
palm	lamp	true	201542769	--	"lamp"	"lamp" or "get lamp"	a rule	post-palm-lamp rule	"Lamp. Palm. Yup. Using your old powers, you change the palm into a lamp, which gives off light. You go all Jason Scott on it, and just like that, bam, it's in your inventory.[paragraph break]Oh, there's that 'dope' op-ed Report Porter Perrot threw at you, too.[paragraph break]You blink and look around and stare at your diorama. You remember how [gtmn] gave it to you for one day you might need warm-ups, to get back in the groove. With unusual examples and anything. In case you had a different divining tool than the tagged gadget[if latches are off-stage].[paragraph break]Oh! And he gave you something else! Those--useless latches! They might be good for something. You remember the lump from sleeping on the chair--yup, there they are[end if].[preefies]."
latches	letters settler	true	439479634	--	"satchel"	"satchel"	--	post-latches-satchel rule	"The locks start fiddling with themselves--and each other--and slowly, a satchel emerges from the mess. A weird device falls from the satchel, which wasn't tied tightly at all. You pick it up, along with [if treatise is off-stage]a treatise that was tied in with the latches and [end if]a purse. Super[if treatise is off-stage].[paragraph break]When you stuff the treatise in the purse, it doesn't seem to take up any space in there[else].[paragraph break]You stuff the treatise in the super purse carelessly, and yet, there's still room for more[end if]. The purse looks like a good place for everything except your lamp, so you fold the satchel and put it in the purse, too. The satchel sinks into the folds--but it's surplus, now."
giant pin	abstract painting	false	447164205	--	"painting"	"painting"	--	--	"The giant pin's edges become sharper and, before you know it, it's reformed to a portrait hanging on the wall. Whatever stuck the pin to the wall still works on the painting, which may not be High Art, but it's worth a look."
pavement	event map	false	682523494	--	"event map"	"event map" or "eventmap"	--	--	"The pavement unfolds into a small map which, you remember, describes your first trip through Yorpwald."
event map	pavement	false	682523494	--	"pavement"	"pavement"	--	--	"The event map folds back into a thoroughly more dull pavement[read-canflip]."
crabgrass	brass crag	false	437595366	--	"brass crag"	"brasscrag" or "brass crag"	--	--	"The crabgrass dries out and becomes a brass crag."
brass crag	crabgrass	false	437595366	--	"crabgrass"	"crabgrass"	--	--	"The brass crag becomes slightly less lifeless crabgrass, again[read-canflip]."
platform	farm plot	false	490844063	--	"farm plot"	"farmplot" or "farm plot"	--	--	"The platform becomes a farm plot."
farm plot	platform	false	490844063	--	"platform"	"platform"	--	--	"The farm plot switches back to a platform[read-canflip]."
pedestal	steel pad	false	613492907	--	"steel pad"	"steelpad" or "steel pad"	--	--	"The pedestal becomes a steel pad."
steel pad	pedestal	false	613492907	--	"pedestal"	"pedestal"	--	--	"The steel pad intertwines into a marginally artistic pedestal[read-canflip]."
pram	ramp	false	233052733	--	"ramp"	"ramp"	--	post-pram-ramp rule	"The pram folds out -- boy, there are all sorts of compartments there -- and becomes a ramp, given revamping. [b]DOWN[r] to a basement you have forgot you had."
sitar	stair	false	331888451	--	"stair"	"stair"	--	post-sitar-or-stria-to-stair rule	"The sitar becomes one with the ground, showing you an inner path to somewhere more peaceful."
stria	stair	false	331888451	--	"stair"	"stair"	--	post-sitar-or-stria-to-stair rule	"The stria glow and cascade into a stair leading back up."
my niche	chimney	false	484428752	--	"chimney"	"chimney"	--	post-my-niche-chimney rule	"The square saying [b]MY NICHE[r] rumbles and collapses to create an impromptu chimney. It's wide enough for you to climb and even appears to have ledges or whatever to grip. You can go up now."
meet bans	meet bans	false	608585586	--	"basement"	"basement"	pre-meet-bans-basement rule	--	"[if Largely All Grey Gallery is visited]Having already visited the [gallery] below-ground, you pat yourself on the back for lateral thinking and generally exploring things thoroughly, as you realize the deeper nature of the [MEET BANS][else]Now you remember why there were ten beams[end if]. Of course, the ten beams lead [b]down[r] to what must be a basement, even if it's called something different."
tables	tables	false	401610655	--	"stable"	"stable"	--	post-tables-stable rule	"The tables make a weird splatching noise. The writing coalesces and seems to consume the wall, and you can now walk inside to see the stable you never really wanted[dust-b]."
ISBN bins	ISBN bins	false	228593225	--	"snib"	"snib"	--	post-bins-snib rule	"You hear a click from [the bins]. They're still covered with long numbers, but not as much as before. Some if the ISBNs have become a snib that can keep the bins locked, so your place is a bit safer from looting."
plates	staple	true	464657709	--	"staple"	"staple"	--	--	"The plates [if plaster is touchable]fall with a clatter from the plaster[else]schlurp together[end if], and a large staple forms from their edges. You take it, so you don't step on it later or anything."
Respect Specter	Respect Specter	false	640791549	--	"scepter"	"scepter"	pre-specter-scepter rule	post-specter-scepter rule	"'Well done.' A scepter appears in the Respect Specter's hands before disappearing with a pop. 'Oops, forgot to warn you, it wasn't real. But it wouldn't have been useful. Besides, the real treasure is the puzzles you solved along the way. [scep-scan-track].'"
plaster	stapler	true	549981512	--	"stapler"	"stapler"	--	post-psalter-stapler rule	"As an act-ruin curtain appears behind, a stapler falls out. You take it[if plates are touchable] as the formerly stuck plates fall[end if]. The curtain behind looks lined but seems too solid to run through."
rifle	rifle	false	338451493	--	"flier"	"flier"	--	post-rifle-flier rule	"Duh! Snap![paragraph break]After a 'Hands Up!' and SHUP! the rifle jumps out of Elmo's hands. Turns out it was loaded, and it did have a bullet with your name on it, because it becomes a loaded propaganda flier with your name on it.[paragraph break]Elmo lowers his voice. 'Okay, we gotta play it safe here. They maybe should've figured I was a mole. Name and all. But I have stuff to tell you.'[paragraph break]Lo, a guide! Dialogue!"

this is the post-palm-lamp rule:
	now dope op ed is in Dusty Study;
	now bean-smell is true;
	now Dusty Study is lit;
	if latches are off-stage, now player has latches;
	process the adjust light rule;

to say preefies:
	if number of prefigured things > 0, say ". And now you have reason to mess with [the list of prefigured things], too";

this is the post-latches-satchel rule:
	if player does not have treatise, now player has treatise;
	now player has the super purse;

to say read-canflip:
	say "[one of]. Reading the notice [if notice is examined]again[else]briefly[end if], you see that things won't be this flexible out in the real world[or][stopping]";

this is the post-pram-ramp rule:
	if tables are moot and sitar is moot:
		min-up;
	else if meet bans are moot:
		min-up; [check if passage is already available via beams or stable->stair]

this is the post-sitar-or-stria-to-stair rule:
	now Largely All Grey Gallery is mapped below Farming Framing;
	if the room below study is nothing:
		now Farming Framing is mapped above Largely All Grey Gallery;
	if meet bans are moot:
		min-up;
	else if niche is moot and pram is moot:
		min-up; [check if passage is made via beams or chimney->pram]
	moot stria;
	moot sitar;
	move stair backdrop to all stairy rooms;
	process the tag backdrops for hinting rule;

this is the post-my-niche-chimney rule:
	now Highest Heights are mapped above Dusty Study;
	now Dusty Study is mapped below Highest Heights;
	if meet bans are moot or tables are moot:
		d "My niche -> chimney is a min-up because stable and/or basement are already accessible.";
		min-up;

this is the pre-meet-bans-basement rule:
	moot beams;
	now Largely All Grey Gallery is mapped below study;
	now study is mapped above Largely All Grey Gallery;
	reg-inc-q;
	if tables are moot or niche is moot:
		d "Min point for tables or niche: we already have a way out of the study.";
		min-up;
	if sitar is moot or pram is moot:
		d "Min point for [if sitar is moot]sitar [end if][if pram is moot]pram [end if]: we already have a way to [gallery].";
		min-up;

this is the post-tables-stable rule:
	now study is mapped inside Farming Framing;
	now study is mapped outside Farming Framing;
	now Farming Framing is mapped inside study;
	if meet bans are moot or niche is moot:
		d "My niche -> chimney is a min-up because stable and/or basement are already accessible.";
		min-up;

to say dust-b:
	say "[one of]. You say, 'Dust, be busted' to clear up the mess in the air. You can go [b]IN[r] to the stable, now, to look around there[or][stopping]";

this is the post-bins-snib rule:
	move snib to Largely All Grey Gallery;

this is the pre-specter-scepter rule:
	if scepter-nag is false and Respect Specter is not bscanned:
		now scepter-nag is true;
		say "The Respect Specter coughs. 'You may wish to scan me in [if specter is ncscanned]cheat[else if specter is cscanned]non-cheat[else]cheat and non-cheat[end if] mode first, if you're not sure about ambiguous settler readings. Would you still like that scepter anyway?'";
		if the player regex-prompt-consents:
			say "'I respect your choice.'";
			continue the action;
		say "'Thank you for respecting my presence and purpose here.'";
		preef Respect Specter;
		the rule fails;

this is the post-specter-scepter rule:
	say "'Oh. One more thing. Instead of the scepter you could've had, have [deductin]. It's got examples of how to use the settler. Just in case you need to brush up. It might spoil too much. So you can [b]DROP[r] it. But if you want it, here it is.'";
	now player has Inducted Deductin;
	set the pronoun it to Inducted Deductin;
	say "[line break]The [specter] leaves for a bit but then pops out from behind a fourth wall. 'Oh. I said one more thing, but I meant two. You can [b]PARSE[r], and with the settler in cheat mode, the game will tell you what can logically be figured out. [b]SPARE[r] undoes this.";
	moot respect specter; [not necessary if you solve the specter, but if you pass by it, this makes some if statements easier]

to say scep-scan-track:
	if got-thru-respect is true:
		say "Thank you for being respectful and listening to my whole pitch. Remember, often in your adventures, two words may seem to clash, but that can actually result in fewer remaining possibilities to sift through";
	else if Specter is ncscanned and specter is cscanned:
		say "I hope scanning me both ways revealed that cheat mode has some limitations, and non-cheat may reveal ambiguous readings from cheat mode";
	else if Specter is cscanned:
		say "While you didn't get the definitive hints from non-cheat scanning, I can suspect you see how it could work, combining both ways to scan";
	else if Specter is ncscanned:
		say "You kind of avoided the cheat-scanning I came here for, but I respect your intrepid stance against cheating, even if it really isn't cheating";
	else:
		say "I respect your need to do more and talk less. There are things I would have liked to explain. But maybe you know them well enough, or maybe you can figure them out on your own, and it'll be more rewarding that way";

this is the post-psalter-stapler rule:
	if act ruin curtain is not in Carven Cavern, now act ruin curtain is in Carven Cavern;

this is the post-rifle-flier rule:
	pad-rec-q "rove over";
	moot high sign;
	try talking to Mole Elmo instead;

section ordeal reload auxiliary

scepter-nag is a truth state that varies.

after fliptoing when mrlp is Ordeal Reload (this is the tell player to move on rule):
	if rifle is off-stage and min-score of Ordeal Reload is max-score of Ordeal Reload - 1:
		say "[line break]Congratulations, Iron [if player is male]Man[else]Woman (Ow)[end if] in Manor! You've found all the secrets here. You can just exit the gallery now[if settler is unexamined], but it'd be a good idea to examine the settler, first[end if].";
	continue the action;

book stores

table of stores anagrams
the-from	the-to	taked	hashkey	roomjump	right-word	right-cmd (topic)	pre-rule	post-rule	the-msg
Store B	Store B	false	505285378	--	"sorbet"	"sorbet"	a rule	a rule	"You ask 'Got any sorbet?' and a seedy man beckons you in. You talk for a bit, and he talks about how he wants to be a writer and his name is Obert (O-Bert) and you suggest he might be a better writer just by calling himself OB-ert (short o.) It's the most ridiculous things he's ever heard. He thumps you eleven times and throws you out. But the free sample was delicious." [bold-ok]
Store H	Throes Hoster	false	524148772	--	"others"	"others"	--	post-storeh-hoster rule	"You manage to discover a secret place set aside in Store H. You wonder who could be there or even if you should go there."
Store K	tokers	false	539799651	--	"tokers"	"tokers"	--	post-storek-tokers rule	"You concentrate on the store with all your might, but you're unable to do anything. In frustration, you bang on the window, breaking it. Smoke comes pouring out. 'Dude you must totally be the cops! We were hotboxing in there!' You assure them you are not, that you've got a rather libertarian view on it all, but it takes so long that a joint they left in there burns the store down. Fortunately, they'd grabbed everything else of value, and all things considered, they feel almost glad to be liberated from their fears of being caught. They pull a tarp apart and sit down.[check-nestor]"
Store N	nestor	false	555773981	--	"nestor"	"nestor"	--	--	"The store rumbles and collapses! But the rubble falls in a circle around the poor fellow inside. He gives a duh-eyed 'Hey dude.' A long pause. 'What happened?' He wouldn't believe the truth, so you just [check-tokers]"
suit ode	suit ode	false	572670412	Strip of Profits	"outside"	"go outside" or "outside"	pre-babbler-outside rule	--	"The Rehabs Basher and the blabber babbler are swept from the doorway and stage, respectively, by something unseen. The blabber babbler frantically babbles something about how this is why we need to fight drugs, but [he-she] is too busy backwards somersaulting to establish eye contact with [his-her] audience. You stumble out yourself, back onto the way high highway.[paragraph break]'Whoah, dude! You totally stuck it to guard-on-a-ground Durango! Dour nag!' The tokers give you the sauciest suitcase you could imagine (tie-dyed, not spaghetti sauce) and encourage you to eat the nice mush munchies therein. You protest at first, worrying the munchies might be 'special,' but no, the tokers express remorse they took the best stuff already. But what you got helps reduce migraines['] mini-rages, like [if headaches is 10](after some experiments with the settler) [end if]that annoying noise from the slider. You can use the slider [if headaches is 0]again[else]more[end if], now.[paragraph break]Their general partying and babble about wanting to find adventure like yours tires you out. As you doze off, you hear them moaning they need more, uh, supplies. When you wake up, they're gone. Maybe for the best, there."
Store P	odorant tornado	false	568332432	--	"presto"	"presto"	--	--	"You say the magic word! An unseen voice lauds, 'SALUD!'[paragraph break]You feel yourself swirling, lifted from the ground, and you see the words in the poster blur as first the store, then the poster swirls into--well, something more nature-like, but daunting. You recognize an odorant tornado, which you can [b]ENTER[r], if you dare. You'll probably need to."
Store T	solid idols	false	589976491	--	"otters"	"otters"	--	--	"The store divides in two until it becomes a path with solid idols packed so densely they block your view. They're all of otters, not-so-oddly."
Store U	course source	false	591972280	--	"routes"	"routes"	--	--	"Store U splits into strips that snake out. They intertwine dizzyingly, making a source course. You can [b]ENTER[r] to see where it leads."
Store V	Tastee Estate	false	594031293	--	"troves"	"troves"	--	--	"You look more closely at Store V. Wouldn't it be nice if there were riches? As you do, up pops the perfect sort of Yorpwaldian place to house troves: a Tastee Estate!"
Store W	truster turrets	false	594801246	--	"towers"	"towers"	--	--	"Store W shakes and seems to sprout up and grow narrower, into a pair of truster turrets. It doesn't seem to matter which one you enter. You hope."
Store Y	balancer barnacle	false	609225725	--	"oyster"	"oyster"	--	--	"Blam! The store flattens a bit, rounds out, and becomes an oyster. There appears to be no way in. But then something behind it schlurps the oyster! A balancer barnacle! You can probably just [b]ENTER[r] safely. Yorpwaldian Balancer barnacles only feast on other seafood."

this is the post-storeh-hoster rule:
	it-him-her throes hoster;

this is the post-storek-tokers rule:
	now mangiest steaming is in Strip of Profits;
	set the pronoun her to tokers;

to say check-nestor:
	now mangiest steaming is in Strip of Profits;
	say "[paragraph break][if nestor is in Strip of Profits]What's more, you seem to have rescued their friend, Nestor! 'Hey, dudes, I like went back to the wrong store or something.'[no line break][else]They spend some time complaining about their one toker friend who like went out to get the really good stuff and never like reappeared.[no line break][end if]"

to say check-tokers:
	say "[if tokers are in Strip of Profits]motion to the mangiest steaming.[paragraph break]'Dude! My buddies!' he shouts. 'I must've went back to the wrong store or something. Hey, I met this dude!'[no line break][else]stand around nervously while he wonders where his friends are. They must be nearby.[no line break][end if]";

this is the pre-babbler-outside rule: [there are no conditions here. We just want to organize everything before moving back to the Strip of Profits.]
	moot nestor;
	moot tokers;
	moot mangiest steaming;
	moot pamphlets;
	now list-headache is true;
	increase headaches by 10;
	now lectures is shunned;
	if t-tediously is in otters:
		let A be pod-num of t-tediously;
		now pod-num of t-tediously is 0; [disable "tediously" in otters]
		now t-tediously is off-stage;
		let B be a random number from 1 to pickup-pod-size of A - 1; [I'm hard coding things here... assuming t-tediously has the highest pod number. Otherwise I am writing lots of code for one special case.]
		install-pickup-line A and B;

book routes

table of routes anagrams
the-from	the-to	taked	hashkey	roomjump	right-word	right-cmd (topic)	pre-rule	post-rule	the-msg
worst ad	worst ad	false	490212044	--	"towards"	"towards/toward"	pre-mesa-dir-flip rule	a rule	"You walk towards the ad to see what it says, and when you do, you find yourself not caring what direction you are going in. Then you hear a crackle, and someone yells, 'Catch that intruder!'[paragraph break]Ow! Darts! You pass out and wake up in the center of the Same Mesa again. The ad is gone. You may not be closer to saving Yorpwald, but you've made it fractionally more livable, so yay there."
scripture picturers	scripture picturers	false	404002364	Cleric Circle	"inside"	"inside"	pre-mesa-dir-flip rule	--	"The structure resigns ingress."
lairage regalia	lairage regalia	false	373417715	Adobe Abode	"across"	"across"	pre-mesa-dir-flip rule	post-across rule	"You walk across, not worrying about what is in front of you. Oscar's appears in front of you. You walk in."
adsorbing signboard	adsorbing signboard	false	283037761	Idle Deli	"past"	"past"	pre-mesa-dir-flip rule	post-past rule	"You decide to walk past Pat's. Then, you turn and enter the alley just past it. The building lurches sideways toward you, and you manage to jump through the doorway with only a minor bump as it slams into you. You hear taps spat as you enter."
sit a nag	Gast	false	350259676	--	"against"	"against"	pre-sitanag-against rule	post-sitanag-against rule	"Quakes squeak as someone approaches, and you think 'Angst! Ai!' [he-she-c] is a lot bigger than you. [he-she-c] sits down and begins, 'tantrums! Must rant![paragraph break]The buggin['] biggun wants you to [b]LISTEN[r] to its staired tirades but also occasionally gestures to the side art on the [sit a nag][if side art is unexamined] you missed before[end if]."
side art	side art	false	480723649	--	"astride"	"astride"	pre-side-art-astride rule	post-side-art-astride rule	"You sit right on the end of the [sit a nag], prepared for a tired tirade. The brokest sob-trek ever--and yet, even with your yelling, 'Nag it, giant!'[paragraph break][gast] changes pace. You hear something in the distance. 'The [woe bow bell]!' [Gast] moans, distracted."
WOE BOW BELL	Rude N Nuder	false	382326203	--	"below"	"below"	--	post-below rule	"It's worth a shot. You duck below the [sit a nag]. Not actually kneeling, of course, because that would be sort of like bowing. But [Gast] decides, why not join you, just in case? After several minutes, [the woe bow bell] stops. Perhaps there was a correlation. Perhaps not. But [Gast] has decided to change the subject, pulling out a book labeled [rude n nuder] and launching new complaints about how this is what Yorpwald is reduced to these days."
Rude N Nuder	U NERD ENDUR REDUN	true	408172316	--	"under"	"under"	--	post-under rule	"You can't take [Gast] waving the, um, literature around. You look under--the parts [Gast] won't let you see--and you wonder what's the big deal. Disgusted that nobody will listen any more, [Gast] throws [rude n nuder] in the air. The slip-on cover rips! It falls away to reveal a different book ... [i]Runner Dude[r], by Nurene Rudd and Derrun Edun. Wait, no! That's another false cover. The book's real title is [b]U NERD: ENDUR (REDUN)[r]! And boy, it is runed.[paragraph break]Well, whoever hid it was clever. Hide something EXTRA taboo under something that just gets everyone moderately uncomfortable." [bold-ok]
pipe soot	pipe soot	true	683820011	--	"opposite"	"opposite"	--	post-pipesoot-opposite rule	"You inch to the other side of the room, engaging in small talk, complimenting Oscar on how nice the place is. With your back to the ashtray, you grab a big chunk of pipe soot, which you stuff in your super purse. You may or may not be a six footer, but you're a soot fixer[if list o toils is examined]--maybe you can find someone the soot is useful for[end if]!"
seed pit	stupor sprout	true	602484096	--	"despite"	"despite"	--	post-seedpit-despite rule	"You ignore Pat's 'pits go to pigs' and 'yon pit, no pity' warnings and the sign. 'You can't...'[paragraph break]But you do. It's yucky and squishy, but it's not the seediest seed site ever. You hold your nose, hoping you can find what you want. Suddenly, you feel irrationally happy to find a small plant--you even think 'TO SPUR PO['] RUTS. PORT US!' Yes, it must be a stupor sprout! You take it, leaving the mere pit emptier." [bold-ok]
be ova	MORF FORM	false	329930229	--	"above"	"above"	--	--	"You look up. There is a giant [morf form]! How did you miss it before? It's so big and huge and intimidating, you stumble back and kick [be ova], which rolls out of sight.[paragraph break]Okay, so now to deal with [the morf form]."
MORF FORM	THE BEAN	false	250266429	--	"from"	"from"	--	--	"The [morf form] suddenly falls, becoming FROM above. You watch a blot bloat as it gets closer. You duck and don't hear the thud. When you wake up, whatever was inside it is in the shape of a bean--but not just a bean. It's labeled [the bean].[paragraph break]You grumble to yourself: 'Mesa's a mess!' / 'Intact? It can't...'" [bold-ok]
THE BEAN	THE BEAN	false	485518766	Harms Marsh	"beneath"	"beneath"	--	post-the-bean-beneath rule	"You push [the bean] and grunt theatrically, and they take the cue. Yes, there's a big hole you can go down. You think you hear a drama armada cheering you: 'Go down now, dog!' ... 'So true, sure to set our ouster...' It's a scented descent, which feels right. It had better be. You hear [the bean] roll back into place..."
NULL IT unit	odd run on aura	false	375930018	--	"until"	"until"	pre-unlit-until rule	--	"The one preposition gives you confidence you will find No-Lag Logan, and because you're below ground, you fear no sunlit insult. The [null it unit] fizzles a bit and pops, and light returns to Harms Marsh ... in the form of an odd run on aura![paragraph break]So while the marsh isn't exactly glowing now, you can definitely notice things better. The sheol holes in particular, though some will still ambush you. But which way to go? Compass directions are still out."
odd run on aura	un road	false	356906602	--	"around"	"around"	--	post-around-unroad rule	"With more light, you find...yes, an un-road! Lit by stripey, spritey pyrites you'd have missed otherwise. They're almost too bright. You find an all noon gag that helps deflect the shiniest bits, but perhaps it can help you even more."
noon gag	noon gag	false	231861444	Ripe Pier	"along"	"along"	--	--	"You go along the path you found. You're a bit worried you might be ambushed by an ol['] loan gang, but soon enough, you find yourself at a pier by ... well, you're pretty sure there's some sort of body of water behind the admits mist ad over there."
data dim mists	data dim mists	false	331668890	Cripple Clipper	"amidst"	"amidst"	--	--	"It's tricky. You don't want to just get through the mist, but you mean to explore everything. And you turn up a bad oar! Then, when you find a ship, it's--well, the bad oar is accepted. 'You found it! You must be the one! I can go now!' It is No-Lag Logan. You protest. You need someone to show you the way! 'You will learn from my impetuousness,' says No-Lag Logan. I needed some weird unusual direction, but I just went ahead and tried any old thing ... and now I have just this Cripple Clipper. It will not work for me, but if you got here, it will work for you."
thickness sketchins	thickness sketchins	false	441136547	Sonancy Canyons	"athwart"	"athwart"	--	post-athwart rule	"Not just any direction will do. You need something nautical. And there it is. Athwart--helps you navigate around tough bits. 'Ahoy, eh? Oh yeah!' you yell, identifying the mast and stuff. You suddenly feel enveloped with all manner of navigational knowledge, and the mess-up spumes popping up everywhere? Well, they are no problem. And though you're in an underground cavern, there are--well, not quite stars, but markers that can help guide you to the free reef, if you need the extra direction.[paragraph break]Harbor! Rah, bro! The bad oar helps you on your way but snaps as you land. You think to yourself, scan yon... so canny... and you wind up somewhere different."
bent ewe	bent ewe	false	681789531	--	"between"	"between"	--	--	"You stand bravely between the hog and the bee. Surprisingly, they don't seem upset. They actually appreciate your company."
raptest patters	raptest patters	false	575888338	--	"without"	"without"	--	--	"It's always tough to figure how to ignore stuff. Do you focus on it directly, to find a way to get rid of it, or do you try to block it out? Either way, you realize that you just want to be without that sort of drivel, and ... amazingly, when you think of the more important things you have to do, it goes away."
hurt hog	hurt hog	false	475056505	--	"through"	"through"	pre-hurt-hog-through rule	post-hurt-hog-through rule	"You realize it's time to move on. So you do. It feels a bit ritualistic and all, but the hurt hog and bent ewe, no longer hurt or bent, move on physically as well. You come upon a yob den nearby. Only your wisdom, or abstract anagram-solving skills, can help you determine whether to visit for a while, or not."
yob den	yob den	false	432873440	Strip of Profits	"beyond"	"beyond"	--	--	"You ignore the yob den. That'll sort itself out later. What's important is to find a way out, back to the surface. And you do... it's much quicker than you'd think! You turn around, and there's the yob den, cheering for you. A drama armada is also there, beneath a ramada, of course. They're applauding you. You realize you're just outside of the poison stripe, and it turns a final shade of bright green before it winks out and vanishes. 'Pardone...a pro end! One, pard!' It's Brother Horbert. 'These other people, well, they promoted me to an Aproned Padrone. I hope I'm up to it. But I know you have other places to be ... thank you... just one more thing?[paragraph break]In private, you help him change a Groans Sarong back to organs, which will spread joy and music and art through Yorpwald. Behind the sarong is a way through Old Warpy. As you enter, you notice No-Lag Logan has joined the crowd waving to you."

this is the pre-mesa-dir-flip rule: [check general rejects for ACROSS, PAST, INSIDE or TOWARDS]
	[if noun is scripture picturers or noun is lairage regalia or noun is adsorbing signboard or noun is worst ad:]
	if Gast is in Same Mesa:
		say "Walking away would upset [Gast]. I mean, into doing something, not just talking. And [he-she] is bigger than you. Maybe listening will help[if noun is not prefigured and noun is not reflexed], and you can move that way later[end if].";
		preef noun; [?? obvious test here is PAST, AGAINST, PAST, PF]
		[
		preef worst ad;
		]
		do nothing instead;
	if noun is reflexed: [this covers going back to the place]
		if noun is picturers:
			abide by the horbert-gone rule;
			say "You go back inside, being a bit over-cautious with protocol. You could've just said [b]IN[r].";
			move player to Cleric Circle instead;
		if noun is lairage:
			if pipe soot is not in Adobe Abode, say "There was nothing else but the pipe soot in Oscar's." instead;
			say "Yeah, [b]ACROSS[r] is fewer keystrokes than [b]ENTER OSCAR[r]'S, so hey...";
			move player to Adobe Abode instead;
		if noun is adsorbing signboard:
			if stupor sprout is not off-stage, say "You got the stupor sprout in Pat's. There wasn't much else there." instead;
			say "You try the walking into the alley trick again, but the building stays still. You're a bit disappointed you can just walk in like that.";
			move player to Idle Deli instead;

this is the post-across rule: now uhh tut hut is clue-used;

this is the post-past rule: now resto store is clue-used; [?? rivets/Trevis Vister clue used too?]

this is the pre-sitanag-against rule:
	if list o toils is unexamined:
		say "You hear loud footsteps and hide under the [sit a nag] in fear. A giant walks by but can't see anyone and runs off, complaining how there's nobody to complain to. Maybe if you had a reason to talk to the giant, or a purpose here, you might listen a bit better. [if Cleric Circle is not visited]Maybe if you could find a way to visit the Cleric Circle and find inner peace[else]Perhaps you could find something to do from Brother Horbert[end if].";
		preef sit a nag instead;
	if Gast is off-stage:
		say "You hear a giant's footsteps in the distance--but your talk with Brother Horbert has helped you be fearless.";
	if U NERD ENDUR REDUN is not off-stage, say "You don't need or want another round of that." instead;

this is the post-sitanag-against rule:
	now tirades are in Same Mesa;

this is the pre-side-art-astride rule:
	if Gast is not in Same Mesa:
		say "You get astride the [sit a nag] for a while, but it's pointless with nobody around. Maybe later.";
		preef side art;
		the rule succeeds;

this is the post-side-art-astride rule:
	now WOE BOW BELL is in Same Mesa;

this is the post-below rule:
	now Gast has Rude N Nuder;

this is the post-under rule:
	moot Gast;
	moot tirades;
	check-list-realized;

this is the post-pipesoot-opposite rule:
	check-list-realized;
	now pipe soot is not scenery; [so we RETRY successfully]

this is the post-seedpit-despite rule:
	now cravings carvings is clue-used;
	check-list-realized;

this is the post-the-bean-beneath rule:
	if worst ad is not moot, poss-d;

this is the pre-unlit-until rule:
	moot darkness;

this is the post-around-unroad rule:
	now noon gag is in Harms Marsh;
	now stripey pyrites are in Harms Marsh;
	now un road is in Harms Marsh;

this is the post-athwart rule:
	moot bad oar;

this is the pre-hurt-hog-through rule:
	if bent ewe is reflexive:
		say "That could work later, but the hog and ewe don't trust you to go by yet.";
		preef hurt hog;
		do nothing instead;

this is the post-hurt-hog-through rule:
	moot bent ewe;
	moot hurt hog;
	now yob den is in Sonancy Canyons;
	set the pronoun it to yob den;
	set the pronoun them to yob den;

section routes auxiliary

to check-list-realized: if number of held quest-items is 3, now list o toils is realized;

book troves

table of troves anagrams
the-from	the-to	taked	hashkey	roomjump	right-word	right-cmd (topic)	pre-rule	post-rule	the-msg
Pa Egg Pea	Pa Egg Pea	false	244059588	--	"gape"	"gape"	a rule	a rule	"You empty your mind to let the advice in Pa, Egg, Pea sink in. It--makes sense, if you don't think too hard. [eicond]."
tears taser	tears taser	false	414701714	--	"stare"	"stare"	--	--	"You stare right at the [taser], just to prove you have initiative and don't really belong here. You hold up [pa egg]. The taser retracts."
eh at heat	eh at heat	false	270386244	--	"hate"	"hate"	--	post-heat-hate rule	"You feel a rife fire in your heart, wiping out any if/er...[paragraph break]'How neat! Hate won heat now!' you think to yourself. You find more ways to hate. It feels right.[paragraph break]You think 'Heats ... hates ... haste?!' then 'Ah, set.' So you manage to stay toasty, but something happens to turn your thoughts of gold coin goin['] cold. A bogeyman takes your moneybag! You notice they sneak through a place called the Race Acre. But you feel a need to draw on more emotion now."
Race Acre	Race Acre	false	234323315	Bustle Sublet	"care"	"care"	--	post-race-acre-care rule	"You feel a gust, or tugs, in your guts. And hey! This caring really works! You ignore aches during this chase and track the robber to...well, they can't have ducked out in plain sight. You run past a loudest used lot, and ... well, you wind up somewhere noisier. Emotion has gotten you this far. In fact, it has even led you to a fretful truffle, which you pick up.[wfak][paragraph break]But you will need to be more analytical and evidence-based to move on."
sob ever verbose	sob ever verbose	false	637146289	--	"observe"	"observe"	--	--	"Cads. Clues. Cul-de-sacs. Once you really pay attention, you see how observing them detachedly gets you closer to what you really want. You're in the zone, now. Something may or may not be moving by the stop post. Time to hone your observing."
mussier misuser	mussier misuser	false	619851650	--	"surmise"	"surmise"	--	--	"You glance over at [the misuser] with the appropriate amount of disdain. You catch their eye. A small staring match ensues. Yes. Yes... you get the contempt bit just right. They shrink away. Your first power struggle, won handily! It is only in a relatively beaten-down place, and it probably wasn't strictly necessary, but it is still something. You realize in the future you will be able to gain juice with gullible people by pointing out said misuser's clear moral shortcomings--and, of course, possessing said shortcomings in a much classier way."
stop post	stop post	false	355202520	Boarded Roadbed	"spot"	"spot"	pre-spot-stop-post rule	post-spot-stop-post rule	"A clue where to go next! You follow it to somewhere more desolate, and there's the thief! You don't let on you've spotted [him-her], but you walk near, notice [him-her] jump, and yell the magic words.[paragraph break]'Setup, stupe!' Wop! Pow! Pop! Wow! An upset! Your smackings are apt food for a footpad. [he-she-c] drops your purse--[i]though at that moment you realize the self-reliance you gained is better than any money.[r] Still, during all this feeling good about yourself, you let [him-her] get away. 'You won't find me in the cellar!' [he-she] yells before disappearing.[paragraph break]You intuitively know it must be a/an [cellar], perfectly clear only to those who have a good idea where it is.[paragraph break]You start your deductive work, but a bee jumps in the way, and you lose all your mental calculations..."
SNORE SO ARENA	SNORE SO ARENA	false	454851781	--	"reason"	"reason"	--	bee-less-active rule	"The [snore so arena] doesn't make sense. You calm down and sort out the reasons it doesn't, and that helps. Then you remember the bumblebee and giant paradoxes: small bumblebees flying don't make any sense. Then, therefore, a much bigger one should make even less sense[if bee-score is 2]. So you have now disposed of the bee both emotionally and logically[else]. You can probably get by the vile bee (it's no longer really an evil bee,) although it may be possible to marginalize it even more[end if]."
evil bee	evil bee	false	607808737	--	"believe"	"believe"	--	bee-less-active rule	"You remind yourself bees smell fear, so you decide to believe that the bee will not harm you[if bee-score is 2]. On top of your reasoning it can't, you render it out of commission emotionally and factually[else]. You can probably get by the bee, although it may be possible to marginalize it even more[end if]. You also believe, that much more, that you can find your way out of here."
a sty tasty say	a sty tasty say	false	323931054	--	"stay"	"stay"	--	--	"You resist the temptation for needless spending, all the while forming plans to get rich by making others spend needlessly."
L Clear Cellar	L Clear Cellar	false	341950993	Drain Nadir	"recall"	"recall"	pre-cellar-recall rule	post-cellar-recall rule	"You take some time, and not all your memory comes back, but a few cues tip you off--they're easier to see with the bee gone. Where's L'Clear Cellar? You keep trying to recall--and you try so hard you forget to feel sorry for yourself. You let out a 'Darn, I...' but then, there's the way. 'Rad! In!' But when you look up, it's not a great place to be."
diapers	diapers	false	459079590	--	"despair"	"despair"	--	post-diapers-despair rule	"You get all 'Shame has me/Limpy my lip' and scream 'A sod's so sad!' and reflect on how you've moiled into demolition, and you remember that hitting rock bottom is the first step. I can't describe your bed cries over a dwelt-on letdown as you gasp at gaps in your [one of]samey, seamy[or]empty, tempy[at random] life and the chasm to stomach.[paragraph break]You move from Ow, Hell to Oh, Well, groaning mood to a good morning, ruined to inured. You realize you have a day job (joy, bad)--empty but not tempy--as a fiche chief, no longer bullied by BILL DUE, and yet... after some furnace care fun, you find yourself listening over and over again to that song. By Eddie C. Why, it's blasting right now!"
large regal lager	large regal lager	false	301731271	--	"glare"	"glare"	--	post-lager-glare rule	"You glare at the cursed alcohol, contemplating its effects on so many leaders and would-be leaders and the economy in general when drinkers don't take as productive jobs as they should. Thar's Trash.[paragraph break]You know now it will cause you to lose willpower[if diapers are moot], despite your recent fit of despair[else] for the intense emotional effort to leave this place[end if]. Not for you are the glugster's struggles against scarlet clarets, his tab habits.[paragraph break]You obviously care about the working man and his productivity and, eventually, his income and savings. How the false down-home humility in beer commercials is worse than beer's physical effects. After an impeccable moment of silence for the productivity lost to the cursed drink, you leave the bedroom just long to pour the hurtful booze down a trash disposal. You formulate a new anti-drug campaign (Sexual? Ale sux! Prohib? Hip, bro!) but realize you are not important enough to carry it out. [i]But you will be one day[r].[paragraph break]Man, that was so Heratio ALGER!"
Id Cede	Id Cede	false	361668827	Boredom Bedroom	"decide"	"decide"	--	post-decide rule	"Yes. It is time. You concoct a melodramatic mental defense against melodrama, and you move on, and up in the world, to where you are no longer despondent but just bored with an average life."
ME ARTS	ME ARTS	false	478776867	--	"master"	"master"	--	post-master-or-bolster rule	"You realize the picture's not just some odd ole doodle. You critique it. 'Matters I mistreat, artist? Me?' / 'Master it.' It's tamer, the whole business. You cross breed boss creeds and master [further-bedroom]the concepts needed to succeed. Ah! Less hassle! You will now achieve zones so Zen as you improve more, VIP.[paragraph break]Once you've fully gotten value from it, you plan to sell it at a profit to someone who can similarly use it--if they are focused and with it and such. Good art only appreciates with age!"
lobster	lobster	false	559099217	--	"bolster"	"bolster"	--	post-master-or-bolster rule	"You bolster your will [further-bedroom]to believe you deserve great food like lobster, not just today, but any day. One day, you will not worry about the price of lobster, and your next [bortles] will take a smaller percent of income than your underlings['] food of theirs!"
pleaser leapers	pleaser leapers	false	574677603	--	"relapse"	"relapse"	--	--	"You lose yourself in the pleaser leapers for a while before snapping out of it. You wonder what you ever saw in them, though of course, you sort of know. 'Danseur dauners, ASUNDER!' you cry, melodramatically, as you realize what a hollow pleasure they are. And yet, at the same time, it was a worthwhile part of your emotional journey. You can't just pitch them out a window, though. They go in the trash, buried deep. Physically and metaphorically. You will look for the approval of real people in the future. Nothing could go wrong that way.[paragraph break]Still, all the same, you feel obliged to respect the initiative of SAP-LEER for profiting so handsomely off them." [bold-ok]
LEAD	LEAD	false	204836855	Browse Bowers	"deal"	"deal"	pre-deal rule	post-deal rule	"You learn to deal with globalization, your own self-hate, your false conscience, memories of EVICTION NOTICE IV, a second-grade bully, and so forth. Even the blankest blankets seem to have a quilty quality, now.[paragraph break]'NO STAYIN['] ON IN A STY!' you yell. Decaf-faced, you leave your unmade apt., full of up and at em and move-it motive! Mo['] nice income ahead! You pass saps on your way..." [bold-ok]
Si Reed	Si Reed	false	503231922	Econ Cone	"desire"	"desire"	--	post-desire rule	"You remember how when you were a kid you just wanted money. And people--people who believe you deserve said things--to show it off to! And a nice subtle sublet full of bustle where they won't get stolen! No win without ownin[']![paragraph break]You make plans for a mortgage on a nice place in Heirsshire. There's a bunch of twaddle about balloon mortgages and reverse derivatives and interest rates, but you'll let the eggheads take care of this. You need to find a job that'll pay for that place now. And affords for fads. No more thingola loathing."
DIVORCES	DIVORCES	false	575948795	--	"discover"	"discover"	--	--	"On perusing [b]DIVORCES[r] with a [if divorces is examined]more [end if]critical eye, you gain insight. These people are not better than you! Just more exciting and better at wasting others['] time! But this is what the media focuses on. Perhaps it is because less productive people deserve it, or perhaps it is to sucker people who might otherwise think for themselves. That's not your business. [b]DIVORCES[r] is not for you! You pitch it and re-focus.[paragraph break]Si Reed sees you gazing at [b]DIVORCES[r], picks it up, throws it away, and says 'So what's the deal? You motivated to move ahead in life, or not?' Why, yes. Yes you are."
praise spirea	praise spirea	false	438050501	--	"aspire"	"aspire"	--	post-spirea-aspire rule	"You remember how when you were a kid you just wanted money. Well, now you recognize the importance of money AND power! You make grand plans for a great fiscal empire, full of power-broking, rainmaking and all those other terms you didn't understand as a kid. As you grok the praise spirea, it quiets down -- or maybe you've just internalized its message[if rivets are reflexed]. Boy, you feel extra well rounded now. You want money and power for many, many different reasons![else].[end if]" [bold-ok]
rivets	rivets	false	564671562	--	"strive"	"strive"	--	post-rivets-strive rule	"You make up your mind to strive. You strive to strive even more. You strive to make others strive. You feel twice as useful as you did a minute ago. You feel all, BAM! MBA[if praise spirea is reflexed]. Boy, you feel extra well rounded now. You want money and power for many, many different reasons![else].[end if]" [bold-ok]
sectarian craniates	sectarian craniates	false	549795471	--	"ascertain"	"ascertain"	--	--	"You look this way and that at [craniates] and, yes, you think you have a revelation or two. Maybe it is only a revelation about how to pretend you had a real revelation, but it will serve you well to seem thoughtful to important people in the future. Who knows, maybe one of them actually has gotten something from [craniates], and if you impress them enough, they might show you whatever the heck it might be."
END PRONER POD	END PRONER POD	false	458885045	Upscale Capsule	"ponder"	"ponder"	--	post-pod-ponder rule	"You realize it's not just enough to have ambition. You look into yourself a bit, and you have all the answers. Well, enough so that people will believe you long enough to get power. Good enough. You focus your sob story about how the guy who just got canned? Well, he almost ran you over, and you learned from him, and you have more to learn--it's easy stuff. But perhaps it's easy because you thought it through! You run past countless offices with people named Gingold, Golding or even Gil Dong before finding an individual one right for you."
red vees	red vees	false	693210005	--	"deserve"	"deserve"	--	post-redvees-deserve rule	"You believe you can, and you can! Once you do, your office fills up with meaningful and productive stuff. The salt, though the smallest, may be the most important. The rest is just trappings."
salt	salt	false	255385641	--	"last"	"last"	--	post-salt-last rule	"You start lastin['] like Stalin. [']Til you ARE worth your salt, sure all stats are up to par. You've stayed steady so efficiently that it doesn't seem much time has elapsed since your career started. Your company becomes Kings at staking takings. And lastin['] like Stalin busses in business, and you re-last [']til it's staler. You're in charge of more than a region now. At which point you realize you'd better get rid of the salt, which causes hypertension in a job like yours. You kick it under your desk and forget about it.[paragraph break]Then, oh, man! A delivery of Trance Nectar came when you were away. That's totally the stuff to help keep you focused and productive, unlike that nasty Large Regal Lager back in Boredom Bedroom.[paragraph break]In addition, there's more 'fine art' to help you focus on your work. [bb-st] now look down on you disapprovingly. For motivation, of course. For motivation."
Sister Tressi Siters	Sister Tressi Siters	false	553780708	--	"resist"	"resist"	--	post-tressi-resist rule	"You stare back, just so. You believe you will not be a failure all your life...and it works! And yet, you know, her stare should and will work on people even more delinquent than yourself. Still, you're not one of them any more. If and when you reach the top and make powerful motivational speeches, you will remember this moment! You feel more able to cope with the pressures of the world."
Marble Blamer Balmer	Marble Blamer Balmer	false	351625627	--	"ramble"	"ramble"	--	post-mbb-ramble rule	"You let your mind wander, and for whatever reason, you figure out even more about yourself than you expected. You are able to snicker a bit at [mbb], and yet--you can still plan how to get ahead. Maybe you don't need to take things TOO seriously."
Marble Blamer Mr Beal	Marble Blamer Mr Beal	false	351625627	--	"ramble"	"ramble"	--	post-mbb-ramble rule	"You let your mind wander, and for whatever reason, you figure out even more about yourself than you expected. You are able to snicker a bit at [mbb], and yet--you can still plan how to get ahead. Maybe you don't need to take things TOO seriously." [this is really horrible copied code, but I see no other way to do things.]
Creationism Reactionism	Creationism Reactionism	false	731028229	--	"romanticise"	"romanticise"	--	--	"The daydreaming somehow works! What a crazy world you think up! Not one where anyone would actually want to read [creationism], of course. But one where people weren't impressed by it. Still, you know thought-police watch for people who throw it out, so you call up a gullible sucker underling to gift it to. In retrospect, you wonder if the person who gifted it to you did not do so from the bottom of your heart. Well, that doesn't matter now."
trance nectar	trance nectar	false	406340841	Strip of Profits	"recant"	"recant"	pre-nectar-recant rule	post-nectar-recant rule	"As you think of drinking the trance nectar, you think...no. It can't be like this. You can do better. You turn your back on the rat race. It seems so easy once you put your mind to it. [troend]"

to say eicond:
	say "[if cur-score of troves is 0]You can picture yourself, successful, extolling this book as what got you started[else if player is in Loather Rathole]You feel you can and will do better than here[else if player is in Bustle Sublet]You dare to feel superior to whoever might be walking around here[else if player is in Drain Nadir]You know you deserve better than this. It's a temporary setback[else if player is in Boredom Bedroom]The book convinces you that average is not enough for a thinker like you, as long as you are thinking like it. You buck up[else if player is in Browse Bowers]Someone semi-important-looking walks by and commends your choice of reading material, and you say you love it[else if player is in Econ Cone]You even successfully turn back an insult from someone who is all LESS READING MORE DOING[else if player is in Upscale Capsule]You turbo-speed-read, since you've LIVED a lot of this advice[end if], ignoring how useless the book is for helping you figure what to do right now. Eh well, you've got a spiel to tell others how THEY better use it"

this is the post-heat-hate rule:
	now purse-stolen is true;
	move Race Acre to Loather Rathole;
	now eh at heat is realized;

this is the post-race-acre-care rule:
	now player has fretful truffle;
	now loather rathole is shunned;
	if tears taser is not moot, poss-d;

this is the pre-spot-stop-post rule:
	if sob ever verbose is touchable:
		say "That should work, but you--your eyes are wandering now. You're not taking it all in. Around the post, the sob ever verbose echoes aid distracts you. You must deal with it first!";
		preef stop post;
		do nothing instead;

this is the post-spot-stop-post rule:
	now purse-stolen is false;
	now stop post is realized;
	now bustle sublet is shunned;
	if mussier misuser is not moot, poss-d;

this is the bee-less-active rule:
	if bee-score is 2:
		say "You're now able to focus perfectly on L'Clear Cellar and how to get into it[if cellar is prefigured]. Not much else to do here than [b]RECALL[r][end if].";
		min-up;
	else:
		say "You're able to focus on L'Clear Cellar and how to get into it, now[if cellar is prefigured]. Maybe you could focus perfectly if you wanted, or you could just [b]RECALL[r] now[end if].";
		now b-text of evil bee is "RYPYYRG";
		now parse-text of evil bee is "BELIEVE";
	now noun is realized;

this is the pre-cellar-recall rule:
	if bee-score is 0:
		say "Darn it, that should work. But you can't focus on anything with that evil bee buzzing around you right now.";
		preef L Clear Cellar;
		the rule succeeds;

this is the post-cellar-recall rule:
	if bee-score < 2, poss-d;
	if tasty sty is reflexive, poss-d;
	now boarded roadbed is shunned;

this is the post-diapers-despair rule:
	moot Ires Pad;
	moot spider;
	move Id Cede to Drain Nadir;

this is the post-lager-glare rule:
	set the pronoun it to LEAD;

this is the post-decide rule:
	if large regal lager is not moot, poss-d;
	now Drain Nadir is shunned;

this is the post-master-or-bolster rule:
	if ME ARTS is in Boredom Bedroom, now ME ARTS is LLPish;
	if lobster is in Boredom Bedroom, now lobster is LLPish;
	say "[if bedroom-solve is 2]You feel your arch-greed recharged. [end if]You're [one of][or]even [stopping]more up to grokking [b]LEAD[r], now.";

to say further-bedroom: say "[if bedroom-solve is 2]further [end if]"

this is the pre-deal rule:
	if lobster is in Boredom Bedroom and me arts are in Boredom Bedroom:
		say "That seems right! But you don't have the courage yet! Perhaps you need to start smaller, with the lobster, or the [b]ME ARTS[r].";
		preef LEAD;
		the rule succeeds;

this is the post-deal rule:
	if pleaser leapers are not moot, poss-d;
	if lobster is in Boredom Bedroom or ME ARTS is in Boredom Bedroom, poss-d;
	set the pronoun them to Browse Bowers;
	now Boredom Bedroom is shunned;

this is the post-desire rule:
	if DIVORCES is not moot, poss-d;

this is the post-spirea-aspire rule:
	remove praise spirea from listen-list of troves, if present;
	process the post-strive-or-aspire rule;

this is the post-rivets-strive rule:
	process the post-strive-or-aspire rule;
	now Trevis Vister is reflexed; [?? this should be something else]

this is the post-pod-ponder rule:
	if cone-points < 2, poss-d;
	if sectarian craniates is reflexive, poss-d;
	now econ cone is shunned;

this is the post-redvees-deserve rule:
	move wonga wagon to Upscale Capsule;
	move nerf fern to Upscale Capsule;
	move pharos phasor to Upscale Capsule;
	move St Al Salt to Upscale Capsule;
	move cark rack to Upscale Capsule;
	move desk sked to Upscale Capsule; [Balmer and Tressi don't appear until you deal with the salt]

this is the post-salt-last rule:
	moot salt;
	now trance nectar is in Upscale Capsule;
	now mbb is in Upscale Capsule;
	repeat through table of troves anagrams:
		if the-from entry is Marble Blamer Balmer:
			now the-from entry is mbb;
			now the-to entry is mbb; [this is part of the silly randomization]
	now Sister Tressi Siters are in Upscale Capsule;
	now creationism reactionism is in Upscale Capsule;

this is the post-tressi-resist rule:
	now mbb is LLPish;
	report-glarers;

this is the post-mbb-ramble rule:
	now Sister Tressi Siters are LLPish;
	report-glarers;

this is the pre-nectar-recant rule:
	if mbb-sis-points is 0:
		say "It ... you know you should drink [the nectar], for the good of society and the economy, but something nags at you. You've come to loathe [the nectar], and yet you can't quite break free of it. With [bb-st] both staring down at you, you can't quite bring yourself to. But maybe if you dealt with even one of them...";
		preef trance nectar instead;

this is the post-nectar-recant rule:
	let temp be 0;
	if Sister Tressi is prefigured, increment temp;
	if mbb is prefigured, increment temp;
	if temp > 0, say "(NOTE: before moving on, you muck with some stuff to get a few extra points, stuff you weren't quite ready to yet, because your desire for more isn't totally drained.)[paragraph break]";
	increase min-score of troves by temp;
	increase cur-score of troves by temp;

to say troend:
	say "No more trance nectar for you. O glum mogul! You backtrack your trip to the top, gaining spirituality as efficiently as you gained worldly status. Once you have irreversibly adjusted your quit note quotient and signed a short-week worksheet, you reenact gloom you remembered in this conglomerate. Is life I, Self, I? Lies, if...[paragraph break]Your condensed rise to the top of this business business makes you efficient at doing enough nothing. Well, nothing profitable. You write wistful songs that someone has to like, surely: [twiddle of table of songs you could write and 5].[paragraph break]You hear a knock on the door. You have been fired.";
	if lager is in Boredom Bedroom and divorces is in Upscale Capsule:
		do nothing;
	else if lager is moot and divorces is moot:
		say "[line break]But you did something for society. A lot. Disposing of [b]DIVORCES[r] and the lager helped you.";
	else if lager is in Boredom Bedroom:
		say "[line break]At least you struck a blow against gossip culture in general.";
	else:
		say "[line break]At least you struck a blow against alcohol in general.";
	say "[line break]Exhausted, you realize you have no way home. But you meet a fellow called Tristan, startin['] a company called Tin Star Transit. You pay with stolen knick-knacks from your Upscale Capsule. The ride's low-frills but extremely fast--to the Strip of Profits. So ends your paydirt day trip: poverty to the very top, IOU phear to euphoria."

this is the post-strive-or-aspire rule:
	if cone-points is 2:
		say "Your willpower is at 200%! But it doesn't do any good without introspection, being sure YOU deserve to get going. You look back at [the end proner pod]. You haven't fully balanced fear of winding up there with focusing on your goals.";
		set the pronoun it to END PRONER POD;
	else:
		say "Your concentration is broken by a scuffle! When you turn around, you notice the person who originally gave you the Peg A. Page book. They have been escorted out by security. And not just escorted. Pushed into a structure you did not notice before. It is an [end proner pod]. You hear the end of the argument: apparently, they made their ambition too obvious.[paragraph break]You shudder to think what will happen to them. And yet ... this could be an opportunity for you. You almost believe you deserve to move further up in the world, but you need to think just a bit more, and perhaps you need to do more than just want, want, want ... or you need to seem to, at least.";
		now END PRONER POD is in Econ Cone;
		set the pronoun it to END PRONER POD;
		if praise spirea is reflexive, now praise spirea is llpish;
		if rivets are reflexive, now rivets are llpish;

book presto

table of presto anagrams
the-from	the-to	taked	hashkey	roomjump	right-word	right-cmd (topic)	pre-rule	post-rule	the-msg
lamb	lamb	false	138495715	--	"blam"	"blam"	a rule	a rule	"You make pretend the gun noises as you point your finger at the poor little lamb. It runs off, scared. But the right kind of scared! And towards greener--well, less grey--pastures."
hump	hump	false	287929218	Austerer Treasure	"umph"	"umph"	--	post-hump-umph rule	"You don't need to ham up 'Hup, ma!' to get over a hump, because it's enough just to try umph. The hump vanishes once you get over it[if Leo is touchable]. [l-n-r] follow, jumping unnecessarily[end if]."
tsar star	tsar star	true	286895605	--	"rats"	"rats"	--	post-tsar-star rule	"The tsar star seems lodged in the tars. But you twist it around saying [b]RATS[r], and it seems to wiggle a bit. Just as you're about to give up, you give one more twiddle, and the tsar star pops in the air![paragraph break]You manage to juggle it before it falls in the tars again, and you just manage to swat it onto dry ground before it falls. You take time to wipe the remaining tars off the tsar star, and as you do, the main tars themselves schlurp into the ground.[paragraph break]Now the tsar star is clean, you see you can affix it to your clothes. So you do."
dart	dart	true	211650728	--	"drat"	"drat"	--	--	"The extra adrenaline provided by the mild swear allows you to be all 'Reach, acher!' And you reach the dart--but not enough to fall in the dumpster."
plebe	plebe	false	409310921	--	"bleep"	"bleep"	pre-plebe-bleep rule	--	"You let forth something bleepy. I can't say it here. You know what it is, because you know what your 'favorite' swears, combos thereof, or half-swear portmanteaux are[if player is not wearing tsar star]. But the plebe looks at your chest and smirks a bit. His old CO swore worse, with sager sarge rages[else]. It's no worse than his legions['] lingoes, but man, you said it with autority! How you built up to it, making the threat stronger than the execution, then BAM![paragraph break]You keep up the abuse by yelling how he can't even stand his bleeping ground to bleeping second rate verbal abuse. 'Reamin[']! Remain? Me, I ran!' (Don't worry, the plebe was getting bored and wanted an excuse to leave, anyway. You gave cover, in case they were being surveilled.)[paragraph break]You can go east now." [bold-ok]
boing	boing	false	239271538	--	"bingo"	"bingo"	pre-boing-bingo rule	post-boing-bingo rule	"You don't have much experience with this sort of thing, but you take a deep breath and realize there are only so many ways to do it wrong. Futzing with the popgun, you mumble 'Aah... aah... a-ha! I loc coil-loci!' You push the trigger just to make sure, and you hear the familiar [b]BOING[r][if popgun was not held]. You decide to keep it, now that you fiddled with it[end if]. [gun-load-if]."
sport ports	sport ports	false	440526323	--	"prost"	"prost"	--	--	"You mentally toast the abilities of people able to navigate the sport ports. It feels good, this act of sportsmanship."
odes song	odes song	false	591595494	--	"goodness"	"goodness"	--	--	"You manage to let our a 'goodness!' at the worst parts of the odes song. Somehow, it works. While you may not have done anything super-significant, your task here feels a bit easier."
Leo	Leo	false	255972525	--	"ole"	"ole"	--	post-leo-ole rule	"You set yourself near the vile veil and avoid Leo as he charges at you! He trips over a stump or root and cries, 'I...sprain! Aspirin!'[paragraph break]Leo's yelling attracts a fellow very much like him. 'Am Rand! Rad man!'[paragraph break]Leo looks up a second. 'Hey! A twin!' each cheers, before glaring at you. 'IN THE WAY!' Looks like you've got another challenge."
Rand	Rand	false	177448218	--	"darn"	"darn"	--	post-rand-darn rule	"You pretend to trip and tie your shoe. 'Darn.' Rand has seen this trick before, but it was a month ago, so he forgot. He dives at you, and you trip him. It would be merely demoralizing to someone more mentally resilient than Rand, but he is crushed by this loss.[paragraph break][l-n-r] begin to commiserate together, mumbling about being washups. Maybe they could use a nice word, or a little chat, about anything."
wzup	wzup	false	526524588	--	"whassup"	"whassup"	--	post-wzup rule	"'Pshaw, us?'[paragraph break]They're touched by your simple gesture and impressed with your command of slang. Nothing too presumptuous. You tell a white lie about how you know mystic arts and they could learn it too, so losing a fight to you isn't all that bad.[paragraph break]They hail leadership qualities you didn't know you have and vow to help you if you need it. 'Not bad to band,' you mumble.[paragraph break]'Want us? Aw, Nuts!'[paragraph break]They'll be following you around for a bit."
ye hoop	angrier earring	true	517618773	--	"phooey"	"phooey"	--	--	"[pooh-phooey-actions][get-earring]."
ye hoop	angrier earring	true	267453412	--	"pooh"	"pooh"	--	--	"[pooh-phooey-actions][get-earring]."
n-t-air	n-t-air	false	354304876	--	"wont"	"wont" or "won't"	--	post-nowt-town-wont rule	"[wont-maze]."
maze walls	maze walls	false	655479952	--	"mazeltov"	"mazeltov" or "mazel tov"	pre-mazeltov rule	post-mazeltov rule	"You decide to congratulate yourself [if maze-index is 0]before you get[else]despite not FULLY getting[end if] through the maze. Amazingly, it works! You black out, however, as the maze crumbles, and in a particularly silly dream, you hear someone [if Nowt Town is unvisited]moaning you didn't even explore the maze someone worked so hard to build.[else if mazeguide-scanned is true]saying you should not have had to scan that nice man or men to figure the puzzle, asking for any due dayenu.[else if Unwary Runway is unvisited]chiding you for not making it to the end.[else if r10 is unvisited]saying you barely even started.[else if zany meter is unexamined]wondering how you KNEW.[else]saying THEY'D never been that clever, THEY'D have to go through the maze.[end if] When you regain your feet, you notice ether to the north where Nowt Town was."
ether	ether	false	481328338	--	"there"	"there"	pre-ether-there rule	post-ether-there rule	"[l-n-r] look at you as you whisper. 'Er...the three... the mist, it's them!'[paragraph break]'Disturb! Bust! Rid! Wallop all.' POW! 'Headshot, hotheads!' [l-n-r], busier, bruise, calling a routing grunt 'Oi!', then 'Imma Maim!' / 'Oof, foo[']!' an assailant cries after a so-fit fist-o-foist. 'Yeehaw! Yeah, we...' / 'Ok, dem's smoked.' interrupts [l-r]. Whammo! How MMA!"
keys	keys	false	399372505	--	"syke"	"syke"	--	post-hogs-or-keys rule	"There's nothing more annoying that pretending like you want something, then saying 'Syke!' Or just saying syke, period. The clincher is when you change up with 'Yikes, I...syke!' All the hogs run after you, but you're fast enough to evade them. Once they're exhausted, [l-n-r] grab the keys. You play keep-away until the hogs can't move from exhaustion. 'Dat was clever, boss.' says [l-r].[paragraph break]'Yup,' you say. 'Syke-illogical warfare.' The wall collapses with an 'Aw, LOL. Allow...ow...all!'"
hogs	hogs	false	240508544	--	"gosh"	"gosh"	pre-hogs-not-keys rule	post-hogs-or-keys rule	"You pretend like you're giving up, and there's no way the hogs can beat you. You wink at [l-n-r] as they gang up on you as you make one last obvious effort--BAM! POW! The wall collapses with an 'Aw, LOL. Allow all...ow!'"
log ons letters	log ons letters	false	400300169	--	"solong"	"so long" or "solong"	pre-harpings-flip rule	post-harpings-flip rule	"[increm]"
alert letters	alert letters	false	372241587	--	"later"	"later"	pre-harpings-flip rule	post-harpings-flip rule	"[increm]"
ought letters	ought letters	false	352450403	--	"tough"	"tough"	pre-harpings-flip rule	post-harpings-flip rule	"[increm]"
hawt thaw	hawt thaw	false	250514908	--	"what"	"what"	--	--	"You realize you have done a lot of mental calculations with anagrams, but some of it feels rote, and while Elvira probably overdid it, there are times you relied just on calculation without asking deeper questions. Why is hawt-thaw as it is? Even Yorpwald's best scientists can't answer that question. So, you make a commitment to be more than just someone who finds anagrams, once this whole shebang is over, and you remind yourself that puzzles for their own sake only go so far.[paragraph break]The hawt thaw shrivels up and blows away, leaving you wiser--and more intellectually curious--for its brief presence in your life, even if it doesn't help you on your immediate quest.[paragraph break]You make plans, once Yorpwald is back to normal, to lobby for a Thaws-Swath to answer these questions. It will frequently be wash't, so it doesn't get shawt."
starch charts	starch charts	false	343183489	--	"trasch"	"trasch"	--	--	"You half-memorize the charts, just in case, before dismissing them. Calling them tras(c)h sort of works as a noun or an interjection, and, well, you needed to rip up something harmless. This act [if shack-flip-yet is true]clues[else]reinforces[end if] to you that the main interjections are mostly used up, and it's probably all nouns and verbs, like the word trash itself, inside the Hacks['] Shack."
Clack Ops Locs Pack	caps lock	true	399038507	--	"capslock"	"capslock" or "caps lock"	--	--	"You think WHOAH as the locs pack morphs into a caps lock button, which you pick up."
disk	skid	false	215229079	--	"skid"	"skid"	pre-disk-skid rule	post-disk-skid rule	"[one of]By some lossless easily reversible algorithm, t[or]T[stopping]he disk changes to a skid with a floppy pop-fly[one of]. The skid's too big to carry, but you can [b]PUSH[r] or [b]PULL[r] it around[or] again[stopping]."
skid	disk	true	215229079	--	"disk"	"disk"	--	--	"The skid changes back into the familiar disk, which you take." [there was a pre-skid-disk rule, but it was trumped by the SHATTER THREATS rule]
flea	leaf	true	210322662	--	"leaf"	"leaf"	--	--	"The hopefully only recently dead giant flea becomes a recently dead giant leaf, which looks much better due to all the pretty colors it's turned. It's light for its size, so you pick it up."
gum	mug	true	201780662	--	"mug"	"mug"	--	--	"The gum, being gum, morphs easily into a new shape -- a mug with annoying smile. Smug Mugs are, sadly, still in fashion in Yorpwald. But they often have a right to be, because they have odd special abilities. Maybe if you examine this mug, you can see if it does."
coal	ALocalCo cola	true	149359819	--	"cola"	"cola"	--	--	"The cheap-and-dirty physical energy-giving coal turns into cheap-and-dirty mental energy giving cola, and not just any cola. ALocalCo cola, the surprisingly invigorating caffeine drink outlawed in Yorpwald ever since Elvira failed to corner the market with the deceptively named All-Cocoa Cola and 'ironic' Ol['] Cloaca Cola, which also got a cease and desist letter from a bunch of weird stick figures in a totally different fantasy realm."
be troo e robot	be troo e robot	false	483363989	--	"reboot"	"reboot"	pre-reboot rule	post-reboot rule	"The [robot] whizzes around Drive A for a moment. It taps around and under. Then it[if player has rom sticks] takes your ROM sticks and puts them in Drive A before it[end if] produces a thin needle so it pokes Drive A just so ... and Drive A reboots! While the software updates, the [robot], looking exhausted, hides on the underside of the Labs Slab. It's done its job. [if player has rom sticks]Those ROM sticks will put your PPC on PCP to code in CPP and avoid PCRam Cramp. [end if]Drives A and E hum for a while, the computer screen lights up with a fractal shaped like a flatcar, and after a stallin['] install (and several booster-reboots,) the code you saw before reappears on the screen. But ... it still doesn't work. There's a peels speel on the screen that explains what, uh, peels you slipped on."
fount	futon	false	377990806	--	"futon"	"futon"	--	--	"The fount turns into a futon, which is better off not wet. [i]There's rest, eh?[r] you think, looking at it[if Im Le Cop polemic is reflexive], though you're not really tired yet[end if]."
censer	computer screen	true	525123080	--	"screen"	"screen"	--	post-censer-screen rule	"The black [censer] and its green dots swirl around and reform into a black screen! With green text!"
drab yoke	keyboard	true	504410731	--	"keyboard"	"keyboard" or "key board"	pre-yak-keyboard rule	post-yak-keyboard rule	"The drab yoke rearranges itself into something more rectangular. The scratchings become bona-fide keys, too. It's a complete keyboard! Well, except for one key[if player does not have yoke]. You are pretty sure you know where this keyboard goes, so you pick it up[end if]."
TBA key	TBA key	false	123716741	--	"tab"	"tab" or "tab key"	--	--	"Well, that wasn't too hard, but it'll be useful if you ever need to organize code."
Im Le Cop polemic	Im Le Cop polemic	false	465512068	--	"compile"	"compile"	pre-polemic-compile rule	post-polemic-compile rule	"You[if player has rom sticks] figure now's a good time to put those ROM sticks in. You[end if] successfully compile your code. Wahoo! Wooha! Core dev covered! But you hear a shwoop, then say whoops. The basic idea works, but the program...ug, sob, bug so bogus. Bug fixing ahead. You can't budge [']til then[if ALocalCo Cola is not moot]. And the task seems daunting, without energy[else if ALocalCo Cola is touchable]. The ALocalCo cola doesn't give enough energy[end if]."
peels speel	peels speel	false	487165982	--	"sleep"	"sleep"	pre-peels-speel-sleep rule	--	"'Fun to...' you muse, looking at the futon. You lie down and immediately feel -- yes, a smarter armrest. That's a good sign! During this purest rest-up, you osmose the max-sleep examples, and even the smartest mattress would only have given smatters of what your subconscious soaks up via from-cot comfort. You lose fatigue and even a potential ague fit. 'Real day already?' you remark. 'Up, coder! Produce!'"
trim socks	ROM sticks	true	636341092	--	"rom sticks"	"romsticks/romstick" or "rom stick/sticks"	--	post-rom-sticks rule	"The socks unravel and re-ravel into a pair of ROM sticks that [if robot is reflexed]the [robot] takes after whizzing out from under the Labs Slab. In they go to Drive A, bfore your mechanical friend returns to its sleep under the slab. Your work will go faster now[else]will surely fit into the right place when you need them to[end if]."
escaroles	casserole	false	682843772	--	"casserole"	"casserole"	--	--	"The escaroles become a much more calorie-infused casserole. Not your sort of casserole, but more active gourmand types might gobble it down."
trim socks	ROM sticks	true	540067126	--	"rom stick"	"romstick" or "rom stick"	--	--	"The socks unravel and re-ravel into a pair of ROM sticks that will surely fit into the computer when you need them to."
BUB DUDE EGG	BUB DUDE EGG	false	304959612	--	"debug"	"debug"	pre-bub-dude-egg rule	post-bub-dude-egg rule	"[if player has rom sticks]It's a long task, so you figure the memory from those ROM sticks will speed things up. [run paragraph on][end if]'Features ... use after...' you say after some initial setting testing on your Do-Rite Editor and Repro Roper. 'Be rugged, debugger! Sweat for software. Stow fear. Go, black backlog. Can't rig tracing... my bug, by gum. DIE, BUG! I DEBUG!' You sow faster softwares[if TBA key is reflexive], despite not realizing what the [b]TBA[r] key should have been and thus needing to use the space bar to organize your code[end if]. You note freeways['] fees awry--for a few years. You find bad asset databases conflating the apparently competing CropCorp, ProcCorp and PorcCorp--and the JetCorp Project--all to E-Viral Computing. The longest sent-log of an imperial email rip. It's just flagrant, but then, you remember how Elvira established code reviews as too boring--'Test log? Get lost!'[paragraph break]'On, self! F'n lose, Felons!' you say. 'Redo, doer!' But you slip. The screen flashes an alarm. 'ION RIG ORIGIN located!' The golden dongle's cover fries, taking the mug with it and revealing a plain old [b]USB[r]. You need a way out!" [bold-ok]
drive a	drive a	false	388504485	--	"avider"	"avider"	--	post-drive-flip rule	"Drive A coughs and whirrs a bit before humming a bit louder. You see the status on the side change from [b]VARIED[r] to [b]AVIDER[r]. Yay! It should work faster now."
drive e	drive e	false	514122776	--	"derive"	"derive"	--	post-drive-flip rule	"You inspect Drive E and, with some educated guesswork, figure why it is out of whack. A few common-sense steps later, it's fixed."
USB	USB	false	219798678	Strip of Profits	"sub"	"sub/bus"	--	--	"[sub-bus]!"

this is the post-hump-umph rule:
	if Leo is in Grey Gyre:
		process the Leo-Rand lackey rule;

this is the post-tsar-star rule:
	now player wears tsar star;
	now tsar star is not boring; [??]

this is the pre-plebe-bleep rule:
	if player is not wearing tsar star:
		say "You try and cuss, but the plebe is not intimidated by your civilian clothes[if Rand is in Grey Gyre] or even your companions[end if]. Perhaps you need something proclaiming your authority.";
		preef plebe;
		do nothing instead;

this is the pre-boing-bingo rule:
	if player does not have the PG on up popgun and popgun is touchable:
		say "(taking the popgun first while you mess with the boing-go bin)[paragraph break]";
		now player has popgun;

this is the post-boing-bingo rule:
	set the pronoun it to popgun;

to say gun-load-if:
	if gun-load-tried is false:
		say "But now, to load it";
	else:
		say "You realize you can load the dart into the popgun now, so you do";
		now dart is in the popgun;

this is the post-leo-ole rule:
	now Rand is in Dirge Ridge;
	now Leo is washed up;

this is the post-rand-darn rule:
	set the pronoun him to Rand;
	set the pronoun them to wzup;
	move wzup to Dirge Ridge;
	now Rand is washed up;

this is the post-wzup rule:
	now Leo is eager;
	now Rand is eager;

to say pooh-phooey-actions:
	if the player's command includes "phooey":
		min-and-q;
		now phooeyed is true;
	else if the player's command includes "pooh":
		poss-d;
	else:
		say "(BUG: you somehow found a third option you shouldn't have when getting Ye Hoop) "

to say get-earring:
	if the player's command includes "pooh":
		say "You convince yourself reaching the hoop can't be that bad. You jump up, and you grab it! It falls from the wall, shrinking in the process into a quivering, smaller hoop. An angrier earring. Wow! Maybe you didn't get full style points, but you got what you needed";
	else:
		say "You decide to give up, but then you think, heck, why can't I drop my items for a minute? Why can't I jump off the wall and risk annoying some ancient spirit? You do so, and you grab the hoop! It falls from the wall, shrinking into an angrier earring. Wow";
	say "[if leo is touchable]! [l-n-r] applaud your agility[end if]![paragraph break]The angrier earring quivers as you pick it up. You think of various epithets it might anagram to, but you can't find any. Maybe you should save it for later";

this is the pre-mazeltov rule:
	if cur-score of presto < 3:
		say "You're not messing around! You see the best way to destroy the maze, and you're going for it.[line break]";
	else if Nowt Town is unvisited:
		say "No point actually going through the maze when you can destroy it.[line break]";
	if player is not in Grey Gyre:
		say "You figure it would be a very good idea to move out of the maze before saying that, in case you wind up vanishing along with the maze. So you head back outside as you came. This thinking ahead will be one more thing to congratulate yourself about, at any rate.";
		move player to Grey Gyre, without printing a room description;
	min-and-q; [ this puts you at 2 for the maze, not counting the carry out fliptoing point ]
	if Tom Avlez is off-stage and Zo Mavelt is not cscanned and Zo Mavelt is not ncscanned:
		min-and-q; [ this puts you at 3 for the maze, not counting the carry out fliptoing point ]
	else:
		poss-d;

this is the post-nowt-town-wont rule:
	if player is not in grey gyre:
		say "You figure it would be a very good idea to move out of Nowt Town before saying that, in case you wind up vanishing along with the maze. So you head back outside as you came. This thinking ahead will be one more thing to congratulate yourself about, at any rate.";
		move player to Grey Gyre, without printing a room description;
	poss-d;
	if mazeguide-scanned is false, poss-d;
	now maze-points is 1;
	destroy-nowt-town;

to say wont-maze:
	if nowt town is unvisited:
		say "When you say [b]WON'T[r], you mean [b]WON'T[r]! You won't even go in that awful maze.[line break]";
	if cur-score of presto is 1:
		say "[if nowt town is unvisited or player was not in grey gyre]Also, why[else]Why[end if] not take care of the big things first? And what better way to start than with an emphatic word? You remember when younger how you could say [b]WON'T[r]. And it works, here, too. The maze dissolved, leaving an ether to the north"; [bold-ok]
		continue the action;
	say "While it's not quite formally an interjection, you remember how many interjections are bowdlerizations or shortenings of other word phrases. It's worth a try. The Internet itself has been responsible for a lot more sensible interjections than that. So, you yell, '[b]WON'T[r]!' The maze melts and collapses, but not before you escape back to the south."; [bold-ok]
	say "[line break]Perhaps you won't get full style points, but so what? It feels good to dispel a maze with one short word"

this is the post-mazeltov rule:
	now maze-points is 2;
	if mazeguide-scanned is false, increment maze-points;
	destroy-nowt-town;

this is the pre-ether-there rule:
	if Leo is not in Grey Gyre:
		say "You suspect someone is in the mist where the maze was. '[b]THERE[r]!' you yell. But you doubt you fooled or intimidated them. You need backup.";
		preef ether;
		do nothing instead;
	if player does not have popgun or popgun does not contain dart:
		say "[one of][l-n-r] charge in. It's two-on-three, though, since [why-2-3]--and the enemies are bigger than you. 'Ha, bums! Ambush!' you hear, before taking a thumping.[paragraph break]You all walk back, slightly beaten up, muttering 'Ah, ow, whoa.' [l-n-r] shake off their bruises. Perhaps if you were a more effective fighter, you could help them win. You're not going to get buffer, so you probably need [if player does not have popgun]a weapon[else]to load that popgun[end if][or][b]THERE[r], you think, realizing you're not [if player has popgun]effectively [end if]armed yet[if player has popgun and boing go bin is reflexive]. You need to fix the popgun[end if][stopping].";
		preef ether;
		do nothing instead;

this is the post-ether-there rule:
	now dart is in Grey Gyre;
	moot dart;

this is the post-hogs-or-keys rule:
	moot lawl wall;
	moot hogs;
	moot keys;
	move harpings phrasing to Saps Pass;
	move mutism summit to Saps Pass;
	say "You unlock the lawl-wall with the keys that fell from it, and suddenly you see the funny side of your journey so far. The wall and keys crumble. The hogs slink off in despair at a job failed.[paragraph break]You give a 'PHT!' as the area suddenly becomes brighter...[paragraph break][b]Phat Path[r][line break]";

this is the pre-hogs-not-keys rule:
	now hogs-not-keys is true;

this is the pre-harpings-flip rule:
	if Leo is in Dirge Ridge, say "You mumble other words to shoo [l-n-r], but you sort of miss them. It was more fun than you realized at the time. Maybe [if yak is not moot]you can get them to provide some muscle[else]they could have helped push the skid, but they did enough[end if]." instead;

this is the post-harpings-flip rule:
	remove noun from byebyes, if present;
	set the pronoun it to harpings phrasing;

to say increm:
	if the player's command includes "tough":
		say "You add an extra 'Hut! Go!' for emphasis.[paragraph break]";
	if rebuked is false:
		say "'But we ain't bored yet, boss!' You convince them they sort of are, what they are getting there, and it works a bit, without using any too-charged words. A bit more, and you'll veto their vote.[no line break]";
		now rebuked is true;
	else:
		say "'Us? Lot louts?' You manage to be firm but fair. You convince [l-n-r] that the computers inside may have viruses, and they understand.[paragraph break]'Real brave of ya, boss.'[paragraph break]'Dat was a good dust-up, wadn't it, boss? We'se sure glad we could helps ya. Tanks for makin['] us stuges feel like guests. You do good in da Sekret Sekter, now. Friend finder.' They go back to Dirge Ridge, muttering about workouts and high-powered workout food. 'Nyurgh! Hungry!' Perhaps if you need some extra muscle later, they could help you.[paragraph break]You look around a bit and see some starch charts on the mutism summit that you missed before. They can't be critical -- and yet, they seem to suggest a change from the interjections you've been using to a more esoteric final bit.[no line break]";
		pad-rec-q "Leo and Rand";
		now Leo is in Dirge Ridge;
		now Rand is in Dirge Ridge;
		now Leo is dismissed;
		now Rand is dismissed;
		now starch charts are in Saps Pass;

this is the pre-disk-skid rule:
	if disk is in drive a:
		say "The disk is where it needs to be, and the skid has served its purpose. Changing the disk back would also destroy your workstation.";
		the rule fails;

this is the post-disk-skid rule:
	if skid is off-stage:
		say "[line break]You make a note you can flip the disk back based on the lossless compression algorithm, etc., and how you don't need to know the deep math cold to be able to use it, or even remember the basics. You can just make it a [b]SKID[r], as long as it's physically possible.";
	move skid to location of player;

this is the pre-reboot rule:
	if player has keyboard and keyboard is not on slab:
		say "The keyboard isn't connected. This probably wouldn't be fatal, but why not do first things first?";
		preef be troo e robot instead;
	if keyboard is not touchable:
		say "You have nothing to type with, so it doesn't do much good.";
		preef be troo e robot instead;
	if disk is not in Drive A:
		say "It's risky to boot without a disk, like that [if disk is in Hacks Shack]disk right there[else]skid used to be[end if], in the disk drive. Much less reboot.";
		preef be troo e robot instead;
	if computer screen is not on slab:
		say "You wouldn't know if anything happened, since there's no screen on the table[if player has computer screen]. The one in your inventory should do[end if].";
		preef be troo e robot instead;
	set the pronoun it to computer screen;

this is the post-reboot rule:
	if rom sticks are touchable, moot rom sticks;
	now be troo e robot is scenery;
	move peels speel to Hacks Shack;

this is the post-censer-screen rule:
	if Hacks Shack is visited and player is not in Hacks Shack:
		say "That screen would go great with Drive A in the shack. So you go back there.";
		go-back Hacks Shack;
		now player has screen;

this is the pre-yak-keyboard rule:
	if yak-around:
		say "The yak emits an air of aggressive apathy. It's like the yak is foiling your attempts, or perhaps you wonder if the yoke might do something nasty to the yak when it changes.[paragraph break]Perhaps it would be an act of kindness to move the yak from bored to sleepy. A bedtime song or story or something.";
		now try-keyboard is true;
		preef bored yak;
		do nothing instead;

this is the post-yak-keyboard rule:
	moot leaf;

this is the pre-polemic-compile rule:
	if player is not in Hacks Shack:
		say "There is no computer around. You probably want to go back to the Hacks['] Shack for this.";
		preef Im Le Cop polemic instead;
	if keyboard is not touchable:
		say "Good idea, but tough to program without something to type on.";
		preef Im Le Cop polemic instead;
	if computer screen is not touchable:
		say "Good idea, but tough to program without something to read code off.";
		preef Im Le Cop polemic instead;
	if keyboard is not on slab:
		say "Good idea, but first, you probably want to put the keyboard on the slab. Do so now?";
		if the player regex-prompt-consents:
			now keyboard is on slab;
			say "Done. You can try to [b]COMPILE[r] again, now.";
		else:
			say "Ok, but by 'may want' I meant 'really probably need to.'";
		preef Im Le Cop polemic instead;
	if computer screen is not on slab:
		say "Good idea, but first, you may want to put the screen on the slab. Do so now?";
		if the player regex-prompt-consents:
			now computer screen is on slab;
			say "Done. You can try to [b]COMPILE[r] again, now.";
		else:
			say "Ok, but by 'may want' I meant 'really probably need to.'";
		preef Im Le Cop polemic instead;
	if disk is not in Drive A:
		say "A DISK, I'D ASK pops up. You realize that [if disk is moot]you can change the skid back, due to the lossless compression algorithm[else]the disk would fit fine[end if]."; [bold-ok]
		preef Im Le Cop polemic instead;
	if be troo e robot is reflexive:
		say "You get one of those annoying NEGLECT A CLEAN GET?! errors that proclaims this version so riven needs a raged-up upgrade with autolibs['] bailouts. The automatic installer is on nil-alerts. They'll need a manual un-maul. Perhaps you need to do something to reset the computer--a[if Drive A is examined]nother[end if] look at the drive might help.";
		preef Im Le Cop polemic instead;
	if caps lock is not part of the keyboard:
		say "[one of]You try but get EXCESSIVE UPPERCASE ERROR. Even converting the code in all upper case, you'd also have to refer to lower-case include files and so forth. You try other work-arounds, like the shift key, but the computer holds all the chips, somehow. (Sorry.) You must be close to a successful compile[or]You need to get rid of that uppercase to successfully compile your code[stopping]."; [bold-ok]
		preef Im Le Cop polemic instead;
	if peels speel is reflexive:
		say "[one of]You get a NEED IF-DEFINE error the first time you try to compile. That peels speel keeps popping up again.[paragraph break]'Up late, a letup,' you think restlessly and dreamily to yourself, 'Then fail the final!'[paragraph break]You're just too exhausted to put up with any more ... probably you just switched something or got something backwards[or]That stupid NEED IF-DEFINE and that peels speel, still[stopping].";
		preef Im Le Cop polemic instead;

this is the post-polemic-compile rule:
	now BUB DUDE EGG is part of the computer screen;
	if hawt thaw is in Saps Pass, poss-d;
	if lamb is in Grey Gyre, poss-d;
	if sport ports are reflexive, poss-d;
	if starch charts are in Saps Pass, poss-d;
	now im le cop polemic is realized;

this is the pre-peels-speel-sleep rule:
	if futon is not touchable:
		say "You haven't yet made anywhere comfortable to sleep.";
		preef peels speel;
		do nothing instead;
	if not cpuready:
		say "Sleep on the futon? Wouldn't be fun to. You've got a big coding session ahead, and you haven't fully prepared. yet.";
		preef peels speel;
		do nothing instead;

this is the post-rom-sticks rule:
	if be troo e robot is reflexed, moot rom sticks;

this is the pre-bub-dude-egg rule:
	if ALocalCo Cola is not moot:
		say "The process of debugging is going to take a while. You will need some sort of energy. That [if coal is touchable]coal won't cut it. Too early 20th century[else]ALocalCo Cola won't quite be enough for the task ahead, as-is. It seems crazy to say, but maybe there's a way to make more of it[end if].";
		preef BUB DUDE EGG;
		do nothing instead;

this is the post-bub-dude-egg rule:
	now USB is in Hacks Shack;
	moot golden dongle;
	moot mug;

this is the post-drive-flip rule:
	if usb is not off-stage, say "Well, flipping [noun] didn't help speed up your programming, but hooray for generally satisfying your curiosity!";

to say sub-bus:
	now issub is false;
	if the player's command includes "sub", now issub is true; [inform won't let me use "whether or not"]
	moot crust;
	say "You hear music by Verdi. '[if issub is true]Diver[else]Drive[end if] time!' intones the mechanical [if issub is true]sub[else]bus[end if] your [b]USB[r] turned into. Man, it really is universal. The [if issub is true]pilot[else]driver[end if] is...one of the nerds from the Esoteric Coteries way back in the metros! He welcomes you in. 'Navig-Gavin. Nice work.' / 'I know.' / 'Rec.' This SecuriCruise is not a Dire Ride (a ton...)' but you fall asleep before you can hear the rest. Wham, doer! Homeward";

section presto auxiliary

to say why-2-3:
	if player does not have popgun:
		say "you don't even have a weapon";
	else:
		say "your popgun is unloaded[if boing is reflexive] and broken[end if]";

book oyster

[because oyster is about verbs, it's tougher to have a one-to-one correspondence between points and lines in the anagram table.]

table of oyster anagrams
the-from	the-to	taked	hashkey	roomjump	right-word	right-cmd (topic)	pre-rule	post-rule	the-msg	pill-msg
tips pits	tips pits	false	325842789	--	"spit"	"spit"	a rule	a rule	"Saliva avails to show your disdain for the bar staff and for generosity in general. The pesty types, relieved to find someone seedier than themselves, look over quite menacingly, daring you to P.S. it."	text
gins sign	gins sign	false	242774022	--	"sing"	"sing"	--	--	"Your singing is abominable. But not as abominable as the lyrics or the 'melody' played in the bar right now. So customers only glare at you, but others order another beer because they're not as drunk as you, clearly." [not really covered in the default verb SING]
tunes	tunes	false	501203408	--	"unset"	"unset"	--	post-tunes-unset rule	"You fiddle with the knobs and such on the jukebox according to the instructions."
perma amper	perma amper	false	360858842	--	"remap"	"remap"	--	post-amper-remap rule	"You brave the electrical underpinnings of the perma-amper to create an ampish mishap."
tines	tines	false	441090447	--	"inset"	"inset" or "inset stein/tines"	--	--	"You place the stein in the tines. It disappears with a loud CRUNCH. The fish around look at you suspiciously, including one who just threw a stein against the wall."
capers recaps	capers recaps	false	412063240	--	"scrape"	"scrape"	--	--	"Skr-r-r-r. You give [i]Capers Recaps[r] a good scratch. The fish in the bar, including the trolls, all whip around. You're the only suspect, since you are the only one with anything resembling nails. Casper shoots you an inspired, snide rip. The pesty types glare at you for disturbing them, too."
trolls	trolls	false	466688042	Olde Lode	"stroll"	"stroll" or "stroll past/by trolls"	pre-trolls-stroll rule	post-trolls-stroll rule	"Well, you fake confidence as you walk past. It's all about being cool, but once out, you bolt this blot. As you run down Diver Drive, you hear the LOLstr trolls yelling 'The rests of youse ain't freeloading cheapskates like [him-her], are you? Buy up and drink up!'[if player has stein][stein-drop].[end if]"	"The pills scatter all over the bar, leaving everyone to slip and fall. You make a break."
clam	clam	false	139082395	--	"calm"	"calm"	--	post-calm-clam rule	"You try some odd combination of singing and storytelling and jokes which really shouldn't work at all, but then, clams aren't very smart, so it goes over okay. The clam ...(cl)ambulates...off. You notice what it was guarding so aggressively: a beautiful urn you feel pulled to and you can't walk away from!"	"The pills form a large maze with no dead ends. The clam goes after the bouncing pills and eats some, zigzags crazily, and runs himself tired tracking new ones down. Then, suddenly, it looks as if it's seen a ghost. It shrivels to a point with a sad deflating noise, then vanishes with a pop!"
urn	urn	false	259337118	Disease Seaside	"run"	"run"	--	--	"You speed away from the evil urn. You don't have time for riches right now! And while you don't feel you did anything heroic, you wind up at..."	"The urn, being possessed of greed, seems to suck in the pills, which cause it to shake. You run in a random direction as it explodes. Hm, run, urn. You could've figured that, but, well, time to move on."
sabot boats	sabot boats	false	294343284	Fighter Freight	"boast"	"boast" or "boast at/to boats"	pre-sabot-boats-boast rule	--	"You start yelling about how great you are and how you deserve a free ride. A beat-foil lifeboat (not shippish) passes you by, but eventually a Fighter Freight ('Her Gift') sees you, and they pick you up. Boaters like a boaster, and they hope your settler can provide soaky kayos. But when they ask to see how it can zap things--well, you become less welcome. Some scary crays chase you to the edge of the ship. You'll need a way out!"	"A boat pulls over as you spill the pills. 'If ye need a ride, come aboard! We'll collect yer coins...'[paragraph break]Before you can protest, you're aboard. You hear yelling as several of the fish realize the 'coins' are pills. They don't like freeloaders..."
pale plea	pale plea	false	265273725	Anger Range	"leap"	"leap" or "leap at plea" or "leap at pale plea"	--	--	"You're a bit scared to jump, but when it's a majestic leap--whee! You jump overboard, and nobody can really follow you, since the boat is moving away, and they don't want to be left behind. Even if they could swim better. Your super purse remains water-tight, so no possessions get soaked."	"Some of the crays are dumb enough to think that the pills might be coins. In the ensuing hubbub of arguments between smart fish and dumb fish, you jump over the edge and swim to shore."
oars	oars	false	258138164	Anger Range	"soar"	"soar"	pre-oars-soar rule	--	"The oars seem to have thrusters underneath. Physics! Technology! Energy conservation! In a burst of methane, the frat raft dances, and you ascend with a roar (as so,) landing just past the sabot boats, who throw up a cry of 'You sail lousy! Ai!' A second wind carries you to the other shore. As you stumble out of the raft, it drifts off, maybe to Rah-Bro Harbor. When you land, a fish growls, 'Weirdo. I rowed.'"	"The pills must've been energy pills, because they jump up and down and attach to the oars and create a reaction that blasts the frat raft into the air to the other side! With a bump, you tumble out and walk a bit..."
frat raft	frat raft	false	217136535	--	"fart"	"fart" or "fart on raft"	pre-raft-fart rule	--	"Channeling frat, uh, co-eds['] humor, you fail to keep your tush shut, thus. Your gust-guts cause the oars, of all things, to grow larger, as if they have gained the gas for propulsion.[paragraph break]It's kind of disgusting, but at least it's not wasteful!"
carps	carps	false	284257131	--	"scrap"	"scrap" or "scrap carps"	--	post-scrap-carps rule	"[spike-and-scrap]."	"[carp-pike-pill]."
pikes	pikes	false	403472058	--	"spike"	"spike" or "spike pikes"	--	post-spike-pikes rule	"[spike-and-scrap]."	"[carp-pike-pill]."
snarled darnels	snarled darnels	false	455342132	--	"slander"	"slander darnels/snarled" or "slander snarled darnels"	--	--	"You take some cheap shots at the darnels, pretending they're out to get you, and you feel clever. They're as forbidding as ever, but [if sausage is not moot]if you can't get angry somewhere like Anger Range, where can you[else]then again, at [anger range], everything should be perfectly tidy, and people should be upset when it isn't![end if]"
cans	cans	false	186374877	--	"scan"	"scan"	--	--	"You scan the cans, and at first they flash RRYR, as expected. Then you hear a rip in the fabric of reality. Apparently, you caused it by 1) not knowing what to do with the cans, so you scanned them and 2) knowing you needed to scan the cans. It's not very big, but between the logical paradox and infraviolet or ultra-red rays or whatever, the sludge in the cans (itself created through an abuse of quantum physics of infraviolet rays or whatever--hey, I'm a programmer, not a physicist) bursts into water and dirt. [paragraph break]If you get rid of Elvira, you'll see if you can replicate this. It'd make recycling pretty darned efficient. You feel more socially conscious, and less of a plain wordslinger, for having partially cleaned up the Hardest Trashed Dearths."
eeks	eeks	false	404819362	Lean Lane	"seek"	"seek"	--	post-seek-eeks rule	"You seek the source of the eeks. Your cryings scrying lead to a woman who must be Aunt Tuna. Weeps sweep as she puts nurse-runes on your trout friend's bruises. He points excitedly to you when he sees you. She bemoans the Same Ten Meanest and asks if you will help poor Tortu not get bullied. She has food for you. And, if you do a good job, the raw red drawer. You also notice some wipes on the drawer."	"The pills make a racket as they bounce around. A matronly tuna sticks her head out a window and yells IF YOU PLEASE. You notice your friend the trout behind her. He waves to you. The tuna shakes her head but invites you up."
dent	dent	false	320852724	--	"tend"	"tend dent" or "tend"	--	post-tend-dent rule	"You fiddle with the dent, joggling the [rew-war] drawer from side to side, then--wham! Something inside knocks the dent back out, and you can't see it in the drawer any more. Aunt Tuna is pleased, and Tortu is impressed."
tea	tea	false	233103945	--	"eat"	"eat"	--	post-eat-tea rule	"Gosh, tea, and you don't feel hostage[if aunt tuna is touchable] to manners or anything[end if]! Not just fringy frying! A dose of seafood (Not, like, fish. But what they eat. Tressed dessert.) A dish is had. Being fed is def! There's a whole crumpets spectrum in here, treats taster, all free of nitrate tainter! Muy yum! But while being a chompin['] champion, you bite half a paler pearl.[paragraph break][if aunt tuna is touchable]'Oh my goodness!' says Aunt Tuna. 'I am so sorry! I do not know how that got in there. You may keep it. I hope it is a decent apology for my being such a negligent hostess.' She [tee-details].[else]Well, you can't exactly go complaining to Aunt Tuna now for this, after making a mess in her place.[end if]"	"You spill the pills. 'That is some way to repay the nice meal I gave you! You will not get to see what is in that drawer and not just because you barely did anything for poor Tortu!' clucks Aunt Tuna. 'I will thank you to leave immediately.'[paragraph break]You do, but soon after, Tortu hands you a pack of Paw-R-Wrap bubble wrap[if tea is not moot] and something from the [tea], too--a paler pearl[end if]. 'Man! That's the funniest mad my aunt has been in a while! I guess she is nice and all but sometimes I sort of want to rebel and don't know how. Not too much. Anyway, once you left, she kept muttering how she wanted to get rid of this Paw-R-Wrap to somebody before I popped it. So I snuck it for you.'"
trout	trout	false	471002223	--	"tutor"	"tutor" or "tutor trout/tortu"	pre-tutor-trout rule	post-tutor-trout rule	"[trout-tut]."
wipes	wipes	true	458473653	--	"swipe"	"swipe"	--	--	"You swipe the wipes before Aunt Tuna notices. You can't see anything here that's dingy enough to use them--or use them the right way--on. Maybe something somewhere less well-kept."
bogus-trace	bogus-trace	false	337433333	--	"trace"	"trace"	--	--	"Based on where you got hit and how fast it hit you, you throw some grass up in the air or something, note how the wood landed, and figure where it came from! But you see no crates-caster. They'll probably chuck something at you when you're not looking, and you'll probably need to use your instincts. (P.S. don't worry, it's not a centaur either, so you can't untrace. You can't trace up and capture it either.)"	"The pills jump over to the debris and then off somewhere. You think they showed you where the throwing came from."
crate	crate	false	337433333	--	"react"	"react" or "react to crate"	pre-crate-react rule	--	"This time you're ready. You turn around and know when to look when the crate is about to hit you. You knock it down in mid-air and, in a fit of rage, fling it back into the tall weeds and hit the en-pris sniper. You hear an expression of anger, then scurrying. You won't need to recast the crates."	"The pills jump over to the debris and then swarm in the air like bees, causing your hidden tormentor to shriek and run away."
skis	skis	false	290473956	--	"kiss"	"kiss"	pre-kiss-skis rule	--	"As you kiss them, they pull up--and dissolve."	"The pills fly to the skis with a bizarre smooching noise. The skis dissolve, perhaps out of inanimate shame."
knob	knob	false	214612168	--	"bonk"	"bonk"	pre-bonk-knob rule	--	"[b]BONK[r]! You hit the knob just right. It falls from between the pans and rolls off...well, somewhere."	"The pills gravitate to the knob and turn it forcefully. It won't act up again."
span pans	span pans	false	248835251	--	"snap"	"snap"	pre-snap-span-pans rule	--	"You snap your fingers. Then, for good measure, you go off on a random tangent about something that doesn't really matter but has always bothered you. You're not sure which action worked, or if they both worked together, but the result's what counts: the pans detach and clank and fall over and melt into the ground."	"The pills bounce up and down between the pans, which begin to vibrate and then shatter. Your way inside is now clear!"
bogus-plains	bogus-plains	false	347641936	--	"splain"	"splain"	--	--	"[if span pans are moot]You brag, to nobody and everyone in particular, how you SHOWED those pans[else if bonkies is true and crate is reflexive]You yell to whoever's throwing those crates, you'll figure them out[else]You explain to the span pans how you'll get by anyway. It's short on detail, but it sounds impressive[end if]. You feel better after this, now you bragged a bit."
paw r wrap	ruby	false	276912353	--	"warp"	"warp"	pre-warp-wrap rule	post-warp-wrap rule	"You warp the Paw-R-Wrap around, and it pops as it reaches its breaking point. Most sardines despise aridness but this sardine hates noise. He runs off, probably to some read-ins.[paragraph break]It's pretty exciting you can go north now and all, but it's even more exciting to find something valuable inside the remains of the wrap: a ruby!"	"'Man! That might just be the cure for my ears!' The sardine grabs the pills as the first one falls, and in a brief melee, the Paw-R-Wrap falls. He flees, and as you run after him, you step on the Paw-R-Wrap, causing it to tear and pop.[paragraph break]You ruined the Paw-R-Wrap, but you do notice a ruby inside. It seems valuable. So you take it."
Achers Chaser Arches	Achers Chaser Arches	false	367879580	--	"search"	"search"	pre-search-arches rule	post-search-arches rule	"'Reach, acher,' you say, stretching a bit more to find something interesting."	"The pills bounce over by the arches. You try to grab them back but wind up grabbing a hidden pearl by mistake."
ol trap	pol art portal	false	400254014	--	"patrol"	"patrol"	pre-patrol-ol-trap rule	post-patrol-ol-trap rule	"You realize you need a sort of minesweeper, so you sneak back to the Rascal Craals and get the rigged digger. You zigzag meticulously back and forth searching for a switch to change the ol['] trap into something safer. You hear a sound of slid lids from the ground--and the ol['] trap springs and cannibalizes the rigged digger. Well, you had nothing to re-dig, G.[paragraph break]As the ol['] trap vanishes, a pol-art portal appears in its place. Some of the political art is very bad indeed, but hey, you've got somewhere new to go."	"The pills thump all over the floor, but you notice one segment sounds hollow. You go over, look under and--voil! You are able to defuse the ol['] trap with a switch. Alas, the pills are too scattered to replace. Some kind of spilled into the floor too, but yeah, the five second rule, anyway."
tubs	tubs	false	322908696	--	"bust"	"bust"	--	post-bust-tubs rule	"As if you've a tub tabu, you expend BTUs as you bust the tubs, eliminating any buts about your strength. Inside the broken tubs, you'd think there'd be a shovel, but it's a corroded decor rod--nah, it's more of a prod, really.[paragraph break]Waste also now lies where the tubs were. You probably don't need to clean it up unless you want to be an extra-good citizen. That prod is puzzling, though. It looks like it could fold out, if you poke it right."	"You spill the pills and slip on them, because no bathmat is around. In the process, you smack your elbow against the tubs. Right on the funny bone. You find it so unfunny you beat the tubs into waste. Which might be hiding more than just that prod you found inside."
prod	digger	true	262171428	--	"drop"	"drop"	--	--	"The prod rattles as you drop it. You try every which way. Heavy end first, light end first, sideways, at an angle--then POW! It opens like an umbrella. It's a properly rigged digger, now, no longer just a prod."	"You spill the pills, which bounce around at your legs until you're annoyed enough to start hitting at them with the prod. Foomp! A hidden switch triggers, and the prod transforms to a rigged digger."
waste	waste	false	437312684	--	"sweat"	"sweat"	--	post-sweat-waste rule	"You make real effort to spruce up the waste. Maybe something nice will be buried in it. There is! As you pile the waste into heaps, you find a very dirty lance. Too dirty to take at the moment. Maybe you can clean it up, though."	"The pills perform a disturbing chemical reaction with the waste, dissolving to leave a dirty lance."
lance	lance	true	271720859	--	"clean"	"clean"	pre-clean-lance rule	post-clean-lance rule	"The lance becomes much less grungy as you swipe the wipes across it. You can actually pick it up, now. So you do. But it's obviously a very righteous lance. Only to be used against an enemy of great annoyance. It won't help against multiple opponents, either, but at least it is collapsible, so it fits easily in your purse.[paragraph break]The wipes biodegraded kind of nastily in the process, but that is one less thing to carry."	"The pills stick to the lance, making it so gross you feel compelled to [b]CLEAN[r] the lance, finally. Turns out it's the retractable sort, which is handy for carrying until you need to use it."
heaps	heaps	false	345016151	--	"shape"	"shape"	--	--	"You channel your inner artist and make something beautiful out of the heaps."	"The pills you spill on the heaps cause a bizarre chemical reaction. You don't feel poisoned, so it can't be too dangerous. You think."
ruby	thin hint	false	331207767	--	"bury"	"bury" or "bury ruby"	pre-bury-ruby rule	--	"You bury the ruby with your handy rigged digger. Good thing there aren't rubies. You'd be busier. Probably give yourself a bruise. You leave a thin hint so you know where to dig the ruby up, when you need to."	"The pills swarm your ruby so you drop it. They sink into the dirt, the ruby close behind. The dirt fills, leaving a thin hint."
HUNTER HUNT AREA	sausage	false	529723362	--	"unearth"	"unearth" or "unearth haunter"	pre-unearth-haunter rule	post-unearth-haunter rule	"A haunter's underneath--[']n unearthed! You're almost unhearted. Your destruction of [the HUNTER HUNT AREA] has brought up ... a weird sausage! You scry a cry as scary: 'My lost ruby!'[paragraph break]After it whines on for a bit, you realize you are not dealing with any old sausage, but a hard-done-by [uss]. It will moan and carry on until satisfied."	"The pills slip into [the HUNTER HUNT AREA], flaring it up. The ground looks extra soft, and you look to see what you can--what's the word? [b]UNEARTH[r]. It's a big weird undead sausage! The sausage cries for its lost ruby! It moans about the horrid things it's seen and endured. It must be a [uss]."
sausage	sausage	false	462435186	--	"assuage"	"assuage"	--	--	"'How sad, shadow,' you explain, and you think you might know where someone hid its jewels. You....well, saw and heard stuff. It nods. Makes sense. the Horned Hedron is full of no-good-niks. The [sausage] waits on your next move."	"The [sausage] reaches out to grab the pills, hoping they might ease its pain. But they pass through its fingers. Crushing! The [sausage] shakes its head sadly, but then shrugs. It knows you tried, and it seems to trust you more now."
gleaner	gleaner	false	498444888	--	"enlarge"	"enlarge"	--	post-enlarge-gleaner rule	"Rustle. Result: luster! After some intercut tincture, the gleaner is bigger and clearer."	"You absent-mindedly shake the pills out. Some bounce off the general gleaner, which swells oddly, and as you look for cracks or damage, you see a pattern within. A way through a maze."
papery yapper	papery yapper	false	500608900	--	"prepay"	"prepay" or "prepay papery/yapper" or "prepay papery yapper"	--	post-yapper-prepay rule	"'Oh! Prepaying is totally different from a bribe. I'm sure I can prepay a judge myself to verify that.' The yapper motions you to slip the gleaner stealthily, like so, before going off to find a prepayable judge. Presumably.[paragraph break]Behind the yapper is a cool looking lever. You're not sure it does anything, but man, it's neat to see!"	"The yapper begins bellyaching about picking up the pills, complaining we all know WHOSE job it is to clean things up, before running off to look for a wastebasket--though one of the pills seemed to go in the yapper's mouth."
lever	lever	false	501914680	--	"revel"	"revel"	--	--	"Yeah. Why not feel good about yourself before figuring everything out? You know, run up the score a bit. You've earned it."
templar ramplet	templar ramplet	false	517782699	Plasm Lamps	"trample"	"trample"	pre-trample-ramplet rule	post-trample-ramplet rule	"You give a bit of a run-up, then make a big show of walking noisily down the templar ramplet. It works! You tumble out in..."
natant ant	natant ant	false	174205344	Tenfold Teflond Den Loft	"tan"	"tan" or "tan ant"	--	post-tan-ant rule	"Whack! Pow! 'Scum ant! Sanctum?! Can...must...must tan mutants!' After your glancing clanging, the lance turns into a red-hot hate rod and breaks in the process as the ant runs away. You completed a mini-SOS mission!"	"With the pills dropping around, the ant is distracted, and your wild hacks with the lance easily chase it. But your lance breaks and evaporates in the process. Well, it was kind of bulky, anyway."
bogus-psalm	bogus-psalm	false	297816735	--	"psalm"	"psalm"	--	--	"Having boarded the Templar Ramplet loudly, you take some time for piety before getting back to the natant ant. Have a bonus point!"
pins	pins	false	291640279	--	"spin"	"spin" or "spin pins"	--	post-spin-pins rule	"You fiddle with the pins, and after a bit of shifting back and forth, you hear a promising click. The dialer begins to hum again."	"The pills get caught up in the dialer, and they hook on the pins. Just the right chemical reaction dissolves the pins, and the dialer is operational again."
bogus-derail	bogus-derail	false	335153504	--	"derail"	"derail" or "derail dialer"	pre-dialer-derail rule	post-dialer-derail rule	"You hear a buzzer re-buzz. 'Goal: Vet Voltage!' Then a pause. Then Elvira's voice.[paragraph break]'HEY! Oh! It's the boys from the Horned Hedron! Another one of your pranks? Ha ha ha!'[paragraph break]Then her voice turns less saccharine. 'Not one of your best. So don't repeat it. I could send you more...supplies...now, I'll pretend this didn't happen!' As her voice crackles off, pins spring up to shield the dialer from further operation, and the dialer quits humming. It doesn't look broken, but you guess you'll need to do something about those pins."	"You spill the pills on the dialer, and they change [b]DIALER[r] to enough of the 720 possibilities that they settle on [b]DERAIL[r]."
bogus-redial	bogus-redial	false	335153504	Strip of Profits	"redial"	"redial" or "redial dialer"	pre-dialer-redial rule	post-dialer-redial rule	"Beep boop, etc. A charge zaps from the dialer. Then, you hear Elvira screeching, 'WHAT?! HOW DARE YOU! I WILL SEND A CHARGE BACK THROUGH THAT YOU WON'T BELIEVE!' A few sirens blare. 'Relays slayer activated.' booms a voice. A noise like an enraged angered grenade. An arson sonar. 'Intruder! Run!' / 'Tired...' you think."	"You spill the pills and hook yourself on the dialer trying to catch them. You wind up REDIALing, and all sorts of hubbub ensues as Elvira's voice crackles, and she accuses the Horned Hedron's leaders of double crossing her, and the Horned Hedron's leaders accuse her. It's great fun to eavesdrop. But you figure you'd better get going before the Horned Hedron crumbles." [bold-ok]

to say hha: say "[b][hunt area][r]";

to say uss: say "[b]USE-SAGA SAUSAGE[r]"; [bold-ok]

this is the post-tunes-unset rule:
	say "The perma-amper makes a pop and sparks and flames out. The music warps and slows down--everyone glares at you, even the fish who were just complaining about the lousy music here. You're nearest the jukebox, so you're the prime suspect.";
	moot perma amper;
	moot tunes;

this is the post-amper-remap rule:
	now remapped is true;
	process the post-tunes-unset rule;

this is the pre-trolls-stroll rule:
	if silly-acts >= 3, continue the action;
	say "The LOLstr trolls [if silly-acts is 0]seem concerned you haven't had any fun at all. You try to argue with them, but it's hopeless. They claim, bored, they're just the messenger as they escort you back inside[gloaty][else if silly-acts is 1]seem concerned you have been kind of obnoxious, and what better way to make up for that than to order a little something, to get on management's good side, now[gloaty][else if silly-acts is 2]make you feel like you're the jerk here and maybe you can spend some money to make up for the nuisance you caused[gloaty].[paragraph break]Maybe one more disruption, and you won't be worth bothering with[end if].";
	preef lolstr trolls;
	the rule succeeds;

this is the post-trolls-stroll rule:
	if flip-spill-flag is true:
		decrease poss-score of oyster by (4 - cur-score of oyster); [a bit odd, but we already increased the score by 1 for STROLL TROLLS or its replacement]

to say stein-drop:
	if player has stein:
		say "[paragraph break]Oh, as you leave, you drop and break the stein. Tiens";
		moot stein;

this is the post-calm-clam rule:
	now urn is in Olde Lode;
	set the pronoun it to urn;

this is the pre-sabot-boats-boast rule:
	if frat raft is reflexed:
		say "You're a bit too winded to make a really good boast after your recent exertions, so it isn't your best, but...";
		decrement cur-score of mrlp; [ otherwise you get 2 points for leaving the shore instead of 1 ]
	now frat raft is unfigured;

this is the pre-oars-soar rule:
	if raft is not reflexed, say "The oars have no gas, or whatever they might run on[if player is not on raft]. Plus you're not on the raft anyway[end if]." instead;
	if player is not on raft, say "That'd leave the raft behind you. Get on it first." instead;

this is the pre-raft-fart rule:
	if player is not on raft and raft is reflexive:
		say "Like a butterfly's wings in China, your fart causes the frat raft to waver. Maybe if you got on the raft, something more would happen.";
		preef frat raft;
		the rule succeeds;

this is the post-scrap-carps rule:
	now trout is in Lean Lane;
	moot carps;
	moot pikes;
	now HUNTER HUNT AREA is in Anger Range;

to say spike-and-scrap:
	say "'Err, boys? Be sorry.' After the rotters['] retorts, you start a scrap and spike the carps and pikes into a nearby wall. A few cuffs and they scuff, spout pouts and become tense teens. You lash out 'Ha, louts!' then 'Scoot, coots! Scat, cats! Cower, o crew!' for emphasis. 'Shlep-helps from a Pedo-dope! [if player is male]He's[else]She...[end if] a loss.' one yells back, seeing you comforting the trout.[paragraph break]The little trout, bruised, gives a side rub and looks up gratefully. 'My aunt Tuna will be proud of me! Or you! C'mon. I'll set a seat! Tea's east!' He runs that way.[paragraph break]Done fighting, you notice a scrawl crawls across the ground. It says [HUNTER HUNT AREA]. You feel angry for taking so long to see this. Maybe there is some other angry force around the Anger Range. You even think you hear something"

to say carp-pike-pill: say "The carps and pikes, distracted by the pills that fall out and keep jumping, ignore the trout. 'You stupid! Those pills are valuable. Out of our way, mouth-breather.' The range anger wells up in you"

this is the post-spike-pikes rule:
	now spikes is true;
	process the post-scrap-carps rule;

this is the post-seek-eeks rule:
	now Hardest Trashed Dearths is shunned;
	now Anger Range is mapped west of Lean Lane;
	now Lean Lane is mapped east of Anger Range;
	if cans are in Hardest Trashed Dearths, poss-d;

this is the post-tend-dent rule:
	set the pronoun it to raw red drawer;

this is the post-eat-tea rule:
	if flip-spill-flag is true:
		if dent is not moot, poss-d; [can't fix dent again]
		if wipes are in Lean Lane, decrease poss-score of oyster by 4; [swipe sweat clean shape (not part of the quest but not doable without it) tan]
		now player has Paw R Wrap;
		now aunt-tuna-cross is true;
		move player to Anger Range;
	pearl-check;

this is the pre-tutor-trout rule:
	if player is in Anger Range:
		say "You probably can't help the trout until they're off his case, but they wouldn't be on his case if he had tutoring in fighting earlier. Catch-22. At least, here. Also, the poor trout's probably getting beaten up for learning in the first place.";
		preef trout;
		do nothing instead;

this is the post-tutor-trout rule:
	now player has Paw R Wrap;

to say trout-tut:
	say "How to start... 'Branded nerd? Bad. Karate? A taker?' You show the trout how to paste a pest with some slick licks. As tutorer, you show him how to avoid the rote rut of torture. Most of what you say is a po['] combat boot camp, but he gives a trouty tryout, as a monkish moshnik with frail flair, and you give a kind dink to boost his confidence. Aunt Tuna clucks that she TOLD him that, and if he'd listened to HER when SHE said it instead of having a ton-not-fair fair--but it's as pleased as she's been in a while![paragraph break]"; [bold-ok]
	say "She explains someone deserves a reward. He's all 'A donut, Aunt! Do!' but she says diabetes is not the best idea. Not even a tater treat. But she hands you Paw R Wrap wrap--a present from someone named Valeri, who used to be so nice but never shows up any more[if tea at a tee is touchable]--and also jerks her head towards the [tee][end if].[paragraph break]You doubt Aunt Tuna has anything else for you[if wipes are reflexive], though maybe you could sneak the wipes[end if][if dent is touchable]. Maybe you could fix the dent[end if]. But you should probably explore elsewhere";

this is the pre-crate-react rule:
	if bogus-trace is in Lapsin Plains:
		say "That's a good idea, but you're not sure HOW to react. You need a bit of data, first.";
		preef crate;
		the rule succeeds;

this is the pre-kiss-skis rule:
	if bogus-trace is in Lapsin Plains:
		say "[one of]That feels right, but as you reach to do so, you feel something on the back of your head, then a splintering noise. You see a bunch of wood fragments behind you. You're not sure how you survived without feeling dizzy, but someone's out to get you. You'll need to get rid of distractions before doing that again[or]You don't need to be hit with another crate[stopping].";
		preef skis;
		now bonkies is true;
		the rule succeeds;
	if crate is reflexive:
		if bonkies is false:
			say "You flinch, a second too late, from a crate thrown at you. You can trace the crate, but you can't -- use your reflexes. You need to do that first.";
		else:
			say "You would, but you would probably get hit with the crate. You need to anticipate, somehow. Trace was the first step with the crate, but there's one more...";
		preef skis;
		now bonkies is true;
		the rule succeeds;

this is the pre-bonk-knob rule:
	abide by the pre-kiss-skis rule;

this is the pre-snap-span-pans rule:
	if crate is reflexive:
		say "You hear a crate crash nearby. You can't snap just RIGHT, though you must be on the right track.";
		preef span pans;
		the rule succeeds;
	if knob is in Lapsin Plains or skis are in Lapsin Plains:
		say "The pans rumble a bit but are held together by the [pan-block]. You'll need to unblock the pans for that to work.";
		preef span pans;
		the rule succeeds;

this is the pre-warp-wrap rule:
	now warp-try is true;
	if Aunt Tuna is touchable:
		say "'Goodness me!' cries Aunt Tuna. 'I do not approve of such hooliganism! Paw R Wrap has less devious uses! I am almost sorry I gave it to you! You ought to be sent from THIS nest for that noise!'[paragraph break]Like all good bubble wrap, maybe the Paw-R-Wrap needs to be saved [']til you find the right person to annoy.";
		preef ruby;
		do nothing instead;
	if player is not in Sclerous Closures:
		say "That would be fun but useless here. Perhaps you could annoy someone with it. Someone worth getting rid of.";
		preef ruby;
		do nothing instead;

this is the post-warp-wrap rule:
	moot sandier sardine;

this is the pre-search-arches rule:
	if sardine is touchable:
		say "A snider near-dis from the sardine keeps you in check. You'll need to get rid of it to have a serious look.";
		preef Achers Chaser Arches;
		do nothing instead;

this is the post-search-arches rule:
	pearl-check;
	now Achers Chaser Arches are realized;

this is the pre-patrol-ol-trap rule:
	if walleyes are not moot:
		say "Now there's a good plan. But right now, that gang of walleyes might rough you up. You need a way to get the gang to vacate these premises.";
		preef ol trap;
		do nothing instead;

this is the post-patrol-ol-trap rule:
	moot rigged digger; [this could be in the "before" rules to save time, but if I slip a condition in ... it might vanish the digger.]

this is the post-bust-tubs rule:
	now waste is in Shuttle Hutlets;
	now player has prod;
	set the pronoun it to prod;

this is the post-sweat-waste rule:
	now heaps are in Shuttle Hutlets;
	set the pronoun them to heaps;
	moot waste;
	now lance is in Shuttle Hutlets;

this is the pre-clean-lance rule:
	if player does not have wipes:
		say "Good idea, but you have nothing that could clean the lance effectively.";
		preef lance;
		do nothing instead;

this is the post-clean-lance rule:
	moot wipes;

this is the pre-bury-ruby rule:
	if player does not have rigged digger:
		if player has prod, say "Your prod from the Shuttle Hutlets should be able to bury stuff if you tinker right. Jar it the right way." instead;
		say "Nothing to bury anything with. Well, there's your fingers, but that'd take too long[one of][or][if Lapsin Plains are unvisited]. Maybe you can explore north of Anger Range to find something[else if Shuttle Hutlets is unvisited]. Maybe there's something behind the span pans[else]. Maybe you missed something in a hut[end if][stopping]." instead;

this is the pre-unearth-haunter rule:
	if player has digger and ruby is moot, continue the action;
	if player does not have digger:
		say "Nothing to unearth a haunter with.";
		preef HUNTER HUNT AREA;
		do nothing instead;
	d "Unearthing Failed. Has digger = [whether or not player has digger], Ruby moot = [whether or not ruby is moot].";
	if sausage is not off-stage, say "You managed to unearth the haunter already." instead;
	say "Ravage a grave!";
	if ruby is off-stage:
		say "[line break]You scry a cry as scary... 'My...jewel...off...east...I...feel...don't...disturb...unless...'[paragraph break]You haven't found or discovered a jewel, yet.";
		preef HUNTER HUNT AREA;
		do nothing instead;
	if player has ruby:
		say "[line break]As you begin to dig, you hear 'My...jewel...close...thieves...pay.'[paragraph break]It wouldn't do to be caught (ruby-)red-handed. Maybe you can frame someone or some people-forms. People-forms who deserve SOMETHING pinned on them.";
		preef HUNTER HUNT AREA;
		do nothing instead;

this is the post-unearth-haunter rule:
	it-him-her sausage;
	move sausage to anger range;

this is the post-enlarge-gleaner rule:
	if gleaner is examined:
		say "[line break]You may wish to re-examine the gleaner now it's changed.";
		now gleaner is unexamined;

this is the post-yapper-prepay rule:
	moot gleaner;
	now lever is in Tenfold Teflond Den Loft;
	if wipes are moot:
		say "As the yapper runs away, you look around a bit more. Hey! There's a templar ramplet in back, too! It might lead to a fun side adventure. You never know.";
		move templar ramplet to Tenfold Teflond Den Loft;

this is the pre-trample-ramplet rule:
	if wipes are not moot:
		if player has lance:
			say "You'd think your lance would make you worthy of climbing the templar ramplet, but not in its current form. It's too dirty.";
		else:
			say "You do not have anything denoting you as worthy to trample the templar ramplet. [if aunt-tuna-cross is true and wipes are in lean lane]And you locked yourself out when you used the pills[else]If you want, you can look around, but it is optional[end if].";
		preef templar ramplet;
		the rule fails;

this is the post-trample-ramplet rule:
	min-up; [you get at least another point for TANing the ant]

this is the post-tan-ant rule:
	if bogus-psalm are reflexive:
		say "[line break]And yet... you feel you missed a style point. Perhaps the proper display before thwacking the ant, suitable to the locale.";
		poss-d;
	moot lance;
	now Plasm Lamps is shunned;

this is the post-spin-pins rule:
	now bogus-redial is in Tenfold Teflond Den Loft;

this is the pre-dialer-derail rule:
	if yapper is touchable:
		say "The yapper'd totally tell on you. Perhaps there is a reason the yapper hasn't told on you yet, and you could use that to ditch the yapper.";
		preef bogus-derail;
		do nothing instead;

this is the post-dialer-derail rule:
	now bogus-redial is in tenfold;
	now pins are in tenfold;

this is the pre-dialer-redial rule:
	if pins are touchable:
		say "Maybe in a bit, but the pins are in the way at the moment. They can't be too hard to get rid of.";
		preef bogus-redial;
		do nothing instead;

this is the post-dialer-redial rule:
	say "[line break]Luckily, you find an evac-cave that lets you out safely.You decide to beat feet to the Anger Range.[paragraph break]Casper Spacer himself shakes your hand. 'No hunter! On the run! None hurt!' He had gotten enough gritty writing from when the Horned Hedron still exerted its hold, but after a brief interview with you, now he has a story about--well, someone like you, with fewer faults, but more a tragic hero. He calls for his adventurer friend Red Gil. 'Get this hero[if player is female]ine[end if] a glider girdle!' You learn it easily. Casper is even more impressed. You fly back to the Strip of Profits."

section oyster auxiliary

[these are rules I didn't want to put in the table as it would be some repetition]

check fliptoing when player is in Posh Hops Shop: if noun is not trolls and silly-acts is 3, check-silly-death instead;

report fliptoing when player is in Posh Hops Shop:
	if noun is not trolls:
		annoy-trolls; [this also gives min-up]
		remove noun from shop-hint-items, if present;
	continue the action;

report fliptoing (this is the oyster min score annoying details rule): [??there may also be a problem where SCAMS interferes. I don't know.]
	if noun is trolls and flip-spill-flag is true and pills are not moot, min-up; [if you SPILL PILLS to ditch the trolls, you can't skip EAT below.]
	if noun is trout and flip-spill-flag is false and pills are not moot, min-up; [SPILL PILLS with trout untutored lets you skip EAT, but you can't now.]
	continue the action;

book towers

[note the trefoil rules are at the end of the table here because I don't want them clogging the start of the table. They're too random and bulky.]

table of towers anagrams
the-from	the-to	taked	hashkey	roomjump	right-word	right-cmd (topic)	pre-rule	post-rule	the-msg
recital article	recital article	false	436240018	--	"talcier"	"talcier"	a rule	a rule	"The recital article suddenly cracks a bit, then crumbles. [Rodney] looks over for a minute, disgusted he has been distracted. Oppression and intimidation are mentally and physically taxing. Especially for the oppressors and intimidators! Anyway, that's one less thing to clean up once you've dealt with Rodney."
dreads adders	dreads adders	false	353649874	--	"sadder"	"sadder"	--	--	"The adders suddenly become less aggressive. You wonder if they feel bad about all the other people they may've obstructed, as they slide harmlessly away."
bluster butlers	bluster butlers	false	589852447	--	"subtler"	"subtler"	--	--	"The butlers quiet down a bit. Then they sniff at you. No, you do not deserve to go west. But you're not really even good enough for their time at all! They mutter how they're more high class than this, and they should be guarding a mansion and not some silly ... well, they aren't even going to bother to tell you. They glide off in search of more gainful employment."
denier nereid	denier nereid	false	475865464	--	"reined"	"reined"	--	--	"The denier nereid feels an irresistible pull back to where she came. As she leaves, she calls out 'I can't stop you...' and, well, she can't."
snider diners	snider diners	false	444333321	--	"rinsed"	"rinsed"	--	--	"The diners['] dry wit and mood dampen as a water spray erupts from nowhere--and gets them! Their outdoor dining experience has been ruined. As they storm (ha) away, you reckon you managed to reseat the teaser-eaters, and you didn't even have to wait for Easter."
diverse deviser	diverse deviser	false	610396742	--	"revised"	"revised"	--	--	"Suddenly, a whirring! The red 'I'd Serve' text melts away, replaced by RAPIER REPAIR, as the now-revised deviser sighs 'Ah! I knew I had it in me the whole time, to be the best version of me I could be!' and then starts going full steam."
pirates	pirates	false	541160519	--	"pastier"	"pastier"	--	--	"You watch as their skin tones lighten a few shades. Even when they blush at their lost perceived virility, that doesn't make it back. Worse, they have no fake spray-tan in their suitcase. They curse and realize they've stayed far away from the coast too long, mumbling about a secret cove you won't find (trust me, you won't[if Actionless Coastlines is visited], even though you've been up there[else] even when you get up there[end if].) Well, except one who decides to become a priest."
fluster self rut	fluster self rut	false	597948438	--	"restful"	"restful"	--	--	"You relax. You stop letting the fluster-self rut bother you. You let it just be itself, or be, and let go how it may've frustrated you in the past. And what do you know? It narrows to a bright line, then winks out. You feel more self-confident."
realist tailers	realist tailers	false	513508399	--	"saltier"	"saltier"	--	--	"The realist tailers are pretty salty as-is, but apparently, you can never get too salty. Or can you? Apparently it's not enough to be attacking you and discouraging you from doing what you want. They start going after each other. And it gets pretty vicious! It seems so exhausting. You wonder why they bother. And after a while, they wonder why they are providing someone like you with such truth bombs for free. They can have their arguments around people who appreciate their realism"
promise imposer	promise imposer	false	574290413	--	"semipro"	"semipro" or "semi pro"	--	--	"The promise imposer looks thoughtful, then mentions some things don't add up. They realize Elvira hasn't followed through on some promises of their own. After thirty seconds of invective, it's unclear whether they want to go in for more certification or to complain to Elvira directly, but they decide they don't want to waste their life here. As they walk off, they shout at you not to go wandering off into trouble, because you're obviously a suspicious type. It actually freezes you for five seconds."
ingrates	ingrates	false	561201770	--	"angstier"	"angstier"	--	--	"The ingrates suddenly develops the mooniest emotions--why bother to stop you from doing whatever? After a final snit-rage about you not caring about their problems, they decide to go whine by themselves."
mardier admirer	mardier admirer	false	430738621	--	"married"	"married"	--	--	"Your admirer blinks, then looks down a ring on their finger, which may or may not have been there before (the ring, you silly.) They start talking of the old ball and chain, and while it's not clear whether the old ball and chain will help them be a better person, which is how it works in theory, or they are just someone to complain to, well ... the mardier admirer is done with you. Why were they wasting time? Such a leer--a sure lech! Your ex-admirer walks away, spouting spouse opuses."
resident trendies	resident trendies	false	675249448	--	"nerdiest"	"nerdiest"	--	--	"The resident trendies begin talking less smoothly. Then you hear a nasal laugh. And it is downhill from there. They look around nervously. They realize they are, well, over, and they walk off into the distance. Their last parting shot: you must obviously be the sort of backward person who can't appreciate cutting-edge games that require a fancy-shmancy graphics card."
organised ego drains	organised ego drains	false	553473418	--	"grandiose"	"grandiose"	--	--	"The ego-drains suddenly leave you with too absurd of a vision of self-pity. It becomes amusing, and you almost enjoy walking among them. This is too embarrassing for them, and they vanish, having had their own egos dented."
sweatier wait seer	sweatier wait seer	false	695435442	--	"weariest"	"weariest"	--	--	"The wait-seer blinks as if enlightened, followed by a head-shake and a nod in your direction. The wait-seer trudges off to find somewhere more scenic to meditate, or perhaps someone else to block and, eventually, enlighten."
Reeds Ale	Reeds Ale	false	642046842	--	"released"	"resealed/released"	--	post-reeds-ale rule	"[rscheck]You concentrate, and suddenly [el-la-full] [if rese is false]takes a deep breath. 'I've been fooling myself, haven't I? Territorial...materialistic...no more of this. Thank you!' [he-she-c] runs off[else]tries to take another pull from the Reed's Ale bottle, but it is suddenly stuck and won't open. 'I...I didn't need the stuff, anyway! I have better things to do!' [he-she-c] runs off. It's not clear whether those better things involve more deals or just stuff that's good for society, but whatever. You can pass, now[end if]."
alarming grailman	alarming grailman	false	354088487	--	"marginal"	"marginal"	--	--	"The grailman might still be able to block you, but he doesn't want to risk it. He seems to lose confidence visibly as you speak. Then he decides not to risk holding his ground any more."
bonker	bonker	false	427742080	--	"broken"	"broken"	--	post-bonker-broken rule	"'No! Kerb... er, bonk...' It starts wheezing and whirring and coughing and bleeping frantically, far more than such a simple machine really should. 'Failed--to--guard--threat--to--state--Dr.--Yow!' Then it explodes in a shower of rainbow sparks. But from the wreckage of the bonker rises ... a [b]STINGER[r]!"
stinger	stinger	false	559013952	--	"resting"	"resting"	--	post-stinger-resting rule	"The stinger whirs around, wheezes, then flops on the ground and rolls off. You wait a minute, wondering if something tougher than the stinger will appear. But you only hear a gander that has flown in, no longer scared by a bonker or stinger. The path east is clear now! "
natives site van	natives site van	false	550443085	--	"naivest"	"vainest" or "naivest"	--	--	"[vain-naiv]. Now that the natives have moved on, you can go south."
asset hit atheists	asset hit atheists	false	611037040	--	"hastiest"	"hastiest"	--	post-agnostic-blocker rule	"The atheists rattle off point after point as they just can't believe you won't agree with their stone cold logic. Emboldened, you suggest that, if this is all the time we have on this world, they really don't want to waste it on you. 'Yeah!' they say. 'You're right! You probably don't even capitalize Atheist! You bum.' They run off for someone else to harass."
lois the hostile	lois the hostile	false	537631654	--	"holiest"	"holiest"	--	post-agnostic-blocker rule	"Lois the Hostile pauses a minute and considers. 'No. That can't be right. But that'd mean THAT, too--and. Whoah. I really do need to change things. I, uh, I've clearly listened to Elvira too much.' She nods at you. 'I bet you helped. I'm not sure how, but thank you.' Then she runs off into the Thearchy Hatchery to start penance."
the Hostile is He Lot	Hostile is He Lot	false	537631654	--	"holiest"	"holiest"	--	post-agnostic-blocker rule	"The lot shake their heads. Perhaps, instead of an ol['] heist, they can realize they do not belong in the Hatchery. But what if they are realizing they don't belong in order to sneak in the back way? A spirited discussion ensues, until one poor fellow who sobbingly admits he is confused and unworthy wanders away--and the Hatchery opens for him![wfak][paragraph break]Then the next one realizes how awful he's been, then the next. The last one, looking back, wishes the unconditional best for your deity of choice, who probably should exist if he/she/it doesn't already." [end of guardians.]
try us yurts	brownies	true	512172846	--	"rusty"	"rusty"	--	--	"The yurts quickly tarnish and crumble. Behind them, you see and take some 'nutrition' as cheap as the yurts that held it: Owers[']-Bin Brownies! The snack of choice for people who prefer quantity over quality!"
docile old ice	docile old ice	false	341000045	--	"coiled"	"coiled"	--	--	"The docile old ice bends, cracks, and whirs as it becomes something far more artistic than you could've made with your bare hands. They inspire real awe now, like the Isle Crag Glaciers. You haven't fixed up the palace, but you've made some nice scenery here."
weeds	ragged dagger	true	480850046	--	"sewed"	"sewed"	--	post-weeds-sewed rule	"The weeds tangle together and pull each other out of the ground. As they do, they reveal two items that seem, well, kind of stupid, but you never know. A ragged dagger and a raves saver, which you take."
mended mini denim	Eclairs	true	326810705	--	"mined"	"mined"	--	--	"You hear zzk-zzh noises as the mended mini denim is cut away. In a huge old dug hole, you see a pack of clairs in the hole under them--probably still eatable, given their general shelf-life. You take them, but you've left a bit of a hole you might be able to go down."
bogus-dandier	bogus-dandier	false	371276262	Treading Gradient	"dandier"	"dandier"	--	post-dandier rule	"You feel slightly more cheery about your prospects of getting out. You didn't fall that far. You remember that, although the exit is high above, the treading gradient was, well, a gradient. So you start crawling through various passages until you find one where--yes, there's a bit of sunlight. You could make it up through there. You start digging with your hands, and what do you know? There's a passage out. You fill it once aboveground, then you do the same for where the denim was. You didn't necessarily solve anything, but you showed you could respond positively when in trouble."
raves saver	raves saver	false	472956780	--	"pearly"	"pearly"	--	--	"The saver shines a bit, then goes back to being a bit less dingy than it is now. The 'replay player' text disappears, too. Hooray for aesthetics!"
sporties ripostes	sporties ripostes	false	709599244	--	"prosiest"	"prosiest"	--	--	"The taunts become less vernacular and catchy and more drawn out. Hey! You can deal with these! They make some logical sense if you're not too careful, but you break things down. No, those annoying jibes don't have to bug you any more, not even a little. When you realize this, they disappear, or maybe you can just ignore them now."
strudel	strudel	false	592462631	--	"rustled"	"rustled"	pre-strudel-rustled rule	post-strudel-rustled rule	"You manage to take the strudel without obviously reaching for it[if sled rut is touchable]. The sled rut vanishes as you do[end if]. This makes no practical difference but makes you feel smoother. Go, you."
fissure	fissure	false	582291393	--	"fussier"	"fussier"	pre-fussier rule	post-yow-free rule	"The fissure begins babbling and yelling at the duck. The duck, annoyed, walks over and pecks at it, inserting its bill and--click! I guess the fissure was vulnerable to ... fursies."
luck node	luck node	false	522953692	--	"unlocked"	"unlocked"	pre-unlocked rule	post-yow-free rule	"The duck sees you fiddling with the ropins. Somehow, as it pokes its bill at the luck node, it finds the right combination. Now that's luck!"
dinger	solve a loaves	false	382846875	--	"grained"	"grained"	--	post-dinger-grained rule	"Suddenly, [i]Reading a Dinger[r] loses the sheen on its cover, the bold elevated authors['] names. 'Ugh,' says the Agnostic. 'Why [i]was[r] I reading this? Surely there are better things to do, things to actually LEARN. Oh, speaking of learning, here are some solve-a-loaves that didn't work for me. Apparently they are more for immediate help, not long-term projects and stuff. Plus they taste icky cold.'" [this is the end of the weird stuff for LLPs. The rest deals with the agnostic. ]
atblock	atblock	false	788195264	--	"attentive"	"attentive"	--	post-tentative-attentive rule	"[agnostic] snaps further to attention, even more eager than before!"
turbos	turbos	false	482585076	--	"robust"	"robust"	--	--	"The turbos whir a bit and grow shinier. Robust or bust! [how-safe]."
blaster	blaster	false	486934458	--	"stabler"	"stabler"	--	--	"The blaster whirs a bit and grows shinier. It quits making those weird noises. [how-safe]."
weirder red wire	weirder red wire	false	600216532	--	"rewired"	"rewired"	--	--	"The wires in the bot boat begin to glow. You realize they could be organized a lot more simply. You point to them, and [agnostic] snaps [his-her] fingers. 'Of course! I can do that...and that... I should've thought of it earlier.' [agnostic] proceeds to find some simplifications you'd never have considered. So many, in fact, the red wire becomes superfluous! 'Man! I feel dumb about all I coulda fixed, now!'[paragraph break]You reassure [agnostic-first] that it's not a big deal, and it's more important to just DO stuff. You even stammer apologetically it wan't much, unable to explain how 'rewired' was so close to 'red wire,' hoping not to slip into 'it was obvious' territory.[paragraph break][he-she-c] brightens, explaining that sometimes an outside perspective can help you overlook things that should've been obvious, and the important thing is that things got improved, because dedication to craft is importsnt, and the organization will help clear the way for new ideas. You nod. [agnostic] thanks you for being the sort of person that helps [him-her] get organized, instead of the sort of person who yells [he-she] needs to get organized."
earnest eastern neaters	earnest eastern neaters	false	611415331	Mislit Limits	"nearest"	"nearest"	--	--	"You concentrate and hope -- and you see figures to the east, swimming for you! You have enough energy to make it to them. They assist you to the shore on the other side of Leak Lake. They show willingness to be rant-ees for a minute, but you don't need that. They take their leave, looking to help the next person with a tenser 'Art, seen! SET! EARN!' It's nothing to sneer at.[paragraph break]Aslosh on the shoals, you look up at the Curst Palace. You are close. You could win it now. But you hold the top opt pot, too, and maybe you have the time to drop off a gift...wherever Renato's friend may be." [bold-ok]
repents serpent	repents serpent	false	690693472	--	"present"	"present" or "present serpent"	--	--	"The serpent gradually slackens, then slinks to where it's just there. But it shortly finds just being present and not really able to annoy anyone is not worth their time. There must be someone else to bother."
ur pine	nastier stainer retinas	false	513602032	--	"punier"	"punier"	--	--	"The ur-pine shrinks and flails. Behind it is ... worse. Stainer retinas. Wait ... not just any stainer retinas. [b]NASTIER[r] stainer retinas. They must be guarding something!"
nastier stainer retinas	succor crocus	true	528602068	--	"antsier"	"antsier"	--	post-retinas-antsier rule	"The stainer retinas blink and begin to lose focus. You stare them down. They blink some more. Then they look from side to side. A long pause, perhaps pondering they'd been tougher to make antsier if 'nastier' weren't so similar, then ... they trail off to who knows where.[paragraph break]Behind them is a pure spring. Clear water drips from it. You let a few drops into the top opt pot ... and the blub bulb opens up. Not into a We-ROFL flower, which brings only temporary happiness, but a succor crocus!"
itster	done any anodyne	false	560616760	--	"triste"	"triste"	--	post-itster-triste rule	"She suddenly blinks. 'This high score doesn't mean much. I could just keep playing, but no...I'd actually like to DO something. I'm disappointed I haven't...' She ditches the IT-STER and gets up and shakes your hand. 'People call me St. Teri. Some, even without sarcasm. You...must be someone important. I'll try to help you, if I can. But I still don't feel up to it.'[paragraph break]And you see why: behind her is a bottle of [anodyne], which 'helps' people feel 'good' about relatively meaningless accomplishments. So good, in fact, they worry about trying something they really want to do, because they might fail, but their rote achievements will always be there to repeat, even if they aren't much fun to retry or recap."
done any anodyne	done any anodyne	false	485549861	--	"annoyed"	"annoyed"	--	--	"[Tetris Sitter] suddenly blinks again. 'No. Life's not good enough. I don't want to pretend like this stuff is good enough any more. I mean, I have to admit I wasted a bit of time and not cling to this. I'd like to do something real. And I'd like to help you.' She pours the anodyne out and throws the bottle down a trash chute."
Curst Palace	Curst Palace	false	695286307	Strip of Profits	"spectacular"	"spectacular"	pre-curst-palace-spectacular rule	post-curstpalace-spectacular rule	"That does it! The sky goes from unsightly to sunlighty. You hear lumber rumble--old stuff out, new stuff in--and watch the ground bristle and blister as the curst palace gleams, shines, turns from boney to ebony and radiates a godly day-glo. It is back to what it was and more! [what-about-ed]. You are treated to a great banquet in the castle hall before one of the local wizards offers you a chariot. Not just any one. A Raci-Hot, shaped like a haricot. As you're driven back to the Strip of Profits, you see so many things as they should be. The Wildest Wilteds are already on their way back to being the Reenergise-Greeneries. The towers crumble as you fly back through to the Trips Strip."
keycar	keycar	false	409615745	--	"creaky"	"creaky"	--	--	"You hear a squeak from the keycar, and its babble begins slowing and warping. Then, suddenly, it zooms off jaggedly out of view, wherever keycars go for repair." [keycar and rousted detours can appear in radically different places, so we want these near the end.]
bogus-rousted	bogus-rousted	false	613001369	--	"rousted"	"rousted"	--	post-detours-rousted rule	"You summon a burst of mental energy. You are sure the Dourest Detours aren't as still and dead as all that. The wind picks up. You feel confident. You plan your way out. You walk along to somewhere new..."
seismal samiels	seismal samiels	false	485423697	--	"aimless"	"aimless"	--	--	"The seismal samiels waver a bit and continue to whoosh about, but now, instead of staying near you, they blow off into the distance. Well, that's one less thing to worry about."
Andres	Andres	false	401528293	--	"snared"	"snared"	--	--	"Andres suddenly feels a pull, and some sort of tentacle you haven't seen before breaks and outside the Loftier Trefoil. It's nothing lethal, but enough to make him flee." [even though the picaros are at the beginning, I've placed them at the end, because this saves time in the long run.]
Andrew	Andrew	false	413189100	--	"warned"	"warned"	--	--	"Andrew suddenly gulps, as if he hadn't realized the downside of this venture. 'Darn, we...raw end!' he mumbles, then flees. Rodney mumbles 'Aw, nerd.'"
Archie	Archie	false	316598460	--	"achier"	"achier"	--	--	"Archie begins grabbing his joints and moaning 'I reach!' then 'I crack a crick!' until Rodney yells at him to get out. Which he does."
Barney	Barney	false	425003395	--	"nearby"	"nearby"	--	--	"Barney assures Rodney he'll look for any unused exits captives might sneak out. But you can see him sneaking off once he is out of Rodney's sight."
Blake	Blake	false	255159849	--	"bleak"	"bleak"	--	--	"Blake moans, depressed, what does fighting matter? He just wants to see his twin brother Kaleb, who's probably as sad as he is. Nobody particularly tries to stop him."
Bredo	Bredo	false	326930483	--	"bored"	"bored/robed"	--	--	"Bredo gives an exasperated look, shrugs, and walks off for someone more [bored-robed] to follow. Or beat up. Or philosophize with. Whichever."
Cedrick	Cedrick	false	370096195	--	"cricked"	"cricked"	--	--	"Suddenly, Cedrick clutches at his knee, then at his elbow. 'I can't do this anymore!' He whines, as he runs upstairs for some rest."
Daryl	Daryl	false	284713801	--	"lardy"	"lardy"	--	--	"Suddenly, Daryl grows flabby and is really in no shape for fighting. He excuses himself, and Rodney shrugs."
Demitri	Demitri	false	491329864	--	"timider"	"timider"	--	--	"Demitri's face becomes contorted with fear, perhaps fear at how embarrassing it would be if you managed to beat him and Rodney[if here-picaros > 3] and the rest[end if]. He runs away quickly, muttering 'I'm tired.'"
Dewey	Dewey	false	506935332	--	"weedy"	"weedy"	--	--	"Dewey loses muscle mass before your eyes (don't worry, he's still in good enough shape.) His armor hangs off him loosely. He flees from embarrassment, but Rodney doesn't care enough to follow. Don't worry--he'll gain his muscle back. Working out is a habit for him!"
Edwin	Edwin	false	370670325	--	"wined"	"wined"	--	--	"You watch as Edwin's face grows redder and he begins hiccuping. He lurches unsteadily, and then he runs upstairs to where he can lie down. He had only been opposed to alcohol on principle, but he will be more understanding now to others who drink."
Eldon	Eldon	false	345909122	--	"olden"	"olden"	--	--	"Eldon rapidly becomes older than the rest of the knights guarding the tavern. He limps off, muttering he wishes he could help. Once outside the Loftier Trefoil and free of your magic, his youth comes back, but he bolts in shame. Hopefully he retained some wisdom."
Ernest	Ernest	false	609227513	--	"tenser"	"tenser"	--	--	"Ernest, who had looked quite relaxed up to this point, suddenly mumbles to himself about all the things that could go wrong, to resent his way of life. And even if nothing can go wrong, that would just make it even more embarrassing if things did. He whispers a prayer to St. Rene, then zigzags jerkily out."
Geno	Geno	false	303665896	--	"gone"	"gone"	--	--	"Geno just walks off, without explanation. Not that you need any. Perhaps he went to seek his twin, Egon."
Goldy	Goldy	false	304154459	--	"godly"	"godly"	--	--	"Goldy has a revelation and looks to the skies. 'No more mercenary money! No more violence!' he cries. He runs off, a new mission in life."
Leander	Leander	false	486874275	--	"learned"	"learned"	--	--	"Leander suddenly sees the futility of war and aggression, its true cost, and how violence begets violence. 'THAT's what I should've learned in school!' He drops his weapon and armor and runs away."
Marcel	Marcel	false	352212307	--	"calmer"	"calmer"	--	--	"Marcel looks less enraged. He wonders what he is fighting for, apologizes to Rodney--and the people in the tavern, and to people he'd forgotten he's harmed. Then he walks off, almost skipping."
Marlon	Marlon	false	348660698	--	"normal"	"normal"	--	--	"Marlon feels normal again, but not boring normal! He feels special enough to realize Rodney doesn't need to hold a spell over him. Yay, Marlon! Yay, you!"
Preston	Preston	false	637239940	--	"pronest"	"pronest"	--	--	"Preston suddenly looks around. He seems panicked, as if anybody could attack him from anywhere. He turns around and runs smack into a postern. After shaking himself off, he runs further away."
Reggie	Reggie	false	451128271	--	"eggier"	"eggier"	--	--	"Reggie suddenly snaps. As do the people next to him. They both mentioned that he smells a little sulfuric, and he runs outside to freshen up. He doesn't come back."
Royce	Royce	false	428847326	--	"coyer"	"coyer"	--	--	"Royce clams up, and when Rodney isn't looking, hey slips away."
Shane	Shane	false	332457700	--	"ashen"	"ashen"	--	--	"Suddenly, the color rushes from Shane's face, and he looks a bit embarrassed. He looks at Rodney, realizing 'He's an...' before running away."
Terrance	Terrance	false	619470753	--	"recreant"	"recreant"	--	--	"Terrance suddenly realizes that unconditional acceptance of pointless duty is lazy in its own way and decides to wander off. [if here-picaros is 2]Rodney[else]The others[end if] can surely handle a bunch of drunks."
Tyson	Tyson	false	465003321	--	"stony"	"stony"	--	--	"Tyson's emotions grow from hateful to just plain stony. This extends to his feelings towards Rodney as well as the tavern dwellers."
Wade	Wade	false	258957789	--	"awed"	"awed"	--	--	"Wade glances at your settler. 'Hmm,' he says. 'A gadget like that, you must be someone important. Beats Rodney's stupid sword.' As he walks away, he mutters some interesting, lucid points that make you feel better about needing or using the settler and quest aides in general. You get the sense if you ever made a game yourself, he'd give some pretty awesome work and advice. You could even picture him helping create a gadget like the settler. Clearly, he was way too good for Rodney!"
Rodney	Rodney	false	499778338	Topside Deposit	"yonder"	"yonder/droney"	pre-rodney rule	post-rodney rule	"Well. Rodney isn't as impervious to magic as he claimed[rodney-ditch]. You're about to leave, but you hear a 'Do halt!' from the cellar.[wfak][paragraph break]The speaker introduces himself as Ornate Atoner Renato, talking about things he'd been near to, or neat. 'I know who you must be, now.'[wfak][paragraph break]You nod. 'While I learned much world-saving theory, I never had the chance to put it into practice. But I do know this: Dr. Yow, if you can find [him-her], will help in several ways, but the Wildest Wilteds are a cruel, difficult place. All people blocking your way--though not things--will be at least as tough as Rodney, though you if you listen and ask questions, it may become easier.' You note six letters in Rodney.[add-adj][wfak][paragraph break]Renato advises you that [passrite] may be scattered in the Wildest Wilteds: not the most delicious snack, but they are a verified skan-snak that will help you to look into things. While Elvira's made it a regular diet for certain henchmen (not that it helps much,) there is no moral punishment for using them.[paragraph break]Then he hands you a flowerpot. But not any old flowerpot. A top opt pot! It's for an old friend--one who bought property near Castle Apcur, the Curst Palace, and can't bring herself to move. Perhaps you will find a flower along the way to put in it. 'I? The one? No, thee! I...old-age gaoled...' / 'Ah, told, old hat.' you say, writing the information in your notepad.[wfak][paragraph break]You follow his directions, running the last bit through a Shout-So Hut. As you exit, a voice booms 'STOP! DIE!' So you sort of expect where you end up next..." [bold-ok]

this is the post-reeds-ale rule:
	moot lars eede;
	moot elsa erde;
	process the guardian taunt and track progress rule;
	if player is male, shuffle-guardians lars eede;
	if player is female, shuffle-guardians elsa erde;

to say rscheck:
	if word number 1 in the player's command is "resealed":
		now rese is true;

this is the post-bonker-broken rule:
	now stinger is in Danger Garden;
	now gualoc of stinger is Danger Garden;

this is the post-stinger-resting rule:
	now geese are in Danger Garden;

to say vain-naiv:
	if the player's command includes "naivest":
		say "You remember that alternate solution to the truth-teller and liar puzzle and ask the natives if they've heard of free beer at the Epic Clean Nice Place yet. They don't believe you at first, but you manage to sucker them with 'of course you've heard of it' and 'would I lie about free beer' and so forth. You provide them unbelievably wrong directions to follow, and the site van chugs off";
		now naiv-nat is true;
	else:
		say "You convince the natives that they're really too good to be guarding THIS spot, and in fact, you cleared out some other areas that are even more fun to guard, but you're sure there're even more fun places if you just go--well, this-a-way and that-a-way. They fall for your flattery and start up the site van in search of somewhere better"

this is the post-agnostic-blocker rule:
	if atheists are moot and the-hostile is moot:
		now agnostic is in Actionless Coastlines;
		now dinger is in Actionless Coastlines;
		if player is in Actionless Coastlines:
			say "[line break]Someone comes ... coasting into view with the atheists and [relig-mf] gone, reading a book. And not just any book, but the inexplicable bestseller [i]Reading a Dinger[r]. While it's not particularly good, you can wind up reading more than you wanted of it. They look up. 'Oh, hi, I'm the coasting agnostic. Thanks for releasing me from having to think about...those people. I can read my book now. I guess smart people read, and they read stuff like this. I hear it has all kinds of cultural tidbits I should know! And I don't have anything more constructive to do. Plus the book's so well presented. No excuse not to read it...'";
			guar-pro agnostic;
		else:
			say "[line break]You hear someone yell, 'Yay! They're all gone! I can read in peace, now!' to the [if player is in Artist Traits Strait]north[else]east[end if].";
	else:
		say "[line break]You hear [if the-hostile are not moot]voices[else]a voice[end if] yell [one of]'[if player is female]Nay, slog, nosy gal[else]Sadly no, nosy lad[end if][or]a bizarrely accented 'Abort, o brat[in random order]!' to someone you can't see.";

this is the post-weeds-sewed rule:
	now player has raves saver;

this is the post-dandier rule:
	now Arid Den is shunned;

this is the pre-strudel-rustled rule:
	if player has strudel and strudel is reflexive, say "(Yeah, okay. You were supposed to pick the strudel up this way in the first place. But hey, have a point anyway.)";

this is the post-strudel-rustled rule:
	now player has strudel;
	moot sled rut;

this is the pre-fussier rule:
	if duck is not touchable:
		say "The fissure squirms a bit but settles back down. When it was open, maybe something could've gone in, but you're carrying nothing close to the right shape.";
		preef fries us fissure;
		do nothing instead;

this is the post-yow-free rule:
	say "[line break]The prison ropins slither to the ground and vanish, along with the luck node and fissure. Out comes Dr. Yow. [he-she-c] thanks you briefly and awkwardly. The duck rushes to Dr. Yow's side. It won't be following you any more.";
	if noun is fissure, now fissure-flip is true;
	now Dr Yow is in Obscurest Subsector;
	moot fissure;
	moot prison ropins;
	moot luck node;
	now lone duck is returned;
	now lone duck is realized;
	now luck node is unfigured;
	now fissure is unfigured;

this is the pre-unlocked rule:
	if duck is not touchable:
		say "You fiddle with the prison ropins but probably need someone or something to facilitate unlocking them due to how they're configured. You don't have anything on you[if Shaven Havens is unvisited]. You haven't explored up north yet[else if duck is prefigured]. You remember trying 'unlocked' with the duck[end if]. Then, [b]UNLOCKED[r] should work. It just feels right.";
		now node-preef is true;
		preef luck node;
		do nothing instead;

this is the post-dinger-grained rule: [?? this should not be necessary if take entry is true]
	now player has solve a loaves;

this is the post-tentative-attentive rule:
	now ag-atten is true;

to say how-safe: say "You'd feel [if blaster is reflexive or turbos are reflexive]marginally safer[else]totally safe[end if] crossing Leak Lake on the boat now"

this is the post-retinas-antsier rule:
	move blub bulb to location of player; [?? I forget if this is necessary but I am being overcautious]
	moot blub bulb;
	now succor crocus is in top opt pot;

this is the post-itster-triste rule:
	now tetris sitter is proper-named;
	now printed name of tetris sitter is "St. Teri";

this is the pre-curst-palace-spectacular rule:
	if player is not in Mislit Limits:
		say "Your word, stupendous as it is, has no effect. Yet. You [if player is in Mesprise Premises]may just need to go back outside[else]are probably not close enough[end if].";
		preef curst palace;
		do nothing instead;

this is the post-curstpalace-spectacular rule:
	if used-ray is false and cur-score of towers is max-score of towers - 1:
		ital-say "You get the final bonus point for not using the toaster/pastries['] x-ray vision anywhere! [if xrayvision is true]And congratulations on resisting temptation after eating [the random moot skansnak], too.[else][line break][end if]";
		increment cur-score of towers;

to say what-about-ed:
	if itster is moot:
		say "[The tetris sitter] comes out to see the results of your magicking. 'Did OK, kiddo!' she yells, shaking your hand";
	else if serpent is reflexive:
		say "The serpent slinks away behind the den to the west, to avoid the rumbling";
	else:
		say "From inside the den to the west, you hear some bozo yelling about property values. Good for him, you guess"

this is the post-detours-rousted rule:
	move player to last-detour;
	now Dourest Detours is shunned;
	if seismal samiels are not moot, poss-d;

to say bored-robed:
	if the player's command includes "bored":
		say "interesting";
		now bredo-bored is true;
	else:
		say "clerically garbed, like he just became,";
		now bredo-bored is false;

this is the pre-rodney rule:
	if here-picaros > 4:
		if the player's command includes "yonder":
			say "Your attempt to bounce Rodney yonder is blocked by a few of his followers, who stumble a bit but stay upright as they combat the invisible force sucking him away. That looked like the right idea, but maybe get rid of a few of them, first?";
			now rodyon is true;
		else:
			say "Rodney's voice would certainly seem droney by itself, but he segues into a marching song. I guess when you're a leader, you have that confidence. Maybe diminish his forces?";
			now roddro is true;
		preef Rodney;
		the rule fails;

this is the post-rodney rule:
	now all picaros in Loftier Trefoil are pinko;
	if here-picaros > 0, decrease poss-score of towers by here-picaros;
	if recital article is not moot, poss-d;
	mootl list of all picaros in Loftier Trefoil;
	now player has top opt pot;
	reposition-guardians;
	pad-rec-q "curst palace";

to say rodney-ditch:
	if the player's command includes "droney":
		say ". [if here-picaros > 1]Rodney seems to grow tired of giving the orders. He loses his crispness and[else]Rodney begins babbling about something or other, then[end if] looks around, embarrassed--";
		if here-picaros > 1:
			say "his remaining pal[if here-picaros > 2]s[end if] can't be bothered to follow such a dry one";
		else:
			say "talking to himself, really, now";
	else:
		say ". Well, maybe he can repel the lightning and sparks kind, but not yours. He is blown through the doorway and looks up, dazed. Nobody goes to help him";
		if here-picaros is 0:
			continue the action;
		say ". The remaining picaro[if here-picaros > 1]s[end if] even ask[if here-picaros is 1]s[end if] if you can work your magic to make [if here-picaros > 1]them better people[else]him a better person[end if]. After a surprisingly illuminating speech that avoids major self-help cliches, you make an excellent case for self-improvement coming from within, and not worrying about being perfect, or getting a perfect score. It goes over well, and [list of picaros in Loftier Trefoil] thank you profusely before going on [if here-picaros > 1]their ways[else]his way[end if]";

to say add-adj:
	pad-rec "the Wildest Wilteds";

section towers auxiliary

check preferring sometimes abbreviated room descriptions (this is the override built in commands to make Marlon normal rule): if Marlon is touchable, try fliptoing Marlon instead;

book otters

table of otters anagrams
the-from	the-to	taked	hashkey	roomjump	right-word	right-cmd (topic)	pre-rule	post-rule	the-msg
bleary barley	nude dune	false	409909726	--	"barely"	"barely"	a rule	post-barley-barely rule	"You alertly re-tally the weakest figures of speech, what you've done so far--yes, an adverb can be braved. It seems each stalk talks as the top of the barley becomes ragin['] grain, seared, then erased. Fortunately, you're able to dance around to avoid the rife fire. After the big land balding, you see someone to the west who yells, 'You won't get past ED RILEY! I'm no YIELDER!'[paragraph break]You also carved out paths in the barley to the north and south. A nude dune, however, blocks progress from all around.[paragraph break]Also, cinders remain from the fallout. They seem useless, but you didn't really expect or need, say, a beryl."
cinders	cinders	false	463338906	--	"rescind"	"rescind" or "rescind cinders"	--	post-rescind-cinders rule	"You formally scatter the cinders all about. You will not rely on luck or fate or cheats in this final stretch. It will hopefully mark a karma point saved for the next person to save Yorpwald. Which may or may not be you. You can't think that far ahead."
Ed Riley	Ed Riley	false	583131047	--	"reedily"	"reedily"	--	--	"'WHAT ARE You...'[paragraph break]'What are you...'[paragraph break]'Hey, man!' he mouths words silently for a bit, his booming voice gone. 'Well--at least you didn't make me share my sandwich! That's...something!' he whines, acting less impressively and more permissively. He slinks away in embarrassment."
motleyer	motleyer	false	758646860	--	"remotely"	"remotely"	--	post-imp-flip rule	"The imp stops dancing about and starts hopping in place, saying 'You better not try and go by me!' You're bigger, so it's not very intimidating. It returns to zigzagging, but it's kind of missing the edges, now."
butlery	butlery	false	615937733	--	"brutely"	"brutely"	--	post-imp-flip rule	"The imp loses some dexterity and gains some strength. Not enough to beat you up."
legendary	legendary	false	641833229	--	"enragedly"	"enragedly"	--	post-imp-flip rule	"The imp flares up for a brief moment, explaining how it gets mad having to be patient. It didn't become an imp for this..."
tallyhoing	tallyhoing	false	593419698	--	"loathingly"	"loathingly"	--	post-whiners-flip rule	"[shout-check]"
callosity	callosity	false	569909740	--	"stoically"	"stoically"	--	post-whiners-flip rule	"[shout-check]"
jollity	jollity	false	501402896	--	"joltily"	"joltily"	--	post-whiners-flip rule	"[shout-check]"
ghoul hat	ghoul hat	false	445734359	--	"although"	"although"	pre-ghoul-hat-although rule	post-ghoul-hat-although rule	"You begin explaining that you just needed a way through, and besides, the stalks wouldn't have been harvest-able anyway. Mr. Lee relaxes and breathes, and as you speak, the ghoul hat releases its hold on him. He tosses it aside, and it breaks and vaporizes. 'But--the ghoul hat--they said it would stop the Gore Ogre.'[paragraph break]Mr. Lee mutters on about hard times these days, still suspicious, but he's willing to listen. The Gore Ogre still seems unwilling to actually attack."
Gore Ogre	Gore Ogre	false	320082191	--	"ergo"	"ergo"	pre-ogre-ergo rule	post-ogre-ergo rule	"Blam! The gore ogre blinks and almost looks intelligent! It calls out for someone ... 'George ... or ...'[paragraph break]Mr. Lee claps his hands. 'Wow! You're [tgw]. It's--well, I never heard your side. You didn't just change things to things. Perhaps I can help you.' You promise to re-bran what is barren. He offers you a walk in his infidel infield. You feel a slight shock halfway through--[if power-back is false]your mordant powers are now merely dormant![else]similar to what the eels gav. You shake exaggeratedly and nod your head in thanks.[end if][paragraph break]'That is all I can give you. I hope it is enough.' You agree. You will help make his seed site the seediest--once you do the whole country-saving thing. It's the least you can do.[paragraph break][revelv]But they are overtaken ... by a vow here."
vow here	vow here	false	667670490	--	"however"	"however"	--	--	"You counter the vow here suitably, until ... it is not here any more. Hooray for removing distractions!"
sea cube	sea cube	false	496604299	--	"because"	"because"	pre-seacube-because rule	post-seacube-because rule	"'Well, now that you put it that way...' You hear a rush of water. Le Mer has unlocked the sea cube. Eels come out. They look up at you--they may be able to understand you."
eels	eels	false	405700023	--	"else"	"else"	pre-eels-else rule	post-eels-else rule	"The eels seem to understand you. They squirm across the pool, and somehow, the wire weir opens. The eels create a path for you to swim to the allot atoll. There, you feel a shock through your body[if power-back is true] much like in Mr. Lee's Bran Barn[else], and your mordant skills are no longer dormant[end if].[paragraph break][revelv]And yet, voices remain, asking, or stating, 'Sullenness? Us?' Or maybe 'Sullenness! Us!'"
sullenness us	sullenness us	false	548181195	--	"unless"	"unless"	--	--	"You provide a counter-point. The voices need not remain sad, because you have a way to defeat Elvira. You think. You hope. You sense less tension in the air."
atmo moat	atmo moat	false	243725566	--	"atom"	"atom"	pre-moat-atom rule	--	"You summon up all your powers for this one. With a swoosh, the atmo-moat swirls into a single atom, which flakes off to obscurity.[paragraph break]Whoah! That wasn't the toughest anagram you dealt with, but it made the most drastic physical change. You feel the same drained sensation as when you passed the solid idols--but you quickly regain energy for whatever else you need to change."
yer all a yell'r	yer all a yell'r	false	445304660	--	"really"	"really"	--	post-gretta-help rule	"You point out just how bad [yer all] is. With logic, of course, but more importantly with an appeal to emotion. Why, the singer/author didn't have any remotely popular follow-ups! That sort of thing. But more importantly, you just keep nagging [the players] with 'Really?! I mean, REALLY?'[paragraph break]It's an effective strategy when logic isn't on your side, and here, it really (heh!) is. The [players] turn the music down, complaining that you are draining the energy all up in here. Gretta looks slightly relieved. As the 'music' fades, you remember the joker who actually wrote and sang it: Ellray Lyerla." [bold-ok]
parleys splayer players	parleys splayer players	false	569230746	--	"sparely"	"sparely"	--	post-gretta-help rule	"The [pla-ma]s['] enthusiasm drains a bit. They take breaks while they're speaking. Gretta looks relieved for a moment."
t-bossily	t-bossily	false	506485351	--	"bossily"	"bossily"	--	--	"The [pla-ma]s cross over from confidence to ordering around, and Gretta groans. She'd given them the benefit of the doubt before, but not now." [begin DOWNSIDE 7]
t-nastily	t-nastily	false	491645247	--	"nastily"	"nastily"	--	--	"The saintliness act breaks out into competition, which becomes cutthroat, and one idiot, then another, lets slip that he could impress a better woman than Gretta with a nice-guy act. The [pla-ma]s scramble to assure her they didn't mean it that way, but she's not fooled."
t-seedily	t-seedily	false	594081210	--	"seedily"	"seedily"	--	--	"That thing the [pla-ma]s were doing? With their eyelids? Well, Gretta seems to have caught on, now. She laughs and groans a bit, and the  [pla-ma]s accuse each other of being too obvious."
t-tersely	t-tersely	false	716493096	--	"tersely"	"tersely"	--	--	"The [pla-ma]s begin talking less expansively, and without big words to make them seem impressive, they really do seem quite one-note. Gretta shrugs and mutters 'Duh, of course.'"
t-angrily	t-angrily	false	410184768	--	"angrily"	"angrily"	--	--	"The [pla-ma]s become overtly disappointed Gretta is not acknowledging how they know a little something about everything. Each blames someone else for being to dull and narrow."
t-shadily	t-shadily	false	377939109	--	"shadily"	"shadily"	--	--	"You manage to make the [pla-ma]s let slip a mean dis of other maidens."
t-snidely	t-snidely	false	535182609	--	"snidely"	"snidely"	--	--	"The  [pla-ma]s refer to Lindsey a little too unfavorably and ignore Gretta's hint that she doesn't really hate Lindsey. Their apologies fail."
t-starkly	t-starkly	false	516001874	--	"starkly"	"starkly"	--	--	"The  [pla-ma]s finally get a bit too explicit about looks, and Gretta is able to overcome their flattery."
t-cattily	t-cattily	false	448579376	--	"cattily"	"cattily"	--	--	"The  [pla-ma]s each lose their composure, each putting down the next guy's uniqueness or virtues or whatever. They're talking more sense than before, but the truth hurts, and things get out of hand quickly."
t-tearily-irately	t-tearily-irately	false	539593685	--	"irately"	"irately" or "tearily"	--	--	"One suitor is reduced to tears as he talks about reality, or his version of it. 'Dude, that was pathetic,' someone else says. 'Yet...Liar! True-luv vulture!' The argument reflects well on none of the [pla-ma]s."
t-blearily	t-blearily	false	508716411	--	"blearily"	"blearily"	--	--	"The [pla-ma]s interrupt each other, but not forcefully enough. Gretta comments, 'fascinating,' further cutting them." [begin DOWNSIDE 8]
t-ribaldly	t-ribaldly	false	401939391	--	"ribaldly"	"ribaldly"	--	--	"The  [pla-ma]s move from courtship to...well, less than courtly desires. She wanted to believe they would not, but they couldn't help it."
t-formally	t-formally	false	482441177	--	"formally"	"formally"	--	--	"The  [pla-ma]s over-explain how they're fly/moral, and that's a critical lapse in concentration! Gretta has the time to ask obvious questions and make them contradict each other. And shortly THAT's all over."
t-coitally	t-coitally	false	473635774	--	"coitally"	"coitally"	--	--	"Sometimes you just have to let idiots talk about what, apparently, all men think about. With the [pla-ma]s, it's like you almost didn't have to do anything."
t-modestly	t-modestly	false	662820003	--	"modestly"	"modestly"	--	--	"Modesty is a good thing--well, in the long term. In the short term, the  [pla-ma]s['] backtracking is too brazen, and it ruins any hope of impressing anyone with false humility or braggadocio."
t-shabbily	t-shabbily	false	393747830	--	"shabbily"	"shabbily"	--	--	"The  [pla-ma] discussing his lab tries to supply details, but the more he makes up, the easier it is for others to pounce on his inconsistencies--but their trolling is so crude, nobody comes out looking too good."
t-shoddily	t-shoddily	false	471132957	--	"shoddily"	"shoddily"	--	--	"The two  [pla-ma]s can't keep up their production. They mutter 'D'oh! Sly is...' realizing they've worked into a dead end."
t-silently	t-silently	false	671077377	--	"silently"	"silently"	--	--	"The  [pla-ma]s run out of words to describe their style nit, and they begin miming, but that just makes them look a parody of themselves. With time to think, Gretta is able to say how sad they look."
t-steamily	t-steamily	false	614619001	--	"steamily"	"steamily"	--	--	"The  [pla-ma]s begin to discuss the disgraceful commercial in much more detail than is necessary, and their facade of refined alcohol palette, etc., is broken."
t-suddenly	t-suddenly	false	616324659	--	"suddenly"	"suddenly"	--	--	"The  [pla-ma]s['] timing is ruined. They started well, but the slightest disruption and--wham! They're just not as good as the paid actors who've been practicing way more."
t-stupidly	t-stupidly	false	628150776	--	"stupidly"	"stupidly"	--	--	"The  [pla-ma]s reiterate how they don't let duty slip, but it's way too heavy-handed. Gretta has to laugh a bit."
t-martially	t-martially	false	531864386	--	"martially"	"martially"	--	--	"The [pla-ma]s, in an effort to prove their worth, begin talking about that most manly of subjects, war. They talk very loudly and begin discussing cool ammunition and weapons and blood and guts. And shoot-em-up games. Gretta yawns conspicuously, clamming the  [pla-ma]s up." [begin DOWNSIDE 9]
t-sincerely	t-sincerely	false	746289017	--	"sincerely"	"sincerely"	--	--	"Gretta nods sarcastically as the [pla-ma]s make a complete u-turn and discuss what they really think of celery. While it's probably good, long-term, for them to be more sincere, their immediate aims have been foiled."
t-sobbingly	t-sobbingly	false	530137500	--	"sobbingly"	"sobbingly"	--	--	"The [pla-ma]s change up the mood, but it is for the worst. One starts crying, then others do--and it's pathetic enough, their plucky efforts to persuade without logic fall to pieces."
t-tediously	t-tediously	false	748843503	--	"tediously"	"tediously"	--	--	"The [pla-ma]s begin whinging with the same old argument, going dreadfully off-subject, and so forth. Suddenly, their nonsense is less believable, or fun to believe."
t-wearingly	t-wearingly	false	645925650	--	"wearingly"	"wearingly"	--	--	"The [pla-ma]s start repeating their arguments, and finally, Gretta draws up the courage to explain it's getting old."
t-drawlingly	t-drawlingly	false	592962469	--	"drawlingly"	"drawlingly"	--	--	"The [pla-ma]s begin talking slower, and suddenly, their conversational hold is broken. Gretta realizes there's no good way to make home repair discussions more exciting and says so. She looks relieved." [begin DOWNSIDE 10-11]
t-emotionally	t-emotionally	false	789771536	--	"emotionally"	"emotionally"	--	--	"The [pla-ma]s['] matter-of-factness is disrupted. They had to play it straight, but they aren't able to. Gretta shoos them away with her hand, cringing to think she was suckered in the first place."
t-desperately	t-desperately	false	948982071	--	"desperately"	"desperately"	--	--	"The [pla-ma]s['] deep stares no longer look profound, but a bit creepy and needy. Their concentration is broken."
t-reactively	t-reactively	false	793570199	--	"reactively"	"reactively"	--	--	"Gretta catches the [pla-ma]s looking around a little too often to see if their words have effect. It ruins the spell.[paragraph break]For your part, you feel you haven't been VERY creative. Cater and Trace and React back in the [plains] has been done, and now, you didn't have to switch too many letters. But then you realize that just underscores how flimsy the [pla-ma]s['] 'creativity' really was."
t-despairingly	t-despairingly	false	781752737	--	"despairingly"	"despairingly"	--	--	"The [pla-ma]s become upset Gretta does not recognize just how swell they are--as a group, and individually. Gretta shrugs and shakes her head, maybe more at herself than the [pla-ma]s." [begin DOWNSIDE 12]
t-indiscreetly	t-indiscreetly	false	915420970	--	"indiscreetly"	"indiscreetly"	--	--	"The [pla-ma]s let their wild clothes get the best of them, asking a bit too closely for Gretta's approval. She rejects them out of hand."
Cut Ya All Cult Laya	Cut Ya All Cult Laya	false	461583976	--	"actually"	"actually"	--	--	"Surprisingly, arguing with the [laya] seems to work! You've been actually'ed yourself, first, but now that you handled the [players], it's cathartic, for a bit, to explore the ways the [laya] is full of rubbish.[paragraph break]The [laya] seems to warp and slow down as you articulate its thoughts. It fizzles and explodes impressively, leaving no trace. I suppose that's what effective gaslighting machines do--erase all trace they were there, success or failure.[paragraph break]You reflect that it's also a move you couldn't have pulled with the [players] around, because they'd just outnumber you and badger you into agreement, no matter how much logic was on your side."
holy nest	holy nest	false	683905568	--	"honestly"	"honestly"	--	post-holy-nest-honestly rule	"You entrench an enchanter with a well-timed 'Honestly?' They throw out anti lying litanying but you're all 'Few LOLs, fellows.' It's not pretty, but their camaraderie's shattered. They begin squabbling about whom Elvira likes better. It's a welcome change."
aside-llp	aside-llp	false	292289828	--	"aside"	"aside"	--	post-ideas-aides-aside rule	"You wave the ideas aides aside. You won't listen to their intimidation. They're visibly impressed ... until you go a bit farther west and hear the roar of a hardy hydra. You step back, and when [e-n-m] laugh at you, you mention THEY could never be that intimidating. That shuts them up.[paragraph break][e-n-m] shifted around a bit. And you notice something that was behind them--a small holy nest. Perhaps it can show up something else about them."
raptor	parrot	false	431763978	--	"parrot"	"parrot"	--	post-raptor-parrot rule	"The raptor turns into a parrot, which squawks gratefully for being rescued. It squawks about not wanting to be a raptor again--except briefly to take revenge on whatever turned it into a raptor in the first place, and maybe you can help it.[paragraph break]With the raptor's bulk out of the way, you see some weird stuff behind."
parrot	parrot-flees	false	431763978	--	"raptor"	"raptor"	pre-parrot-raptor rule	post-parrot-raptor rule	"'A bird! Rabid! Dinosaur is around!' croaks the parrot. before it changes. 'Repel it, reptile!' you hear a woman cry. The raptor gets to ur-thing hurting and takes out the hydra to the west![paragraph break]'Coren,' Elvira cries over a loud squish and pop, and you almost feel sorry for her.[paragraph break]'Clergies! A sacrilege!' [e-n-m] cry, but nobody comes to help. They are paired, repaid, running away as smarting migrants. 'Twist, twits,' you smirk under your breath.[paragraph break]Before you can consider whether you should return the raptor back to its normal form, it crashes through the narrow exit to the east. The Edictal Citadel will be easier to enter![paragraph break]The raptor totters under its own weight. You change it back to a parrot.[paragraph break]'A whistle is wealth,' it says, dropping the whistle to you before flying off.[paragraph break]As you contemplate a new name for the Reclusion Inclosure, you realize that whistle is worth a look, first. And you might want to [if medals are prefigured]figure out the medals[else]recall what you did with the medals earlier[end if]."
pines	snipe	false	419446388	--	"snipe"	"snipe"	--	post-perverse-preserve-flip rule	"The tip of one pine becomes a snipe's bill, the trunk becomes the spine--and you have a snipe."
corona	racoon	false	324129868	--	"racoon"	"racoon/raccoon"	--	post-perverse-preserve-flip rule	"[extra-c]The corona grows wider, becoming a living thing."
nails	snail	false	266175977	--	"snail"	"snail"	--	post-perverse-preserve-flip rule	"The nails arrange themselves in a sort of spiral, expand, and turn into a snail."
thrones	hornets	false	593056280	--	"hornets"	"hornets/hornet"	--	post-perverse-preserve-flip rule	"The thrones shorten--a throne, another--HORNETS! Thankfully, they ignore your waspy yawps." [bold-ok]
owls	owls	false	332375155	--	"slow"	"slow"	--	post-owls-slow rule	"The owls['] swooping speeds hit such lows they they swoop back to their ambush place in hiding. You notice it isn't a very comfortable one, and you help them make a nest from tens of nets. They won't attack again. You refuse anything for the additional magnanimity but ask if any towels need to be changed to owlets. Thankfully not very many.[paragraph break]With the owls dispersed, you notice other, calmer animals. Calmer, but unhappy: a stray satyr, a leopard, a badger, and ocelots."
ocelots	ocelots	false	548714671	--	"coolest"	"coolest"	--	post-ocelots-coolest rule	"The ocelots perk up and, instead of pacing aimlessly around, develop a swagger. Their SlopInc Clip-ons get close to, then are, the real thing. Yes, LookKool shades. Each pulls out a BMOC comb to fix his fur before stashing it for later use."
leopard	leopard	false	445979194	--	"paroled"	"paroled"	--	post-lamer-realm-flip rule	"The leopard perks up as its handcuffs are dissolved."
badger	badger	false	287365426	--	"garbed"	"garbed"	--	post-lamer-realm-flip rule	"The badger looks down and realizes it is wearing clothes. B-grade, garb that won't make you grab or brag, but it can't be drobe-bored. It's less embarrassed now and nods to you gratefully. Perhaps it can return the favor some day."
satyr	satyr	false	409254857	--	"artsy"	"artsy"	--	post-lamer-realm-flip rule	"The satyr shakes a bit as if he has had a vision. He begins drawing figures in the air, standing on his hind legs and conducting an imaginary orchestra. He seems less strictly focused on his own survival now."
lilac bays	lilac bays	false	413053868	--	"basically"	"basically"	--	--	"Nothing happens, until the asyllabic lilac bays bloom unexpectedly! Weird that such a flabby word would provide them with nourishment, but hey, plants already like plant food, which is weird enough. Well, you've prettified things."
weltish whistle	weltish whistle	false	534280357	--	"deeply"	"deeply"	pre-whistle-deeply rule	--	"It takes some time, but you manage to move from making shrieks to something more rumbly and enduring. Noting the writing on the whistle, though, you make sure not to use it til you need to."
medals	medals	false	482616124	--	"quickly"	"quickly"	pre-medals-quickly rule	--	"The medals clink together. You feel infused with speed. Even your fats feel fast.[paragraph break]Oh, also, if you were waiting all game, wondering when you'd get to use the 'Q before U' factoid, I guess it just slipped in under the wire!"

this is the post-barley-barely rule:
	set the pronoun them to cinders;
	set the pronoun him to Ed Riley;
	move ed riley to Minded Midden;
	move cinders to Minded Midden;
	move Edictal Citadel backdrop to all ominous rooms;
	process the tag backdrops for hinting rule;

this is the post-rescind-cinders rule:
	now rescind-cinders is true;

this is the post-imp-flip rule:
	if imp-score is 2:
		say "The sly imp lets out a curse. It's completely failed to keep its cool. It leaves, confidence shattered. You can go past now.";
		moot imp;
		now all block-concepts in Shiner Shrine are forcemooted;
		moot motleyer;
		moot butlery;
		moot legendary;
	else:
		set the pronoun it to sly imp;
		remove noun from shrine-imp-items, if present;

this is the post-whiners-flip rule:
	if whiner-score is 2:
		say "[line break]As they sulk away from the Clarthead Cathedral, the whiners let loose a final complaint about that bum Ed Riley who got a more exciting post--kissing up to Elvira so weedily[if ed riley is in Minded Midden]. You're a bit sad you couldn't dispatch that loudmouth yet, but yay, working your enemies against each other[end if].";
		moot whiners;
		now all block-concepts in Clarthead Cathedral are forcemooted;
		moot callosity;
		moot tallyhoing;
		moot jollity;
	else:
		set the pronoun them to whiners;
		remove noun from cathedral-items, if present;

to say shout-check:
	say "[one of]The din loses speed, energy, nastiness, variety and volume. A re-count reveals several leavers. But even with them gone, too many are left blocking the way south.[no line break][or]Slowly, conversation dwindles until it leaves every hassler rahless, slasher of noise. They find another place where rioters roister.[no line break][stopping]";

this is the pre-ghoul-hat-although rule: abide by the medal check rules for ghoul hat;

this is the post-ghoul-hat-although rule:
	if sea cube is moot, min-up;

this is the pre-ogre-ergo rule:
	abide by the medal check rules for gore ogre;
	if Mr Lee wears ghoul hat:
		preef gore ogre;
		say "Mr. Lee pulls on his ghoul hat, as if he wants to believe you, but his brain is half being controlled by something. You may need another word, first[if Reclusion Inclosure is not visited], and, perhaps, proof of what is in the Edictal Citadel[end if]." instead;

this is the post-ogre-ergo rule:
	de-inhib;
	if eels are reflexed, min-up;
	move vow here to Bran Barn;

to say tgw:
	say "that dude[if player is female], uh, dudess[end if], with those powers";

to say revelv:
	say "You hear voices[one of][or], again[stopping]. 'Revil-a-Elvira?' / 'Yes, her.' / 'HERESY!' "

this is the pre-seacube-because rule:
	abide by the medal check rules for sea cube;

this is the post-seacube-because rule:
	set the pronoun them to eels;
	now eels are in Loop Pool;
	if ghoul hat is moot, min-up;

this is the pre-eels-else rule:
	abide by the medal check rules for eels;
	if sea cube is touchable:
		preef eels;
		say "You consider the end to an argument, but you don't have a start. The eels rattle against the sea cube, just waiting for the right first word." instead;

this is the post-eels-else rule:
	de-inhib;
	if gore ogre is moot, min-up;
	move sullenness us to Loop Pool;

this is the pre-moat-atom rule: [?? preef beforehand to tidy code?]
	if players are in Disowned Downside:
		say "Your powers aren't back yet, but if they were, that'd definitely tip the [pla-ma]s off to who you were. They'd let Elvira know quickly.";
		preef atmo moat;
		do nothing instead;
	else if power-back is false:
		say "That seems like it should work, but you just can't summon the power. Someone around here should be able to help you, you hope.";
		preef atmo moat;
		do nothing instead;

this is the post-gretta-help rule:
	d "Checking progress on flipping [the noun].";
	if uber-rand-cheat is true:
		if number of pickup-lines in Disowned Downside is 0:
			say "You're done! Somehow. This shouldn't happen, but you are.";
			moot parleys splayer players;
			try talking to Gretta;
			continue the action;
		else:
			say "Skipping standard text as we're just wiping the [players].";
			continue the action;
	if noun is t-tearily-irately:
		if the player's command matches "irately":
			now irately is true;
	if noun is a pickup-line and noun is not ment:
		say "(Wow, you did this without seeing the [players] act anything like that!) ";
	increment gretta-score;
	d "Gretta's score is now [gretta-score].";
	if gretta-score is 1:
		say "Gretta looks a bit unsure but less engaged than before, and the [players] seem off-stride and unenthusiastic for a moment.[paragraph break]";
	otherwise if gretta-score is 2:
		say "Gretta nods, able to reject the worst of the [players]['] bragging, but she still listens, likely out of cognitive dissonance. Strike two for the [players].[paragraph break]";
	else:
		say "Suddenly, Gretta realizes zeal is, er, SLEAZIER. 'The balls! All the BS!'[paragraph break]Their preludes repulsed, they shuffle off all 'Man hater mantra, eh? Yum, so mousy. A dim maid. Hotness she's not!' as a beastly last 'bye,' to a beer hall, label her only worth trifling flirting. Their lustin['] becomes insult, but you look steely, as if saying 'Lest Ye!' Even to the heckling lech-king.[paragraph break]Gretta Garett-Tatger thanks you for interceding. She shuffles her feet a bit, unsure whether to leave or stay. She must have had a reason to hang around the Edictal Citadel in the first place. But you can't ask that straight out.";
		now hold-it-up is true;
		moot players;
		unless yer all a yell'r is in disowned downside, now yellr-figured is true;
		moot yer all a yell'r;
		mootl list of all pickup-lines;
		try talking to Gretta;
		continue the action;
	process the how players hit on Gretta rule;
	if debug-state is true and noun is a pickup-line and noun is not ment:
		say "NOTE: The player can't have known this yet, but for testing, it can pass, since we can't determine when each pickup line shows up.";
		continue the action;
	continue the action;

this is the post-holy-nest-honestly rule:
	now holy nest is reflexed;

this is the post-ideas-aides-aside rule:
	now aside-llp is reflexed;
	move holy nest to Reclusion Inclosure;

this is the post-raptor-parrot rule:
	now nails are in Perverse Preserve;
	now corona is in Perverse Preserve;
	now thrones are in Perverse Preserve;
	now pines are in Perverse Preserve;

this is the pre-parrot-raptor rule:
	if location of player is not Reclusion Inclosure:
		say "'Awk! I'd just kill you in that form. Try that around some bad guys.'";
		preef parrot;
		do nothing instead;

this is the post-parrot-raptor rule:
	now player has whistle;
	moot raptor;
	moot hydra;
	moot Merle;
	moot Elmer;
	if aside-llp is not moot, poss-d;
	if holy nest is not moot, poss-d;
	moot aside-llp;
	moot holy nest;

this is the post-perverse-preserve-flip rule:
	increment nounsolve;
	let temp be number of touchable southy puzanimals;
	if temp is 1:
		say "The [b]IQ[r] medal you're wearing clanks against the [b]LUCKY[r] medal. It looks a bit clearer, now.";
	else if temp is 3:
		say "[line break]The [list of touchable southy puzanimals] swarm around you and dance in a circle a few times before going back to rest. You seem to have gained their full trust, whether or not you can do anything with the [random pre-animal in Perverse Preserve]. Your [b]IQ[r] medal looks very shiny now.";
		now random not touchable southy puzanimal is llpish;
	move asyllabic lilac bays to minded midden;

to say extra-c:
	if word number 1 in the player's command is "raccoon":
		say "(Ignoring the extra C.) ";

this is the post-owls-slow rule:
	now ocelots are in Lamer Realm;
	now badger is in Lamer Realm;
	now satyr is in Lamer Realm;
	now leopard is in Lamer Realm;

this is the post-ocelots-coolest rule:
	moot SlopInc Clip Ons;
	now ocelots wear Look Kool shades;
	process the post-lamer-realm-flip rule;

this is the post-lamer-realm-flip rule:
	let temp be number of touchable reflexed animals;
	increment adjsolve;
	now noun is realized;
	if temp is 1:
		say "The [b]LUCKY[r] medal you're wearing clanks against the [b]IQ[r] medal. It looks a bit clearer, now.";
	else if temp is 3:
		say "The [list of touchable reflexed animals] all look over at you, point and give you a thumbs-up. They glance over at the [list of touchable reflexive animals] and shrug a bit, as if it can come along if it wants to. Your [b]LUCKY[r] medal looks very shiny now.";
		now random touchable reflexive animal is llpish;
	move asyllabic lilac bays to minded midden;

this is the pre-whistle-deeply rule:
	if Elvira is touchable:
		say "Elvira summons her monsters to attack as you learn to play the whistle. 'Sorriest resistor! Apt end, pedant.' is the last you hear. Maybe you should've practiced somewhere else.";
		get-dead;
		follow the shutdown rules instead;
	if parrot is touchable:
		say "The parrot still has the whistle. You can't play the whistle until it's yours.";
		preef whistle;
		do nothing instead;
	if number of NPCish people > 0:
		say "That's the right idea, but your practicing might be rough on [a random npcish person]. Maybe you should go back to the Disowned Downside[if merle is moot and player is not in Reclusion Inclosure] or the Reclusion Inclosure[end if][if player is in Reclusion Inclosure], or find a way to get rid of everyone else[end if].";
		preef whistle;
		do nothing instead;

this is the pre-medals-quickly rule:
	if medals-shiny < 2:
		say "You feel a surge, but not enough. [if medals-shiny is 0]Both medals seem[else]One of the medals seems[end if] tarnished. Maybe there's a way to clean [if medals-shiny is 0]them[else]it[end if] up and restore [if medals-shiny is 0]their[else]its[end if] full power[med-unf].";
		preef medals;
		do nothing instead; [?? preef at start to save code lines? Preefed gets un-preefed anyway]
	if Merle is touchable:
		say "That seems right, but not now. [e-n-m]'s stupid underling chatter is bad enough at regular speed. You're worried going at super speed might drive you nuts[med-unf]. [if hydra-known is true]You probably need force to get west, too[else]You might need that speed in the final combat, instead[end if].";
		preef medals;
		do nothing instead;
	if player is not in Reclusion Inclosure:
		say "There's nothing you really need to attack or avoid quickly here or nearby[med-unf]. But there probably will be. The medals will help then.";
		preef medals;
		do nothing instead;

book general auxiliary rules

section presto

shack-flip-yet is a truth state that varies.

report fliptoing when player is in Hacks Shack:
	now shack-flip-yet is true;
	continue the action;

check fliptoing when mrlp is demo dome: say "[this-game] tried to flip something, but it should not have. BUG." instead;

check fliptoing when mrlp is presto (this is the warn against SHATTER THREATS rule):
	if noun is leaf or noun is mug or noun is ALocalCo cola or noun is keyboard or noun is TBA key or noun is skid or noun is disk or noun is rom sticks:
		if player is not in Hacks Shack:
			if noun is keyboard:
				abide by the pre-yak-keyboard rule;
			if Hacks Shack is not visited:
				say "You might not be safe from Elvira's SHATTER-THREATS legislation here. And you're not sure what to do with that, yet. But that feels right.";
				preef noun;
				do nothing instead;
			if noun is disk and yak is moot:
				say "You probably want to go inside the shack before doing that. That stupid SHATTER-THREATS law and all. Do so now?";
				if the player yes-consents:
					say "Great!";
					move player to shack;
					move skid to shack;
					continue the action;
				else:
					say "You can't see much more to do with the skid now, though.";
					do nothing instead;
			if noun is keyboard and yak is moot:
				say "You probably want to [go-ret-shack] before doing that. That stupid SHATTER-THREATS law and all. Do so now?";
				if the player yes-consents:
					say "Great!";
					move player to shack;
					move drab yoke to shack;
					continue the action;
			say "That stupid SHATTER-THREATS law might pick you up out here. [if noun is disk and yak is on skid]Anyway, the yak on the skid wouldn't appreciate it. [end if]Best to [go-ret-shack] and try again.";
			preef noun;
			do nothing instead;

to say go-ret-shack:
	say "[if shack is unvisited]find a safe inside place[else]return to the [shack][end if]"

section otters auxiliary

after fliptoing a pickup-line (this is the weaken-players rule): [ i don't want to put this in every single entry for a pickup line. ]
	process the post-gretta-help rule;
	continue the action;

to de-inhib:
	pad-del "powers";
	now power-back is true;
	if atmo moat is prefigured:
		say "[line break]You feel strong enough to tackle the moat, now";
		if try-fail-animal:
			say ", and maybe even the [if try-fail-pit-north is false]loud roar[else if try-fail-cathedral-south is false]owls[else]owls and loud roar[end if] that chased you away back east, too"; [note that try-fail-animal means 1 of pit-north ansd cathedral-south must be true]
		say ".";

the medal check rules are an object-based rulebook.

a medal check rule for a thing (called x):
	if player does not have medals:
		if x is ghoul hat or X is sea cube:
			say "You try to argue that you're that person who saved Yorpwald in the first place, but you have no compelling reason--or evidence, really, that you're, well, YOU. [if player is in bran barn]Mr. Lee[else]Le Mer[end if] is unmoved.";
		else:
			say "That feels right, but it also feels like you're getting way ahead of yourself, there.";
		preef x;
		[
		preef ghoul hat;
		preef sea cube;
		]
		do nothing instead;

book others

table of others anagrams
the-from	the-to	taked	hashkey	roomjump	right-word	right-cmd (topic)	pre-rule	post-rule	the-msg
moss cap	compass	true	433635024	--	"compass"	"compass"	a rule	a rule	"The moss flattens and clears. A stupid weedy bit becomes the compass needle. Congratulations. You now have something which is able to tell the direction! You look at where it points north. You will be able to progress without risk through the greenish sheering." [this must come first or Inform thinks we want a fruit in column 2]
slime	limes	true	386961913	--	"limes"	"lime/limes"	--	--	"The slime schlurps into a pile of limes too cumbersome for you to carry." [start rustic citrus easy]
spear	pears	true	393057655	--	"pears"	"pears/pear"	--	--	"The spear splatters into more pears than you can hold!"
lumps	plums	true	400734724	--	"plums"	"plums" or "plum"	--	--	"The lumps grow circular and purplish, and suddenly plums are rolling all around."
pagers	grapes	true	425657357	--	"grapes"	"grapes/grape"	--	--	"Poof! The pagers turn into grapes. 'Wow, less noise, more merchandise!'"
sated stead	dates	true	350407000	--	"dates"	"dates/date"	--	--	"The sated stead shakes a bit, then disappears. In its place are some dates."
eerie blurbs	blueberries	true	891090201	--	"blueberries"	"blueberries/blueberry"	--	--	"Getting rid of these blurbs is almost a public service. Pulps splup as the vandalism vanishes." [start rustic citrus hard]
peanut cola	cantaloupe	true	637943038	--	"cantaloupe"	"cantaloupe"	--	--	"The cola bottle turns into a sort of tannish sphere, and you hear pulps splup inside."
harmonicas	maraschino cherry	true	494589373	--	"maraschino"	"maraschino" or "maraschino cherries/cherry"	--	--	"Several painfully tinny chords later, the off-red harmonicas become a maraschino cherry."
omen prism	persimmon	true	707273074	--	"persimmon"	"persimmon"	--	--	"The omen prism's red outside schlurps and changes color to form something better looking--a persimmon."
magenta rope	pomegranate	true	769822574	--	"pomegranate"	"pomegranate"	--	post-pomegranate rule	"With a splatch, the note and rant get yellowed and ball themselves up around the rope to form a pomegranate. You have done either Curtis or society a favor by getting rid of those writings."
mad train	tamarind	true	391814053	--	"tamarind"	"tamarind"	--	--	"Well, you aren't sure if it is that much of an improvement, but a fruit is a fruit. Curtis seems pleased. Everybody gets suckered into buying one of these once, and after a few months, they forget how nasty it was and buy it again."
PSA Elp	apples	true	443013650	--	"apples"	"apples/apple"	--	--	"The PSA [']Elp falls off from the wells and pops out into a few apples, red and yellow and green, like the readings on your settler. Well, you may not have ESP, but it's something almost as good." [start swell wells]
riot cap	apricot	true	410438606	--	"apricot"	"apricot"	--	--	"The riot cap rounds into an apricot, which you take."
stucco	coconuts	true	560113623	--	"coconuts"	"coconuts/coconut"	--	--	"The stucco that was part of the well congeals into a hairy ball (you don't want to know how) and rolls on the ground."
sorer bogey	gooseberry	true	844616803	--	"gooseberry"	"gooseberry"	--	--	"A howling from the well, and the reddish letters fly off! A rather large gooseberry falls on the ground. You pick it up."
miser ruble	mulberries	true	808940340	--	"mulberries"	"mulberries/mulberry"	--	--	"The ruble blossoms in your hand, turning to a more pleasant sight: a clump of berries."
green stain	tangerines	true	757915387	--	"tangerines"	"tangerines/tangerine"	--	--	"The green stain coalesces and brightens...and becomes a few tangerines! It changed color, too. Every single one ain't green."
barber sickle	blackberries	true	732304866	--	"blackberries"	"blackberries/blackberry"	--	--	"The barber sickle grows into a bunch of vines which sprout black fruits, and a basket pops out to hold them. How convenient." [start filed field]
buried raft	breadfruit	true	619813094	--	"breadfruit"	"breadfruit"	--	--	"You decide the raft would be better as breadfruit, whatever that is. The raft swirls into something more spherical, but still nothing close to what you expected. It's odd and bumpy, but you take it."
barren cries	cranberries	true	761370255	--	"cranberries"	"cranberries/cranberry"	--	post-cranberries rule	"The barren cries and briar screen swirl into a reddish mist and become cranberries."
rapt figure	grapefruit	true	694430761	--	"grapefruit"	"grapefruit"	--	--	"The figure gives a look as if it's eaten something sour before it rolls into itself, into a lumpy yellow ball--a grapefruit!"
pipe panel lie pen app	pineapple	true	669912106	--	"pineapple"	"pineapple"	--	--	"With a plain peep, the lie pen app bursts into a pineapple!"
pryer bars	raspberry	true	704483418	--	"raspberry"	"raspberry"	--	--	"The drupelets in the pryer bars pop out and multiply, leaving you with raspberries."
barriers west	strawberries	true	980775919	--	"strawberries"	"strawberries/strawberry"	--	--	"The barriers west collapse into a pile of strawberries."
mean trowel	watermelon	true	815317707	--	"watermelon"	"watermelon"	--	--	"The trowel seems to inflate from within and take on a much greener shade. It becomes a watermelon--not a big one, but healthy looking enough."
Ammo Gang	mango	true	242122758	--	"among"	"among"	--	--	"You mingle among the No Ammo Gang for a while. You have some good conversation, and at the end, they swipe your Tekno-Token through a credit-verification machine and give you a mango. You let out an OMG. It seems the right thing to do." [start Clangier Clearing]
nectarine	nectarine	true	648047304	--	"ancienter"	"ancienter"	--	--	"The unripe nectarine becomes salable. You swipe your Tekno-Token to pay for it, taking only one: multiple nectarines might have transience."
peach	peach	true	267747770	--	"cheap"	"cheap"	--	--	"You go for a direct approach, which works great. Probably won't work again, but you feel a better patron for this potent barter."
i solve voiles	olives	true	504404157	--	"olives"	"olives/olive"	--	--	"A siren goes off! 'You get the last jar of olives!' Len Craig cries, as he tears down the voiles. 'Congratulations!'[paragraph break]You take it. You remember a distant argument where you KNEW olives were a vegetable. You said they must be, and they would do, for a serving of vegetables. Plus, they didn't taste all sweet. You are older and wiser now, or at least you know not to push the issue while you're running errands here."
quince	quince	true	450223472	--	"cinque"	"cinque"	--	--	"You hold up five fingers and repeat 'five' in several languages. Italian finally works. Len pauses, then nods his head. He wipes off the NAME A PRICE markering with a rag."
prices precis	kumquat	true	454868268	--	"cripes"	"cripes"	--	--	"Man! The way you said it, man, Len Craig has another look. Kumquats are indeed an order of magnitude off. He hands you one as gratitude for giving pricees precise knowledge and takes the prices precis down to look for other errors."
melon	melon	true	388955186	--	"mo len"	"mo len" or "len mo"	--	--	"You prod Len and ask if that is really the last melon. You know salesmen's tricks. He smiles, then gives you a much nicer melon from a secret stash."
auction caution	papayas	true	388128590	--	"papayas"	"papayas/papaya"	--	--	"You point at the auction caution and wave down someone passing by who's relieved SOMEONE here seems to know the rules. He gives you some fruits for your, um, ASAP yap."
lemons	lemons	true	485229152	--	"solemn"	"solemn"	--	--	"Thinking all 'I frown for win' at the lemons, you mind-trick Len into lowing his price. 'Enjoy your rickets sticker.'"
a banna	small yellow banana	true	162797375	--	"banana"	"banana"	--	--	"The (a) banna['] folds up neatly into a small banana."
orange	orange	true	391177517	--	"go near"	"go near"	--	--	"You move cautiously, with moves as sneaky as [greedy-s]'s that eventually got [him-her] tarred. [he-she-c] sees you grab it but sniffs 'O anger. A goner.' Sour grapes at the orange!" [start scape space]
a brr hub	rhubarb	true	352061340	--	"rhubarb"	"rhubarb"	--	--	"The brr hub expands and lengthens. It turns a bit greener. [greedy-s] sniffs at the rhubarb with disdain. Yay, more fruit for you. Even weird fruit like rhubarb."
Dr Severe	guava	true	778533808	--	"reversed"	"reversed"	--	--	"Dr. Severe's expression suddenly changes. 'I hadn't thought of it that way... or that. I haven't been very helpful, can I? Well, instead of complaining about what can't be fixed, I should try to, uh, fix stuff. Hey, however you helped me, I'm grateful. Have this guava.'"
concisions	concisions	false	607064964	--	"concisions"	"concisions"	--	--	"Just gazing at [if player has s-i][the s-i][else][the s-c][end if] right, you ... gain wisdom. All your wordplay has made you realize you understand logic but not how to connect. You take a step back to look at the big picture. Yes, you see ways to give your words power even without anagramming." [ this comes before the gift flips proper because we want to use the slider to act on the concisions first. ]
coin	icon	false	207258516	--	"icon"	"icon"	--	post-iconic-flip rule	"You vacate your mind of material thoughts. The coin becomes too omen-y to be money." [start curtis gift flips]
coins	s-c	false	303532482	--	"sonic"	"sonic coins" or "sonic"	--	post-sonic-flip rule	"Blam! The coins begin to rattle gently and don't stop."
icons	s-i	false	303532482	--	"sonic"	"sonic icons" or "sonic"	--	post-sonic-flip rule	"Blam! The icons begin to rattle gently and don't stop."
coins	icons	false	303532482	--	"icons"	"icons"	--	post-iconic-flip rule	"You vacate your mind of material thoughts. The coins become too omen-y to be money."
coins	s-i	false	607064964	--	"sonic icons"	"sonic icons" or "icons sonic"	pre-sonic-icons-double-flip rule		post-sonic-icons-double-flip rule	"You can't decide whether the coins should become sonic or icons first, but you know what? It doesn't matter. You just hope you've got enough brainpower, or whatever, to get a twofer. And you do!"
s-c	s-i	false	303532482	--	"icons"	"sonic icons" or "icons"	--	post-sonic-flip rule	"You vacate your mind of material thoughts. The coins become too omen-y to be money."
viewer	viewer	false	601028460	--	"review"	"review"	pre-gates-stage-flip rule	post-gates-stage-flip rule	"You conduct a thorough review. Of hard stuff and easy stuff and what's most relevant. It's easier than you thought."
searcher	searcher	false	581009492	--	"research"	"research"	pre-gates-stage-flip rule	post-gates-stage-flip rule	"You conduct thorough research. Of hard stuff and easy stuff and what's most relevant. It's easier than you thought."
fleeing feeling	fleeing feeling	false	376061830	--	"prep"	"prep"	pre-gates-stage-flip rule	post-perp-prep rule	"You use the viewer and searcher in tandem and learn about self-presentation, being charismatic, being prepared, etc. While part of it seems artificial and open to abuse, it's easier than figuring out anagrams, that's for sure."

this is the post-pomegranate rule: [the magenta rope is already flipped]
	moot megaton pear;
	moot rampage note;
	moot mopeage rant;

this is the post-cranberries rule:
	moot briar screen;
	moot barren cries;

this is the post-iconic-flip rule:
	concisions-check;

this is the post-sonic-flip rule:
	if player has So Great Storage, slot-appear;
	if noun is s-i, process the force-others-guru-point rule;
	concisions-check;

this is the pre-sonic-icons-double-flip rule: [coins -> sonic icons = 2 points]
	min-and-q;

this is the post-sonic-icons-double-flip rule:
	process the force-others-guru-point rule;
	concisions-check;

this is the pre-gates-stage-flip rule:
	if gate-level is 2, say "No need to over-study or over-think. Through the gates!" instead;

this is the post-gates-stage-flip rule:
	say "[line break]";
	if gate-level is 2:
		say "Man! Another simple reflection gives serious results[if noun is not fleeing feeling]. Hey, you don't have to do everything. There are people who make technology that makes things easier for others, and that's (wait for it) a sort of magic on its own[end if]. After all your struggles, you feel almost guilty the last bit was straightforward, but it passes. A tidy conclusion is, well, tidy.[paragraph break]'Gray date? Great day!' you tell yourself. You feel ready to tackle what lies in the Valence Enclave, now[if cur-score of others < max-score of others - 1]. You wonder if you could've helped Curtis a bit more, but that's totally up to you[end if].";
		if player has fleeing feeling:
			moot fleeing feeling;
			say "[line break]As a bonus, all that preparation puts to sleep the feeling you're a perp.";
	else if gate-level is 1:
		say "Well! That was simpler than a lot of other things you had to figure out. Perhaps Elvira was right that anagram puzzles can make people overthink much, even if she was wrong about everything else[if noun is not fleeing feeling]. Or perhaps people deserve convenience and simplicity even if they haven't rescued a magical land[end if].[paragraph break]You feel almost ready to see what awaits in the Valence Enclave, now. Even if you didn't get anywhere, the failure might teach you something.";
		if player has fleeing feeling, say "[line break]Also, you feel a little less like a perp now. The fleeing feeling remains, but it's much weaker."
	[an edge case bothered me here, so I want to write it out in case it ever bothers me again: if did-guru is false, we cannot min-up, because you may just use the arugula and then go win anyway. That'd be a bit silly on the player's part, but it's possible.]

this is the post-perp-prep rule:
	moot fleeing feeling;

section others auxiliary

to concisions-check:
	now singed design is part of the noun;
	if player has s-i or player has s-c:
		if concisions are off-stage:
			now player has concisions;
	if noun is s-i and concisions are not moot:
		say "You have a feeling [the s-i] have a hidden use, one you don't need, but one that may give personal growth, a way to find a different sort of word manipulation.";
	skip upcoming rulebook break;

volume demo dome tables

[xxdmt]

table of testing notes
thistext [x tester street] [tdm0]
"Early parts relate the brave heroes who slogged through the first version of the game, replete with missing directions to new areas and puzzles that ... well, they technically fit the area. This includes people who tested both Shuffling and Roiling. Their early recommended tweaks helped so much."
"I remember I wanted the hints to work, so I asked testers to run a tricky command. It seems like awkward coding now--a line that hinted what to do next got written to a file every move so nothing was spoiled--but it helped."
"Some testers stepped in post-Spring Thing 2013 to help me with changes I thought seemed basically necessary."
"I remember feeling guilty about asking someone to run through the three areas in different orders to test the SECURE/RECUSE option in Shuffling. It seemed even more tangled in Roiling."
"Knowing how hard it was to ask people to test cases where you do a, b, c in all six possible orders, I tried to make Inform 'test x with y' commands."
"Some people who wrote reviews were kind enough to isolate bugs I couldn't otherwise catch. Their observations also made it in and gave me 'why don't I...' moments. I also was able to trade testing with a few people, which was very helpful. I recommend it. Working on their games sometimes reminded me I should try to add feature X for my own games. Or, sometimes, I borrowed their idea with a twist to make mine easier."
"It gets harder to ask for help the longer a game goes on from its original release. However, stuff like randomizing completion order made it into my more automated files."
"Testers for other games often gave me ideas of how to streamline part of the Stale Tales Slate. Sometimes a detail that bothered me here would have a similar one pop up elsewhere. I thought, why not fix it?"
"Eventually, migration to GitHub, where I could write out issues and commit code, and Zarf's regtest scripts allowed me to run tests it was exhausting for human testers to run. I ran them repeatedly. I hunted down annoying bugs I wouldn't otherwise have the time to. Most testing became automated."
"Sometimes I needed full computer processing power on my virtual Linux box, so that forced me not to browse on the Internet. Or I ran a test when I went out to do chores or whatever. It felt neat, doing two things at once, or getting something done while I slept. It was good to save time when Roiling took a minute to build, and I just wanted to nail that one last elusive bug."
"Many of the original testers of Shuffling have moved on. But thinking, yes, this is what they were REALLY asking for still helps me with the later releases. Or saying, yes, I know this puzzle isn't optimal, but I don't see how to fix it. Then years later seeing a way. Of course I want to move on. But it feels good to close the door on some issues, or know I can do better."

table of calparts
thistext [x calendar] [tdm1]
"Part one: Protean[paragraph break]There's no compelling personal story here. I just had fun trying to make the sort of game I'd have liked when I was younger, the sort Infocom might've done better if the Apple didn't have its limitations.[paragraph break]This part maps how ARO was part of [shuf] at first, til I realized that'd be too long for IFComp's two hours. You see how the game started with the stores, how there was F, I, U, V, W and Y, with P being the finale, and how store M didn't exist for a while. In fact, Store R got finished at the very last. It relates how OUTSIDE was the original puzzle until the author realized that was too abstruse, thanks to a tester, and it maps how F and I were first, so they go the good stuff--the nouns--before M started developing. Somewhere along the line, too, I decided to go in for an anagram of Psuedonym. Moe Spudny, Spud Money, Don Muspey and Ed Spumony all seemed amusing, but it wasn't until I remembered a character I wrote for a walkthrough of Deathlord, Ned, that I started poking around. Yompus may not be a real last name, but it sounds like one. So I went with it. Finding it was one of those 'click' moments that didn't solve any technical problems, but it felt cool.[paragraph break]Plus, the best I found for Andrew Schultz was CRAWLS, ZEN, THUD, until Hanon Ondricek pointed out (in 2014) Dawn Churlzest worked, too."
"Part two: Wrapt to[paragraph break]I realized that it was probably best to go with nouns-to-nouns. Well, until the last puzzle. This kicked out all but F and I. I didn't know what else to do, or where the finale would be. I eventually decided on R, once I figured a resort would be a good place. It only had the Means Manse, and you just had to EXIST. I think your enemy was Too-Apt Pa Otto, and you had to make him into a POTATO. But that was a bit mean. Then METROS began to take shape, and I liked the underside and hotel, and then other locations fell into place."
"Part three: Trap there? Er, phatter[paragraph break]The big problem I had was that I couldn't disambiguate how to flip items, and I had no encouragement for guesses for anagrams. This was a pretty big fault, and there were others, too. Nevertheless, I found a lot with the help of my testers, and I even had the bright idea of trying to provide an alternate way through Metros. One sub-try got the player stuck. Nevertheless, I was able to identify ways to take care of this throughout the comp, and I had plans for post-release stuff. Every mistake I made served to give me an idea to make things easier for the player. The game needed it. I also settled on the idea for the new hint device. I didn't want to reuse what I had from SA, but I also wanted to make things simpler and more powerful. People had trouble seeing if they could take both devices, so I merged them. And I started on the settler, once people said they wanted something a bit more Master Mind like."
"Part four: tap furor[paragraph break]Nobody was really furious at the game, but I certainly got to work when I learned about David White's hashing. Immediately it made ARO more accessible, in theory. I had a lot to whip into shape. I tried to fix a few things per day. I was disappointed in the bigger mistakes I made, and after getting SA into a decent beta (or so I thought,) I started on ARO."
"Part five: pave rift[paragraph break]The only problem was, once I got back to ARO, it didn't make sense. I had an idea that nouns would only feature in the intro. Oyster was just entering a house and leaving. Routes didn't let you underground. Troves--well, I didn't get the concept of what it should be in the first release, though I had a few passive verbs. I had to look through my master document of anagrams, and I found that a lot I dismissed as too simple wound up fitting just right, and testers particularly liked them. I also figured on interjections for Presto as the last area, because interjections are EXCITING. Towers--well, more on that later. I also wasn't sure what to do with OTHERS, which I had after the Ordeal Reload and before the strip. I eventually decided to chuck it for release 1, as it wasn't as good an introduction as I thought. The diorama was created 2 weeks before 2013 Spring Thing, and I think it was relatively successful. But I left so much to do at the last minute with exiling a region I'd worked on that I missed some big things."
"Part six: star pix[paragraph break]I had hoped to put graphics into the game, and it turned out trickier than I thought. Thankfully Glimmr for Glulx works pretty well, but I would up losing valuable time not using the fonts correctly, due to a dumb mistake. I also failed to stop a buffer overrun in some cases, but that's another story. This was something automation could not catch. I also experimented with some pictures and colored text (Yorpwald/wordplay) but didn't get cover art. I couldn't think of anything simple."
"Part seven: vaster pen[paragraph break]The big problem, though, was what to do with Towers. Originally they were a mess of anagrams like STANCH and CHANTS you had to guess, and you got clues of what was where, and some choices were good and some were evil, and you hacked through the Thickest Thickets. One guy, Elmer, was good, and Merle was evil, and the (then-)Coevals['] Alcoves had an elevator where you could go to the various floors and try puzzles. I liked this when OYSTER was small, but Oyster started getting bigger, and Towers became too abstruse with its actions.[paragraph break]It did have hinting, though, and this hinting eventually got repurposed more powerfully and elementally to the settler, but until then, it was a mess. I figured adjectives would be the trickiest things to look at, but a look through my master document gave a lot. At least they weren't as bad as adverbs. I couldn't do anything with them, right? Adverbs were so--powerless."
"Part eight: that gripe, gather pit, tiger path[paragraph break]And that's when it hit me--I could just GREP my anagram file for ly\b, or words that end in LY, and of course you could be powerless near your great foe. The Bleary Barley came first, then a way to regain your powers--conjunctions were another word that could be very powerful. Then I noticed a slew of animals which hadn't been anagrammed, mostly because I didn't see how to in SA without crowding the game. Things started to click. I even had an enemy to defeat, but she had no character or name. The necro-crone wasn't Elvira til after Spring Thing."
"Part nine: inert nap, pain rent[paragraph break]I was able to get the game working with a walkthrough, and I submitted it okay. Greg Boettcher noted it worked, and he liked the idea, though he diplomatically noted that the walkthrough's cuing helped (translated, this meant I forgot to cue SEVERAL exits.) I found a few easy bugs post-release and didn't see any reviews for a while. I was at least glad one liked the pedanto-notepad. But I was still frustrated. I was grateful to place second to a very entertaining game (Geoff Moore and I have since helped each other with other works,) and I knew I wanted a post-release fix, but I didn't know the scope. What probably kicked me in the butt was an email from someone named Toby Ott who thanked me for the game. He explained he was blind and liked games like this, but he'd found a few bugs. This moved me from 'I better fix my mistakes' to 'I can make this better for people who like this sort of thing.' I also saw a very good walkthrough with bug reports from David Welbourn. I was happy to note I'd fixed some of the bugs, but he provided cuing beyond the good stuff my testers found, including some help-code that hung the game. I think what they found helped him be able to find stuff without getting TOO frustrated. But again, it was nice people were PLAYING."
"Part ten: pet rant pattern[paragraph break]I thought I'd get the first release out before IFComp 2013, but there were always new bugs to find or puzzles to touch up. I'd fix an area, then move to the next, then be sure the area was paved over smoothly--only to find several 'I saw that, right?' issues. The thing was, there was so much I needed to do, I couldn't get down to the fun aesthetic stuff in good conscience. Eventually I decided on a drop-dead release date early in 2014, but unfortunately I couldn't get to some good transcripts. I left some huge bugs in--ones my testers found--but release 2 made a lot more sense."
"Part eleven: nerve leapt. Vent. Repeal[paragraph break]One of the huge problems I had with testing was the inefficiency of adding one anagram. But with the major issues out of the way, I found ways to do stuff better. How to add names to anagram checking. This caused my bookshelf to add 1000 titles for release 3 and let me name all the authors. I found a way to centralize all the anagram tables so you could see them at the end. I thought I wouldn't use it much, but I wound up adding ten tables more. I used Notepad++ to load quickly and add anagrams when I didn't need to compile, and for my own vanity, I tracked the number of anagrams in the randomized tables and even checked if they conformed to Benford's Law and Zipf's Law. I wrote an anagram-checker. PERL even helped me to detect bad punctuation, capitals or quotes. All this helped me focus on technical stuff. There's so much I thought I'd only use once, but I reused it. All sorts of internal checks (like the tables of anagrams and David White's hashes--in some cases, I wasn't checking right) cleared up. The Table of Nudges grew by several hundreds as I wrote a program to check for the hash value and dump it in a text file for later use. I even managed to write a silly program to check the relative difficulties of the areas. Towers is, by far, the toughest. But I think the most important thing I did was to try and play through one or two areas seriously per week. I needed to let testers['] suggestions soak in. Some puzzles, I thought, weren't perfect, but I didn't have better. But I would up cleaning them up later."
"Part twelve: twerp valet varlet wept[paragraph break]It turns out there's nothing here that was any good, but I liked this sentence."
"Part thirteen: inert? Phatter! Prettier than...[paragraph break]Just having time pass and being able to tighten up puzzles and think of things has been revealing. I write down my notes, look them over, and get on with it. I've never worked as hard at a creative project as I did with [this-game], but so many times I thought I'd run out of things to do before finding one more. While I figured 'Demo dome mode' shortly before release 2, I never got around to it because there was always something else in the game."
"Final part: plan a rift[paragraph break]I'll have to move on. I had fun with [this-game] as a thought experiment. I enjoyed looking at a phrase, saying I bet that'll anagram, and being right. I also enjoyed finding that a simple anagram could fit nicely in the game's flow. But it all has a diminishing return to scale. I want to move on, but hopefully I'll be able to add new silly books or dialogue on a whim. Github makes it easy to add things--and I wish I'd had it earlier, so I could've tracked other changes. Oh, and if people find bugs (still) I can roll that up, too."

[teenager pith part eighteen]

table of passeparts
thistext
"(ORDEAL RELOAD) You see the Roman Manor region renamed Means Manse, then Ordeal Reload."
"(ORDEAL RELOAD) You see the basement renamed the Largely All-Grey Gallery and the Stable renamed Farming Framing."
"(ORDEAL RELOAD) You see the Collapsed Old Places before the Strip of Profits replaced by Carven Cavern and moved to where you hide the ruby in Oyster, then renamed Rascal Craals."
"(ORDEAL RELOAD) Curtis, whatever he was doing in Collapsed Old Places, is moved to the epilogue in Store H, in Rustic Citrus, of course. Elmo is moved from Collapsed Old Places to before you exit the Largely All-Grey Gallery."
"(STORES) You see the Trips Strip replaced by the Strip of Profits."
"(STORES) You see a limestone milestone becoming a Megaton Magneto-Montage."
"(STORES) You see Ian/Nia (a Drug Guardian) become the Rehabs Basher, and a lecturer becoming Max P Lee, Example (later Pam Exel if you are female) then acquiring the title Blabber Babbler."
"(P/Y) You see the hawt thaw was just thaw before, and also, the Horned Hedron was north of the start of Presto before it was promoted to Oyster's main bad-guy area. You also see the north/south PRESTO areas were named Spumed Tar, Permadust, Purest Dam and A Dumpster."
"(U) You see the Poison Stripe demoted to scenery, because Same Mesa gives more of a feel you're Stuck Here."
"(U) You see Unearthed [']N Underneath becoming Sun-Spared Underpass becoming Harms Marsh."
"(U) You see the Rigged Red Gig becoming the Cripple Clipper. Also, BEHIND and WITHIN are puzzles that vanish, and HUG THOR is replaced by Hurt Hog. Oscar's and Pat's are also renamed to the Adobe Abode and Idle Deli."
"(V) You see Poverty renamed the Loather Rathold, Bad Velour Boulevard being renamed A Sidewalk Laid Askew, then Rustin['] Ruin St. (in Ruts), then Loudest Used Lot and finally Boarded Roadbed. Perky Crass Skyscraper is renamed the Econ-Cone."
"(V) You watch Boredom Bedroom being renamed Pallid Li'l Pad, before it switches back, with Drain Nadir spun off."
"(V) You watch as A Rotund Rotunda is renamed Dour Tan Rotunda, then finally Browse Bowers."
"(V) You watch as Very Top is renamed FiefCo Office, then Upscale Capsule."
"(Y) You watch as Marc's is changed to the Posh Hops Shop, changing the initial flee command from SCRAM with Trolls as bodyguards."
"(Y) You watch Oyster D get renamed the Tenfold Teflon'd Den Loft, and DIE THOU Hideout becomes the Horned Hedron."
"(Y) You also see Achers' Arches become scenery and the Shovel Hovels becomes the Shuttle Hutlets."
"(Y) The Blowfish Fishbowl becomes Helots['] Hostel before settling on Lean Lane, which is revealed as the predecessor of Hardest Trashed Dearths."
"(Y) You watch Hero's Shore get renamed to Saccade Cascade but reserved as the post-haunter name for Anger Range."
"(Y) You watch the Scum Ant Sanctum morph into Plasm Lamps."
"(W) You watch as the Servant Taverns are moved from after Rawest Waters and placed at the start of the Towers area. It is renamed the Loftier Trefoil."
"(W) You see a wholesale switching of locations in the Wildest Wilteds, even when they were the Bland Sad Badlands and before. Danger/Gander Garden is moved from the start to guarding Dr. Yow. Unblest Sunbelt becomes the Leveraged Everglade. Campiest Campsite is moved west of Scope Copse and demoted to scenery for Outer Route, which is moved south and replaced by Fringe Finger. Shaven Havens is moved north of the admirer, with Savager Ravages demoted to bounding scenery. Dopiest Topside is the new introductory name. Heron Isle Shoreline goes through several iterations: Ole Shrine Shoreline, Strati Strait, and finally Artist Traits Strait. Ruffian Funfair becomes Baldest Blasted Saltbed."
"(T) The Maiden Median becomes Gent-Fora/Frat-Gone Frontage, then Disowned Downside."
"(T) Less Nice Silences becomes Tapering Anger Pit/Inert Gap, then Shiner Shrine."
"(T) Southward Shout Ward becomes Rote-Moan/Near-Moot Anteroom, then Clarthead Cathedral."
"(T) A Stocked Stockade becomes Reclusion Inclosure, then Rancho Archon Anchor. Coevals['] Alcoves becomes the new Reclusion Inclosure, with the Alcoves demoted to scenery."
"(T) Wickeder Wire Deck becomes Lamer Realm/Blest Belts. Perverse Preserve becomes Uprates Pasture once you've done enough."
"(P/T) Burnt Brunt in Presto becomes the Char Arch. Bleary Barley in Otters becomes Minded Midden/Burnt Brunt."
"(W) A weirder bot was originally a guardian to be REWIRED, but it was replaced. Only much later did I put the red wire in a bot boat."
"(W) The serpent is moved from the start of towers to an optional puzzle near the end. It becomes pester'n. Later it becomes a repents serpent."
"(W) Some coiled old ice becomes docile, flipping a puzzle, and neural pulses becoming unreal pluses is scrapped. Similarly, ice sheets that were rimiest becoming rimiest are replaced with something firmer."
"(W) A perfect prefect who needs to become porcine is given walking papers as a guardian. So is a greedy gnome guardian who becomes Ed Yerg east of the Mislit Limits. Ed replaces Old Hat Daltho, who is no longer dying/dingy but moved to the start and renamed Ornate Atoner Renato. Eventually, Ed Yerg is cashiered for the Tetris Sitter."
"(W/Y) A papery yapper formerly seen as Angriest is thrilled to be promoted to the end of the Oyster area, especially since it will be bribed, sort of."
"(W/H) Nameless salesmen are sent to the post-script episode. They were formerly dandier, replaced by the arid den to be drained, then by the promise imposer, with the arid den moved to a separate room."
"(W) Other former guardians are a nebula (unable,) deacons (who become Lois the Hostile and the Hostile-is-He Lot,) an orc replaced with a proper alarming grailman, a grandiose swarm (moved to ego-drains.)"
"(W) The smart kid is replaced by a Coasting Agnostic, who doesn't FIDGET (gifted) any more but is absorbed in Reading: a Dinger."
"(W) Near the end of release 4, I finally disposed of Muscly Luc Sym and Ms. Lucy. They were a bit awkward, and I liked the denier nereid better. But they were great stopgaps for short words while I looked for something better."
"(W) SMH-Life Mel Fish, who was originally the man covert in inapt paint, also was retired. I forget when I realized 'himself' wasn't really an adjective, but once I came to grips, he had to go. Realist tailers replaced him, and they're kind of more menacing, anyway."
"Finally, here in the Demo Dome, the owl decal code wall became something the Coder Decor, and the allow-lots-tools wall became raised aiders."
"There is other illegible writing. Stuff forgotten even after I researched it. Well, there is enough, I hope, for those interested in that sort of thing."

table of informcode
thistext [x coder decor] [tdm2]
"A chunk of code starting with CheckTranscriptStatus (courtesy of Zarf) notes how the author was able to nag his testers to take a transcript if they left a comment without transcripting on--or to thank them."
"You read various testing commands used in writing the game, including ones to show the exits every move, hint everything visible every move, and track hints without spoiling things for the player. Other commands include jumping to the Strip of Profits, clearing all but Otters, and even jumping to just before the Gates Stage."
"You stare at the start of the Tables of Nudges. There's, like, 1000+! That's over double [shuf]! The numbers look confusing and arbitrary, but you recognize the anagram-strings that the game checks for, as well as how room anagrams seem to point to the same error messages. You even see how they were broken into regions, and a region has a table name called table of routes anagrams/nudges, and so forth."
"You stare at the start of the Table of Random Books. Wow, [number of rows in table of random books]! That's a lot of books! The second column seems to give a book a priority, so the player is likely to see certain ones first. Those seem to cover certain puzzles that occur later. It seems like a lot, but there's a note that it was well over two years, and the author just wrote a few neat words from each book to poke at."
"You see some specialized Inform 6 code from Zarf (again,) Climbing Stars (in more than one place--for disabling TRACE for the Oyster puzzle, and for restarting the game after winning) and other people."
"You see a bit more Inform 6 code the author scratched out himself. The main chunk is at https://www.intfic.com/t/i6-stubs-for-i7-programmers/83/6."
"You read more various miscellaneous testing commands, like ones that zap all the guardians, see all the fruits or even show what the player would've missed or alternate paths every move."
"You stare at the various tables of random text. A voice from behind a fourth wall mentions they used to be in lists, and worse, not even alphabetized so that some duplicates could be caught easily."

table of auxiliary tech stuff
thistext [x raised aiders] [tdm3]
"#things to do before release:[line break]1. alphabetize tables and check for duplicates[line break]2. make sure anagrams are valid, especially books[line break]3. make sure duplicate anagrams are weeded out or checked[line break]4. check punctuation"
"#generating silly names with honorific titles cheaply[line break]for ($x in %firstNames) { if ($isLastNameAnagram{alf('$x$ext')}) { print '$ext $x $isLastNameAnagram{alf('$x$ext')}'; # print for instance Mean Roy Maroney"
"$alf = join('', sort(split(//, lc($a)))); if ($ana{$alf}) { print '$a=$ana{$alf}'; } $ana{$alf} .= ' $a'; # anagram find code"
"if ($a =~ /^\'[bracket]a-z[close bracket]'/ { print 'bad quotes line $line: $a' } # quote tracking"
"if (firstWord($a) eq firstWord($last) { print 'Possible duplicate: $line, $a = $last.\n'; }"
"There's a reference to http://www.intfiction.org/forum/viewtopic.php?f=38&t=17095 which describes how to detect orphan text in Inform source."
"The perl code is a bit complex, but it seems to involve reducing strings to smaller things. #Mega Mage Game = a3e3g3m3."
"if (($startsWithCapital{$currentTable} == 1) && ($thisString =~ /^[bracket]a-z[close bracket]/)) { print 'Bad capitalization!' # other test cases for if it's -1 (needs to start with lower case) or 0 (doesn't matter) and there are even tests for quotes or punctuation at the end."
"Below the code for reducing strings are various comparisons to detect if an anagram has been used, if a book anagram is proper, or if the book matches its author(s)."
"In the book/author notes, there's a few comments about 70% had matching names before the try, and 10% just had bad anagrams, before that was all fixed. And many former author names were shipped off to [shuf] to make room for new ones here."
"while ($a = <A>) { if (($a =~ /@ARGV[bracket]0[close bracket]/) && ($a =~ /@ARGV[bracket]1[close bracket]/)) { print '$a matches.'; } } # simple check for if I wrote something already"
"There's simpler code below just detecting if any anagrams are found in table entries. It's tough to follow, with exceptions for if two of the same word are in an entry, with the same hash as above."
"There's code of what appears to be copying critical files to a GitHub directory. [shuf] and Roiling files are sent to sister directories, along with the compiled release binaries and piles of odd utilities."
"The rest is too archaic, but it includes other things I put on [ghsite] include scripts to verify random text anagrams, to create the cheat and non-cheat text in the settler, and even track geometric means of table lengths."

table of observations
thistext [from chic loner chronicle] [tdm4]
"I found so many ridiculous anagrams just reading a book on the way to work, or working out, and then I'd just feed them into the anagram server. If ten thousand seems like a lot, well, that is over two years, so that is fifteen per day. That is not so bad when you consider one takes a minute, and I can waste a lot of time in any case."
"One of the best parts of using the anagram server was that I kept seeing cool quotes on the right. These added up to ideas for future games, or even funny jokes, or even more authors to read. It's always a treat when one project gives you spin-off projects."
"A simple I <3 BLOCKSITE FOR FIREFOX. AND GOOGLE CHROME. Well, that's not very philosophical or motivational, but it could be practical."
"It's difficult to describe when an idea has critical weight to branch out. For things like the responses to waiting or blank commands, I maybe had a few in one of/or loops, until I sat down and concentrated on words that meant doing nothing. It took a while to find, but once I had, say, six, I sat down and tried to stretch it to ten, when I put it in a table for the player to see at the end."
"Many of my ideas come from everyday things. I didn't pay religious attention to my file of anagrams once I put down the initial puzzles. However, having two testers say, this seemed a bit wobbly, got me thinking. There were puzzles I liked, and I recruited the best talent available, so to speak. But like on a sports team, the most impressive athlete doesn't necessarily fit. It was hard to retire favorite anagrams or demote them, but it was necessary. And I got some good mileage with ones I'd passed up because I thought I had enough good ones. The diners in release 3 are probably the best example of this."
"It wasn't until I established an assembly line for writing things up that I really started getting the anagrams in place. Before, I sent things to my daily writing, which sorted ideas to a big file by region. Once I cemented ARO as a big project to dedicate time to directly, I didn't have that hurdle, and things went faster."
"I'm still amazed how much organization helped me. Before, I might see an anagram and wonder where it went. Once I organized the anagram types into the Table of Megachatter, it became a lot clearer what would go where, and I could add a new category if I wanted. The one of/or constructions--where things cycled every three times you observed--billowed out to tables. As did lists, where it was tough just to insert one idea. I figured how to make a final note, too, before cycling."
"I even found it easy to add new or break-off tables. For instance, the schematic catechism (one of the last anagrams I wanted to do something with but I didn't know what) originally just had random ideas. Then it had research topics. Then it had Brainy People. Again, none of this would've happened if I hadn't also written code that let me shift between tables."
"Once the anagrams started flowing, and I started adding alternate solutions, ARO started taking a long time to compile. Like 30 seconds. So I tried to place in random text and so forth while I built, since that was low-risk for recompiling. I had one rather bad bug which the Inform 6.32 compiler didn't track (http://www.ifarchive.org/indexes/if-archiveXinfocomXcompilersXinform6Xexecutables.html got the new version) but mostly it was just a matter of writing stuff down and feeding it to a computer. It was much more fun procrastination than others. I found stuff to do (book reading) while something compiled, and that made having to raise an in-program constant less unbearable."
"Many of the puzzles just didn't make sense in the first version. But I was able to sort them out by ones that needed to be changed and ones that would be nice to. I found a lot of times I had to let a tester's observation sit for about two weeks before changing something: gee, it'd be nice to..."
"Perhaps the last thing I enjoyed looking up was that my data roughly obeyed both Zipf's and Benford's Law. I put the megachatter table rows and byte totals as data points into a graph at http://benford.jplusplus.org/, and while each looked pretty good by itself, together they gave a very low z-statistic. Zipf's law was a little trickier--the upper and lower halves of the data had different trend lines. I impart this to how I just sort of added a bunch of tables late, so of course those would sink to the bottom. While a few later tables gained traction (posse bosses, lame talk shows and comedians,) many were just neat to get to ten, and I didn't add to them."
"I also found that, by the end, I spent more time adding anagrams than actual bug fixes to Shuffling and Roiling. But it was fun, and I felt I was doing something every day. Still, it got to be time consuming, and it took a while before I figured a way to add stuff to a separate text file, push a button, and add it to source."
"Learned Helplessness is a powerful thing, and you can always be sucked back down into it: there's that silly voice in my head saying 'Haven't you gotten enough shortcuts?' Larry Wall's delightful oversimplification of the three programming virtues has helped me a lot, here, but I think the real way to frame things is: with the tools I have now, X would be too tough. I don't see how to fix it, yet, but I will."
"One thing I wish I'd done earlier, that would've given me more shortcuts, was setting up my GitHub account. The simple graph of what you've done today (green vs. grey) is great motivation to do something/anything, and if it isn't much, that's motivation to do more next time."
"Finally, I'm just grateful I had so much fun exploring so many alleys and polishing so many odd things. I hope you had even half as much fun playing as I did writing the Stale Tales Slate."

table of tripod games [tdm6]
thistext [x disport tripods] [tdm3]
"A rather direct mention of andrewschultz.itch.io and githu.com/andrewschultz discusses everything, though a lot more detail is ahead."
"First, there is a mention of Threediopolis, where you need to find the right path through a 3-d city to certain treasures and acquaintances."
"After Threediopolis, there is Fourdiopolis, a much larger 3-d city with teleports."
"There is also a framed invitation to The Problems Compound to watch Alec Smart deal with peers. After that, to Slicker City other places."
"There are half-written invitations to Buck the Past and Grubbyville, one a sequel to The Problems Compound and the other about a scheming would-be valedictorian."
"You see a bunch of weird creatures. They call themselves UGLY OAFS."
"You see a depiction of a cube floating in a cavern."
"You see an advertisement for AILIHPHILIA, where everything is a palindrome."
"You see a large tome called the VERY VILE FAIRY FILE. In some unnamed land, maybe you will be able to neutralize it."
"You see a large assortment of Pig Latin translations and impressions of the Fight-Ite Fey and Factual Actual Fey becoming the Flame-Lame Fey. Under They Thunder!"
"You see a small five-by-five chessboard that invites you to explore basic endgame checkmates in Fivebyfivia."
"You see another small five-by-five chessboard that invites you to explore unusal endgame checkmates with minor pieces, bishop and knight. There are apparently many such Fourbyfourias."
"First of many EctoComp games is A Checkered Haunting, where you walk across a five-by-five city trying to cover all blocks except one without repeating."
"The land of Uxmulbrufyuz features four other lands, each with only vowel in its name."
"There is also 69105 More Keys, a tribute to David Welbourn's game."

table of pagelist [from novella] [tdm6]
thistext	page-read-yet	comprehensible
"Page One: Openage. Peonage."	false	true
"Page Two: 'Pa, we got top wage!'"
"'Gape there? Ah, pert age!'"
"'Forage up! Oaf-purge!'"
"Gee, if a VP..."
"Axe pigs!"
"A discussion of nag-peeves. 'Vegans? Eep!'"
"'Get-hip age? The PIG age!'"
"'Inane Peg? Pain, Gene.'"
"'Nag Pete? Apt, Gene.'"
"'Glen, a peeve.' / 'Even gap, Lee?'"
"-"
"Tether in thin tree, then tire."
"Outer fen: tureen of rue often / refute? no. There's also something about utter profane rapture, often."
"Effete gapin[']."
"Axing teepees and an exigent apse."
"Even, tense."
"'The genie! Thine? Gee!'"
"Inane Teen Peg finds a neat genie pen."
"'Pay. Get. Went.'"
"'Teeny Town yet, Newton?'"
"-"
"'Enter thy wet tent? Why, tree?'"
"Fur toy newt went to fury."
"A wet envy fit."
"Sixty went."
"Building of a new event sty."
"Thy tweeting."
"Ninety went."
"Gather pity, gritty heap: part eighty."
"Other tiny north Yeti are described."
"'Oh, twit, try to try with...'"
"'Try! Hit! THERE!'"
"'Try fruit, oh? Tut! Horrify your thrift. Hurt rift, yo.'"
"'Vitrify the thrifty. Vie!'"
"About a soccer team, Try This XI."
"Hitters envy thy nerviest, never--hmm. A picture of a shivery tent."
"'Height? Try it!' / 'Gritty hit, eh?'"
"Something about a nervy tither."
"'Forget pay? A pert fogey.' Also, a putdown of poetry."
"'Fret on, yo. Foyer not too ferny.'"
"-"
"Hefty retro fret theory: try thereof, fry thereto."
"About a turfy roof."
"Verify oft, iffy voter!"
"A story fix."
"'Even frosty foster envy?' / 'Never, softy.'"
"Toy freight, thrifty ego, gift theory."
"Not finery for ninety."
"An apt effigy drawn here."
"Stuff about nifty foe Tony Fife."
"A Witty-off between funny guys."
"Thrifty fee: $3.50. Fiery theft, then a hefty refit."
"If Oft fury... fruity-off?"
"-"
"Fix sty if..."
"Iffy events at an Ivy Fen Fest"
"Thy gift, fie!"
"Someone playing a tinny fife."
"Pigsty, axe, pixy gates."
"Onyx site nixes toy, yon exits."
"The adventures of a twisty ox."
"Thirty exes['] sexy titter."
"'Us, fix troy?' / 'Fruity sox.'"
"Fix set ivy sty, if I vex."
"-"
"Sexist envy."
"'I, sexy, tight.'"
"Tiny nixes."
"Avenge types['] tangy peeves. Spy eventage."
"Something testy-woven."
"Blather about testy women."
"The adventures of a nervy esthete."
"A trip to a frosty venue."
"Festive envy."
"Sexist envy, just as nine pages ago. Apparently, it's an important issue."
"'Even envy sets' is the moral here."
"Hey, vignettes! Eighty events!"
"intense envy."
"'Tea, eh, piggy?'"
"Hot eyeing to hygiene."
"'Yo, we tight! Got whitey!'"
"Tree high, yet. Eye the girth. 'Hi, greyteeth!'"
"'You fighter! Fry, toughie! Grief, youth or thief-guy!'"
"If they give, vie ye! Fight!"
""
"a description of a hygiene vest."
"Yeti get high! Hey, hit it, egg."
"eye-hinting a hygiene nit."
"-"
"'Yo, teen inn?' / 'Not ye nine!'"
"Tiny Towne? None witty."
"'Thinner yet? Inherent yet?'"
"Dramatic dialogue at the end: 'Funnier toy unto finery, intone fury!'"
"finite envy."
"a disappointing rehash of 27 pages ago."
"a disappointing rehash of 18 pages ago."
"NO HINTING YET."
"Ninny Nite."
"Undone herd endured, hon. Oh! Run Ended!"

volume attack tables

table of ordeal reload attacks
target	nohit
plaster	"There's too much of it, and it's too hardened."
act ruin curtain	"It's still too thick, even though some of the plaster is peeled away."
Elmo	"[if see-rifle]Elmo kind of has the upper hand here[else]No, he's here to help[end if]."

table of stores attacks
target	nohit
chapter patcher	"If you don't want to use it, just ignore it."
megaton magneto montage	"Pointless expressions of rage? You're ... not game."

table of routes attacks
target	nohit
Brother Horbert	"Yorpwald's already got a St. Lip-Split."
scripture picturers	"A shameful attempt at vandalism."
THE BEAN	"It's like a dense metal or something. It's more likely it would make something else crack."
Gast	"You don't have a weapon big enough to take [Gast]. One won't appear in your super purse. Anyway, [he-she]'s not evil, just whiny."

table of troves attacks
target	nohit
Pa Egg Pea	"It deserves to be ripped to shreds, but that'd just be littering."
tears taser	"It could fight back much more powerfully."

table of presto attacks
target	nohit
Leo	"[dont-hit of Leo]"
Rand	"[dont-hit of Rand]"
lamb	"Meanie. There's a better way to help it flee home."
walls	"Brute force is ineffective. As well as all the swears you use with the brute force. You need to wipe out the whole volt maze, not just these walls."
hogs	"If you were as strong as [l-n-r], maybe. But you're not. Maybe you can out-think them."

to say dont-hit of (fi - a person):
	say "[if fi is fightin]Neat! Be Beaten! (You'd go to a lit posh hospital where CPR is crisp for that. Think. Or, rather, out-think.)[else if fi is washed up]He'd still beat you up, even though he really doesn't want to fight. Wouldn't change that he and [r-l of fi] are still [i]washups[r]. Maybe a talk with them would break their funk.[else]Slug lugs? As d-u-m as mud.[end if]"

table of oyster attacks
target	nohit
LOLstr trolls	"'I'd beat...' you think, before you realize you've been BAITED. You think bouncers, one scrub. That cools you down."
urn	"Your irrational anger turns to irrational greed when you get close enough to smack it."
sabot boats	"O, bats!"
frat raft	"Yes, the stupid oars don't seem to move themselves, but that's no reason to get upset! Think!"
HUNTER HUNT AREA	"As you kick at the area, a vision of a red hate urn, replete with frowns and scowls, pops up for a second or two before disappearing."
carps	"That sounds so--brutal. And nonspecific."
pikes	"That sounds so--brutal. And nonspecific."
trout	"[this-game]'s kind of topsy turvy, but not like THAT."
paw r wrap	"Alas, the Paw-R-Wrap is nor Wap-R-Wrap."
knob	"Yes, but how?"
skis	"You give them a whack, and it hurts much more than it should. You wonder if love, not hate, is the answer."
span pans	"Well, you need to do something to the pans."
yapper	"I dunno. Not without scissors you don't. That yapper looks pretty tough. The yapper could take out a rock-man or two, you bet."
ant	"You poke at the ant, which keeps it at bay. You need something more simple, violent and direct."
dialer	"That would only sabotage communications here. You need to sabotage the supplier."

table of towers attacks
target	nohit
yurts	"Don't get [']urty! (Sorry not sorry.)"
campiest campsite	"A loud voice booms LE FIST ITSELF! You quiver in fear at the thought of retribution from attacking anything."
diverse deviser	"[if gizmo is not off-stage]You already broke [the deviser][else]No, it must be useful for something[end if]!"
mended mini denim	"[if player has gizmo]The gizmo can't cut through[else if player has dagger]Your ragged dagger doesn't quite cut it[else]You've got nothing sharp enough[end if]. It's been mended nicely, for sure."
sweatier wait seer	"You find it tough to get close to the sweatiness. 'Ew...I...tears,' you say, your eyes going red."
bluster butlers	"They're probably trained to hand out ur-belts."
promise imposer	"That might be RIP-some."
bonker	"As you hunker down to run at the bonker, it wavers menacingly. You're not going to beat it while it's in such good shape."
prison ropins	"[which-sharp]--but force doesn't seem the right way in, anyway."
log gaol	"[which-sharp]----but there is probably nothing beyond in the Wildest Wilteds anyway."
Dr Yow	"[if Dr Yow is in prison ropins]You can't reach in, and it's a bad idea anyway[else]You imagine Dr. Yow mouthing a dry 'ow,' which isn't quite an anagram, but suddenly remember a fellow called Dry Mo, who may or may not be Dr. Yow's bodyguard. Besides, Dr. Yow is here to help you[end if]."
lone duck	"The poor thing at least doesn't have a clonk due. You can see red at this, if you want."
serpent	"Snaky yanks would backfire on you. Maybe you can calm the snake, though."
Tetris Sitter	"Rest it! (Feel free to see red at this.)"

to say which-sharp: say "[if player has ragged dagger]The dagger is not very sharp[else if player has gizmo]The gizmo is versatile but not sharp[else]You have nothing remotely sharp[end if]"

table of otters attacks
target	nohit
ed riley	"'I could DRIL YEE!' Ed booms. You can just HEAR the flagrant misspelling, and it makes you see red."
players	"[one of]Don't hate the player, hate the game.[paragraph break]Um, sorry about that. But b[or]B[stopping]eing outnumbered, maybe you can attack their arguments instead."
Mr Lee	"Be nice. He's on your side."
eels	"Be nice. They're on your side."
hornets	"[nice-to-animals]."
snipe	"[nice-to-animals]."
snail	"[nice-to-animals]."
racoon	"[nice-to-animals]."
parrot	"No. He's here to help."
imp	"It jumps out of reach, streakily, satyrlike."
whiners	"That idea is banefully unflyable."
leopard	"Even if he weren't a hardened criminal, you'd lose. I mean, a leopard."
ocelots	"They're bigger than average. And the leopard would back them up."
satyr	"He's bigger than average. And the leopard would back him up."
badger	"It's bigger than average. And the leopard would back it up."
raptor	"Not even."
sea cube	"Bounce no cube."
Elmer	"[att-elm]"
Merle	"[att-elm]"

to say nice-to-animals: say "You didn't rescue them to kill them like this";

to say att-elm: say "'Die, brag brigade!' you think. But they see your sour look and say 'Venomous? Us? Move on.'"

table of others attacks
target	nohit
Curtis	"Aw, c'mon. Curtis is sort of bossy, but he's not that bad."
Len Craig	"Len Craig is pretty fair and balanced."
Red Rat Art Erd	"[not-even-trader]."
Dr Tera Darter	"[not-even-trader]."

to say not-even-trader: say "If anyone deserves it, [he-she] does. But [he-she] still doesn't. [he-she-c]'s already had enough physical abuse."

volume readables

table of ordeal reload readables
to-read	what-read	alt-read
giant pin	"[first custom style]GNAT. I NIP[r] is nonsensically written in red on the giant pin."	a thing
sitar	"Oh, right. You bought it from [first custom style]Trisa Israt[r]. You see red at the money wasted."
rifle	"It's kind of tricky to read red writing on a red gun, but it appears to be an [first custom style]Irelf-Efril[r] rifle."
pastel plates	"[first custom style]EPSTAL[r] is written as an author's signature."

table of stores readables
to-read	what-read	alt-read
Store H	"'All who enter here risk exclusion. Closed for having a truly frightening [first custom style]HOSTER[r]. Trespassers will be, er, shot. - [first custom style]E. S. Roth[r]'"
Store W	"[first custom style]WESTOR[r] is the name of the company that built this. [one of]There's more, about what method they used[or]They used the [first custom style]SET-ROW[r] method[stopping]." [bold-ok]

table of routes readables
to-read	what-read	alt-read
worst ad	"'WARTS DO SOW, DRAT' is written below [first custom style]RADWOST[r] but not in red. Hmm." [bold-ok]
cravings carvings	"When you squint the right way, '[first custom style]SPEED IT? SIT. DEEP.[r]' is written in red."
trashy ashtray	"On this side is [first custom style][one of]PEST OP, OI[or]PO['] SPITE, O[cycling][r]. You can read the other side [one of][or]again [stopping]if you want." [bold-ok]
A Bev O Be Ova	"The self-proclaimed genius behind this marketing idea was Ev Abo. You see red at people gaining fame the easy way, instead of by saving imaginary worlds and stuff."
Admits Mist Ad	"[first custom style][one of]IT'S MAD[or]DAT'S [']IM[or][ad-auth][or][ad-auth][or][ad-auth][in random order][r], in red."

to say ad-auth:
	say "An author's signature: [first custom style][one of]T. D. ASIM[or]MS. DITA[or]SAD TIM[in random order][r]"

table of troves readables
to-read	what-read	alt-read
tears taser	"[first custom style]RATES[r] is written on the tears taser, in red."
stop post	"[first custom style]POP'S TOTS[r] is written in red on the stop post."
a sty tasty say	"[first custom style]YAY STATS[r] is nonsensically scrawled in red. Or maybe [first custom style]YAYS TATS[r] was the business here before. Whatever."
LEAD	"You can't get settled. Everything seems too general or too specific, and as you read, you hear voices from the past: 'What a yutz! [if player is female]She[else]He[end if] needs to learn to, like...!' They always acted as if it was so simple.[paragraph break]However, there must be some simple way to focus and move on."	[troves]
large regal lager	"[one of]The story on the lager is mostly in black, except where it mentions [first custom style]ERGAL AGLER[r], who brewed the first batch long ago, in red. I'll spare the details, because the story would kill almost as many brain cells as actually drinking the stuff[or]Your eyes gloss over all but the red name, [first custom style]ERGAL AGLER[r][stopping]."
pleaser leapers	"[first custom style]SAP-LEER[r] is the 'ironic' name of the company that produced this monstrosity. They may have ironic distance from the time their customers waste, but their customers, alas, don't."
See Dir	"Nothing catches your eye except an article on [first custom style]RIDEES[r], captioned in red. Whether that's rid-ees or ride-ees with e's mashed together, you don't have the energy to find out."
DIVORCES	"All sorts of articles that make you see red. This one's about [first custom style][one of]Rod's Vice[or]Rev. Disco[or]VeriDocs[or]someone who Scored IV[in random order][r]."
sectarian craniates	"You note, written in red, one of the two creators of this piece of work is [first custom style][one of]Cat Raines[or]Stan Ciera[in random order][r]."
rivets	"The rivets have two messages in red. One is [first custom style][one of]RISE, TV[or]VET, SIR[in random order][r]!"
red vees	"Etched into the vees in red are the names of this motivational device's inventors. One is [first custom style][one of]Erv Dees[or]Ed Evers[in random order][r]."
END PRONER POD	"It is, apparently, produced by [first custom style]N-E-PROD[r] corporation."
r cad card	"[one of]A message in red: [first custom style]Derp on, Epdorn[r]! The authors are also in red.[or]The message, also in red, is from [first custom style]Dr. Peno[r] & [first custom style]Ned Orp[r].[cycling]"
Blamer Balmer	"The likeness was drawn up by [first custom style]Mr. Beal LeBram[r], whose signature is in red."
Blamer Mr Beal	"The likeness was drawn up by [first custom style]E. R. Lamb[r], whose signature is in red."
creationism reactionism	"You see one of the two authors['] names in red: [first custom style][one of]Scot Manieri[or]Cristi Emano[in random order][r][one of]. Maybe it'd help to check the other one, too. It's a big long book with a big long title[or][stopping]."

table of presto readables
to-read	what-read	alt-read
volt maze	"[one of]The writing says EZ-Ol[']-Av['] (TM) Volt Maze. [or]Olav Metz and Zemo Valt were the main architects. [or]It was built by Olav Metz and Zemo Valt of EZ-Ol[']-Av[']. [cycling] You can read it again to see the [one of]architects[or]company[or]architects and company[stopping]." [presto]
sport ports	"[first custom style]TOP'RS[r] is the name of the firm who built the Sport Ports, carved in red."
drab yoke	"It is, apparently, an [first custom style]OAK DERBY[r] drab yoke, from the small red print."
Clack Ops Locs Pack	"The [locs pack] mentions, in red, [one of][first custom style]PC CLOAKS[r] are also a super cool productivity booster.[or][first custom style]POLACCK'S[r] products are shoddy imitations of, well, this. Don't be fooled![in random order]"
Be Troo E Robot	"[first custom style]OBERTO[r], in red. That's its name."
drive a	"It says DRIVE A/A DRIVE: [if drive a is reflexed]AVIDER[else][first custom style]VARIED[r][end if]."
drive e	"It's alternately referred to as Drive E and E Drive. [one of]But wait! There's some kibitzing in red, which you can see if you READ again[or][first custom style]I'D VEER[r], someone has written in red[stopping]."
peels speel	"Through the jargon, you read [first custom style][']E Elps! [']E Elps![r] a lot. It's emphasized in red."

table of oyster readables
to-read	what-read	alt-read
stein	"The stein reads [first custom style]TIENS[r] in red, trying to be foreign and exotic, maybe." [oyster]
jukebox	"Complicated instructions for, of all things, how to turn off the tunes currently playing. Always [first custom style]tunes[r], in red, never songs. [one of]Do, undo[or]Reset, set[or]Do, undo, set, reset? Hm[cycling]."
tips pits	"[first custom style]IT'S P[r] is written in red on the bottom."
HUNTER HUNT AREA	"[first custom style]Etahn Ru. Near-Hut Haunter[r]."
cans	"You squint. [first custom style]NASC[r] is the name of the company that produced these cans, written in red."
span pans	"Red writing indicates the pans were made by [first custom style]Nan's Apps[r]."
gleaner	"The gleaner was made by [first custom style]Al Green[r], written in red."
Templar Ramplet	"Someone named [first custom style]LAMPERT[r] carved their name in red in [the ramplet]."
dialer	"A red warning courtesy of [first custom style]I. ALDER[r] says the letters can be shuffled but not [first custom style]LAIRED[r]."

table of towers readables
to-read	what-read	alt-read
recital article	"This version was written by some lovely chap named [first custom style]ALTERIC[r]."	[towers]
diverse deviser	"[first custom style]I'D SERVE[r] is written in an overly-flowery font. A bit silly, but hey, a clue's a clue."
strudel	"[first custom style]DR. ELTUS[r] recommends this strudel!"
keycar	"When the car slows a bit, you read [one of]product of [first custom style]KC AYER[r][or]property of [first custom style]RAY ECK[r][in random order], in a slightly different shade of red. Maybe the other side has [one of]more information[or]a refresher[stopping], if you read again."
fluster self rut	"You focus and see that the brand is [first custom style]TRU-SELF[r]. Which would make you see red on general principles."
Thearchy Hatchery	"[first custom style]THE LOIS SIT HOLE[r] is written on the Thearchy Hatchery in red[if the-hostile is moot]. Nice, but you don't need clues any more[end if]."
Dinger	"You notice it was co-authored. [first custom style]Di Regan[r] and [first custom style]Ned Riga[r]. The names elevated, embossed, in red."
prison ropins	"Part of the red writing on the prison says [one of]Made by [first custom style]DunkelCo[r][or]Made in [first custom style]LOUDNECK[r][or][first custom style]CONKLUDE[r] there's no way to break in[or]Designed by [first custom style]EL CUNDOK[r][or]Violators have a [first custom style]CLONK DUE[r][cycling]. There're four other bits to read."
luck node	"One of five names in red on the node by the fissure reads [first custom style][one of]Doc Lunke[or]Ned Lucko[or]Ed Clunko[or]O'Kendluc[or]Ockeldun[in random order][r]."
blaster	"[first custom style]ALBERT'S[r]."
bonker	"The bonker was created by [first custom style]KB RENO[r]."
stinger	"The stinger's brand is [first custom style]TRI-NEGS[r], for triple the demoralizing grin power, you guess."
done any anodyne	"The [anodyne] has the signature of its inventor, [first custom style]Dyan Eno[r], in red."

table of otters readables
to-read	what-read	alt-read
cinders	"[one of]You see red realizing you aren't as crafty as [first custom style]Sr. Indec[r] reading the cinders[or]You recall somehow that NRD ICES work[or]You see red having no access to IC Nerds who'd know what's what[in random order]."	[otters]
coma camo	"You concentrate and see: 'Formerly the [if player is in Clarthead Cathedral]Southward Shout Ward, then the Rote-Moan/Near-Moot Anteroom[else]Less Nice Silences, then Tapering Anger Pit/Inert Gap[end if].'"
sample maples	"On one, you read: 'Formerly the Maiden Median, then the Gent-Fora/Frat-Gone Frontage.'"
cut ya all cult laya	"One of the two designers['] names is [first custom style][one of]Clay Laut[or]Lucy Lata[in random order][r]."
sullenness us	"You focus on the voices swirling around, and a despairing bit of poetry appears in red: [first custom style]LE SUNLESS SUN[r]."
holy nest	"Scrawled in red on the holy nest is [first custom style][one of]ETHYLS? NO![or]EH, SLY? NOT![or]SLOTH YEN.[or]THY LENS, O![or]YE SOL, NTH.[or]ELTYN? SHO![in random order][r]"
stray satyr	"You see [first custom style]TSYRA[r] branded in red under the stray satyr's shoulder."
whistle	"[if player does not have whistle]You strain your eyes to see that [end if][first custom style]Ed Plye[r], apparently, made the whistle."

table of others readables
to-read	what-read	alt-read
eerie blurbs	"One reads [first custom style][one of][']ERE IS RUBBLE[or]REEL? RISE, BUB[or]RUBBER I ELSE[or]RUBLE BEE, SIR[or]REEL RUSE BIB[in random order][r], and it makes you see red." [others]
omen prism	"Looking into the omen prism, you see text form in red: [i][one of]Mr. Pinsome[or]One Ms. Prim[or]Moni's Perm[or]Nope, Mr. Sim[in random order][r]."
peanut cola	"The brand name is [first custom style]A PLACE UNTO[r]. It feels forced enough to make you see red."
riot cap	"It's red and [one of]made of [first custom style]I-TARP-CO[r] material[or]designed and shaped by [first custom style]CAPTOR-I[r], whoever they are[in random order]."	--
PSA Elp	"It says [first custom style]Pal! ESP![r] in red. Not very good advice, but maybe it will help in its own odd way."
stucco	"One of two advertisements is for [first custom style][one of]ScoutCon[or]SunCotCo[in random order][r], whatever that is, in red."
mad train	"[first custom style]DR. NIMATA[r]."
mean trowel	"It's designed by [first custom style]Newt L'Amore[r], along with [first custom style]Mr. Owen Late[r], to help you avoid a [first custom style]Moaner Welt[r]."
pipe panel lie pen app	"There's no red text, but there is a mention of how people finally tweaked it to contain gelatin, and also that a truly odd someone could enjoy living in it under the sea."
orange	"It's stamped with the word [first custom style]ENGARO[r] in red."
singed design	"The singed design on the [if player has coins or player has s-c]coins[else if player has coin]coin[else if player has icon]icon[else if player has icons]icons[else]BUG[end if] reads, when you look close, property of [first custom style]NISCO[r]."

volume general blather tables

[this appears across tables]

table of ordeal reload general blather
default-talker	gen-blah
Respect Specter	"'My past is not important. I can help you now, though, if you [b]SCAN[r] me.'"
Report Porter Perrot	"[bug-report]"
Mole Elmo	"[bug-report]"
Respect Specter	"'Unfortunately, I don't have time for small talk. The terms of my coming back here were to give helpful advice only if you SCANned me. I need to, um, respect that.'"

table of stores general blather
default-talker	gen-blah
Rehabs Basher	"[he-she-c] nods at you and the blabber babbler. It's remarkably effective psychological warfare, to repress you and all."
blabber babbler	"If [he-she] actually heard you, [he-she][']d yell a stunning rebuke to whatever [he-she] could pretend you'd say, then chalk your confusion up to drugs. You just want to get away from all this [b]TEDIOUS[r] stuff."
tokers	"The yawners aren't very answery, and you probably don't need a THC chat. They like you and all, but despite your adventuring, you'd never, like, invent a drug or do nothing as well as they do." [begin stores]
nestor	"'Whuh, whuut? Try asking me about, like, stuff instead. Not, you know, stuff.'"

table of routes general blather
default-talker	gen-blah
Brother Horbert	"[one of]'Saint Tina's Nun of No Fun left a list-o-toils for possible curse cures. Check thou it before proceeding, if you haven't.'[or]After a fret, he says, 'The list-o-toils!'[stopping] He seems pretty focused on that." [begin routes]
Pat	"'[one of]No dine. Done in[or]Not much to munch[or]Food? Us? Doofus[or]Sparest repasts[cycling]. No [pat-rant][randbla] or [randbla][pat-rant]. [pat-on-pit].'"
Oscar	"He's too grouchy to give much help here. He mutters on about slotted dottles--which, well, you [if player has pipe soot]already have pipe soot[else if read-list is true]don't think will help you get any pipe soot[else]don't know or care much about, now, yet[end if]."
Gast	"[Gast] is sort of controlling the conversation, and [he-she]'s bigger than you. You probably just need to sympathize and avoid getting hit by flailing limbs and so forth."

to say pat-rant: now pat-whine is whether or not pat-whine is false; [this is for asking pat anything to get random deli foods]

to say pat-on-pit: say "[if stupor sprout is off-stage]Can't even explore the seed pit[else]Don't have your guts to explore the seed pit, either[end if]"

table of troves general blather
default-talker	gen-blah
evil bee	"The bee just buzzes. That's what bees do."
spider	"Talking to animals? This isn't the way to get to the top!"
Si Reed	"Si Reed points to his head, then to yours, then smiles knowingly. Or you assume it's knowingly. 'Be an [first custom style]ID SEER[r] like me!' You see red at this stupid exhortation."

table of presto general blather [delete this]
default-talker	gen-blah
lamb	"It's a baaaaad conversationalist."
plebe	"Plebes aren't much for small talk. In fact, they get yelled at for that sort of thing. Hmm, maybe yelling the right way would make the plebe move."
Lev Tzoma	"[left-here].'"
Zo Mavelt	"[left-here].'"
Tom Avlez	"[left-here].'"
hogs	"They snort and laugh as if you are beneath speaking to or even wasting harsh words at."
bored yak	"The yak, not being very yakety, does not talk back."
giant dead flea	"It's sort of dead. Not that it was great conversation when it was alive."
Leo	"[lrduh]"
Rand	"[lrduh]"
computer screen	"[if screen is on labs slab]Yelling at a computer never works. If you need to say something, just say it[else]The screen isn't even plugged in[end if]."

to say left-here: say "'I was told I was left here to help someone who needed it and might need a clue and---well, they didn't tell me what the clue would be"

to say lrduh: say "'I dunno much about that. I like do stuff not think stuff.'";

section presto auxiliary

Leo-traveled is a truth state that varies.

after going north in Char Arch when Leo is eager:
	now Leo-traveled is true;
	continue the action;

book oyster

table of oyster general blather [delete this]
default-talker	gen-blah
pesty types	"The pesty types would probably think YOU were drunk if you told them why you were here or asked questions." [begin OYSTER]
trolls	"Talking wouldn't distract them from [if silly-acts is 3]eventually beating you up[else]keeping you in the Posh Hops Shop[end if]. They'd just win the argument. They're trolls, after all."
clam	"It snaps back at you. Physically, not verbally. Words--okay, conversation--won't help it relax, so you clam up."
Casper	"'[ohai-casper][randbla][ohai-casper][run paragraph on]' Casper mutters to nobody in particular."
scary crays	"They chuckle a bit. You're not going to be able to talk your way out of this."
trout	"[if trout is reflexive]He needs a pep talk. Guidance. Even if it's not 100% correct[else]He shrugs. The outside world is intimidating to him[end if]."
carps	"They snot nots. Tons. Brusque, queer BS. You need to take action, instead."
pikes	"They snot nots. Tons. Brusque, queer BS. You need to take action, instead."
aunt tuna	"'There is not much to say, with the haunter lurking under Anger Range, and the Horned Hedron assailing innocent people!' Looks like you won't nyet-a-yenta."
sandier sardine	"He flashes a snider look as he reads in to your talk. 'Ear dins. Wish I worked at Adrien's.'"
weaselly walleyes	"They snicker menacingly and whisper loudly that you're probably scared of lots of things like ghosts. They aren't. Not even the haunter!"
sausage	"It does that whoo-whoo thing. WHERE IS MY JEWEL. You think you know which jewel."
yapper	"The yapper does not shut up about unbribability but still manages to wink and cough at the same time. It seems you may need to do things the right way."
ant	"The ant twitches silently but menacingly."
dialer	"Your voice would be recognized as not evil enough, even if you got through."
intercom	"Your voice would be recognized as not evil enough, even if you got through."

to say ohai-casper:
	if casper-mumble is true:
		now casper-mumble is false;
	else:
		now casper-mumble is true;

table of towers general blather
default-talker	gen-blah
Spec O Scope	"Try looking in it instead."
dreads adders	"They can't speak. They seem happy enough just blocking you."
Andres	"[war-duh]"
Andrew	"[war-duh]"
Archie	"[war-duh]"
Barney	"[war-duh]"
Blake	"[war-duh]"
Bredo	"[war-duh]"
Cedrick	"[war-duh]"
Daryl	"[war-duh]"
Demitri	"[war-duh]"
Dewey	"[war-duh]"
Edwin	"[war-duh]"
Eldon	"[war-duh]"
Ernest	"[war-duh]"
Geno	"[war-duh]"
Goldy	"[war-duh]"
Leander	"[war-duh]"
Marcel	"[war-duh]"
Marlon	"[war-duh]"
Preston	"[war-duh]"
Reggie	"[war-duh]"
Royce	"[war-duh]"
Shane	"[war-duh]"
Terrance	"[war-duh]"
Tyson	"[war-duh]"
Wade	"[war-duh]"
Rodney	"This standoff won't be resolved with diplomacy."
denier nereid	"She discourages you from anything too adventurous. She sees you getting mad and says '[first custom style]END IRE[r],' which makes you a bit madder. You see red."
bluster butlers	"'If we let you by, we'd have to answer to our mentor, Les Burt!' You see red at the name."
snider diners	"They [one of]ignore you, asking [first custom style]is DERN[r] coming[or]talk about [first custom style]Dr. Enis[r][or]mention [first custom style]NERD IS[r] something unintelligible[in random order], until they're red[one of], but you sense they have a bit more to say[or], but maybe they have one more rant[stopping]." [bold-ok]
fluster self rut	"You feel agitated just talking to the rut, whether or not it decides to talk back. You press yourself hard to think what to ask, but no. That can't quite work."
organised ego drains	"The ego drains just aren't to be argued with without getting, uh, drained. Fortunately, they aren't stopping you from going anywhere."
pirates	"[one of]Harsh arrhs and the sound of shook hooks follow your attempt to converse.[or]'Yarrh, Harry,' they shout, and one of them makes fun of your skin tone. You feel like a spiter, hoping they get skin cancer.[in random order]"
lars eede	"He seems to want to talk, really, and at the same time, he doesn't. He keeps mumbling a sales pitch under his breath, and maybe if you listen a bit, you can remember it."
Elsa Erde	"She seems to want to talk, really, and at the same time, she doesn't. She keeps mumbling a sales pitch under her breath, and maybe if you listen a bit, you can remember it."
mardier admirer	"They claim they are really impressed with you, though of course you have faults you need to fix! [one of]Off-guard, red-faced, you mumble, 'I? Rad? Erm...' Maybe you can stomach another backhanded compliment[or]The mardier admirer focuses on comparing you to [first custom style]Red Irma[r] and [first custom style]Ed Mirra[r]. What a couple! Though you see red at the pairing[cycling]."
realist tailers	"[one of]'[first custom style]It's real[r],' the realist tailers assure you, whatever it is. You see red.[or]The realist tailers hope for more [first custom style]lit eras[r], which makes you see red.[or]You see red at the realist tailers['] lists of what may [first custom style]tire Sal[r].[cycling]"
natives site van	"You seem unable to convince the natives they are too good to park their site van here, or to find a way to sucker them into moving. However, they do babble on about [one of][first custom style]ST. EAVIN[r], the local church[or]the local [first custom style]SETI-NAV[r][or][first custom style]TIN EVA'S[r] bar[or]where to avoid [first custom style]AI VENTS[r][or]the local [first custom style]INVEST-A[r] stock broker[or]a local celebrity named [first custom style]SVETINA[r][or]the [first custom style]TIN-SAVE[r] recycling center[in random order], which makes you see red[one of]. Maybe there's more of that, if you can hack it[or][stopping]." [bold-ok]
sweatier wait seer	"'[first custom style][one of]Sit! We are[or]Trees! Aw, I[or]Trees! I, aw[in random order][r]...' the wait-seer says before going silent again. You see red."
duck	"It quacks."
Resident Trendies	"They sniff. They're too cool to hang around you, but they're also too cool to consider letting you by."
ingrates	"[one of]They swat imaginary red [first custom style]ire-gnats[r] as they brush you off[or]You're shocked by the [i]angriest[r] interruption imaginable[cycling]."
repents serpent	"[serp-say]."
alarming grailman	"'You do find me alarming, don't you? I always give 110%. No-one passes [first custom style]Liam Garn[r]!' You see red at the name."
bonker	"You try to chat but feel like a, er, knob."
stinger	"The grin set in the stinger distracts you from what you meant to say. You feel almost drunk, and hear a weird voice in your head. '[first custom style]Ginster! Ginster![r]' You see red."
Lois the Hostile	"She complains[hostile-red]!"
Hostile Is He Lot	"They complain[hostile-red]!"
promise imposer	"The promise imposer seems to talk about everything except what you want to. It makes you see red. Maybe that evasiveness can be a hint."
atheists	"They start logic-bashing, when one of the junior atheists tries to make a point. [one of]'[one of]Eh...I[or]I...eh[in random order]...stats why God can't exist.' [or]'Is theta's...'[or]'This tea's...'[or]'Ah, test is...' [or]Why, they should sell atheist gear like ties, hats. [or]St. Tiesha was, apparently, very nasty. [in random order]The atheist turns red, wondering if they had a right to speak up."
agnostic	"[if duck is not returned]'Hey! Do you know anything about making stuff? I read in the Turbine Tribune about making stuff that could cross the water! I wonder what's beyond there!'[paragraph break]'IDK, kid.'[paragraph break]'Oh, wait, you're just an adventurer, not someone who knows anything technical. Gosh, I didn't mean it like that. I just...don't have any information for you.'[else if gizmo is not moot]'Boy! If only I had a tool to create a bot boat!'[else]'Man! If I [boat-works], that'd be awesome! I wouldn't even care if they got lost. Just making stuff.'[end if]"
Dr Yow	"[if luck node is not moot][doc-in-prison].[else]'Ah yes! My rescuer! Thanks again! Are you interested in detailed technological phenomena? No?' [he-she-c] begins calculating on [his-her] fingers and working on an abstruse problem. [he-she-c]'s probably not going to help you much with grunt work, but [he-she] could help someone technical help you.[end if]"
Tetris Sitter	"[if itster is not moot][The tetris sitter] has nothing to say. Her game is too important[else if ur pine is not moot]St. Teri looks at your top opt pot, sadly[else if anodyne is touchable]St. Teri looks at you but can't help looking at [the anodyne][else if top opt pot is not moot]St. Teri looks at your top opt pot wistfully[else]'Old clues, eh?' She colludes: speculatively, circular, a polite ole tip about the Curst Palace. Make it [3-random]? 'No closure, counselor,' you lament, but her general tone and how she says it seem to do something for you. Maybe it'll help something pop in your head[new-mislit-clue][end if]."
keycar	"The keycar just randomly talks about itself. Conversation won't be interesting. Maybe you can find a way to quiet the keycar."

to say serp-say: say "[if serpent is reflexed]The serpent is motionless[else]The serpent just hisses[end if]"

to say war-duh: say "Rodney silences [the noun] from answering."

to say hostile-red:
	say " about something irrelevant to what you asked, which makes you see red: [first custom style][one of]the soil[or]the oils[or]St. Helio[in random order][r]. Hostile"

to say doc-in-prison: say "[he-she-c] gestures to the ropins and then shakes an invisible cage of [his-her] own. As if [he-she] is too exhausted to talk any more[if Dr Yow has been rowdy and Dr Yow has been wordy]. You figured two ways to get [him-her] to talk, and that's probably enough[else if Dr Yow has been rowdy or Dr Yow has been wordy]. Maybe Dr. Yow has a bit more expressiveness in [him-her][end if].";

to say boat-works:
	say "[if agnostic has gizmo]could make a bot boat here[else]could see if that boat works[end if]";

to say 3-random:
	sort table of magnifs in random order;
	say "[blurb in row 1 of table of magnifs]! [blurb in row 2 of table of magnifs]! [blurb in row 3 of table of magnifs]! He-he. Eh";

to say new-mislit-clue: now flip-final-clue is true;

table of otters general blather
default-talker	gen-blah
Ed Riley	"'Stay there in the rye, idle! Yielder!' he booms[ed-nonsense]. Be nice to quiet him down, somehow."
cinders	"You need to find the right way to ask them. One without speaking."
Le Mer	"[one of]It's kind of single-minded, but it's impressive the moat talks at all[or]Again, ethereal babbling[stopping]. '[if sea cube is not moot]You must convince me to unlock the sea cube[tho-need].[else if eels are not moot]The eels still distrust you[tho-need].[else]Your powers are regained. Go to your destiny![end if]'"
atmo moat	"The moat has nothing to say. If it did, it'd probably just say 'KEEP OUT.'"
Mr Lee	"[if gore ogre is moot]'You have gained my trust and your powers. Go on!'[else if ghoul hat is moot]You try to convince him you're the good guy, but--that's pretty obvious. You need to convince the Gore Ogre to flee[tho-eels].[else]You fail to get anywhere. Between the ghoul hat and the Gore Ogre, Mr. Lee looks petrified, hopeless[tho-eels].[end if]"
Gore Ogre	"'EORG EORG EORG!!!'"
Gretta	"[if player is female]The [players] block you from talking to her. They redouble their conversation, expecting her to be flattered she's getting more attention than you[else]The [players] manage to small-talk you down[end if]. Perhaps you need to get rid of them."
players	"'Talking's stalking,' they yell at you before continuing to hit on Gretta."
eels	"[if eels are reflexed]'Eels...' / 'Fib-beliefs?' Their attention span seems short, and they have little to say. You need one word, useless on its own yet powerful.[else]They seem to have their minds on other things now that they helped you.[end if]"
Elmer	"[mon-men]"
Merle	"[mon-men][no line break]"
sly imp	"It could talk circles around you as-is. So talking may not be the way to get past it."
whiners	"Rational conversation won't make the whiners budge. You probably need to make them quieter."
hardy hydra	"Roooooooar."
ocelots	"[if ocelots are reflexive]Flimsy I'm-flys[else]'You're cool.'[paragraph break]'You? Cooler!' You feel [one of]encouraged by this exchange, impressed they got away with that[or]awkward about this repeat, but they don't--there's just nothing else to say around them[stopping][end if]."
badger	"[uf]"
leopard	"[uf]"
satyr	"[uf]"
hornets	"The hornets just buzz."
snipe	"The snipe rustles back and forth a bit."
racoon	"The racoon skitters around."
snail	"Schlurrrp."
owls	"They're too busy swooping at you to talk."
raptor	"'Roooooooar.'"
parrot	"[if Merle is touchable]Don't blow his cover![else]'Fear the feather! A bird, rabid!' He's got revenge fantasies, but not in his current state--or here."
Elvira	"'I watch a witch,' you mutter. 'Nice try. Tiny rec. Y'cretin.' You're not going to out-debate the vexin['] vixen."

to say tho-need: if power-back is true, say ", though I feel you may not need the eels['] energy"

to say tho-eels: if power-back is true, say ", though you wonder if you need a double-charge after talking to the eels"

to say mon-men: say "'We're Elvira's monster mentors. Making REAL animals. You don't need Eden.' They [if Merle is reflexive][one of]babble a bit about the philosophies of Lhen Yost[or]prissily swear Elsy Noth is ruining kids['] morals[or]pay sycophantic respects to St. Hoylen[or]discuss how they have to talk shy to Len[or]wonder if they should pull out the ole synth[or]discuss the philosophies of Lytheson[in random order], which leaves you seeing red[else]continue semi-squabbling[else]ignore you--you seem easy to push around[end if]."

table of others general blather
default-talker	gen-blah
Curtis	"'Ehh?' says Curtis. 'I don't have time for small talk. More fruit, more fruit.'" [begin others]
Len Craig	"[one of]Len proceeds to tell you how he was known as Icy Len til he started doing things nicely and even suggests you use nonverbal cues as a way to get an edge. You get the feeling you asked about something irrelevant, but that advice might help you in general[or]Len's eyes glaze over a bit. Nothing personal, just business[stopping]."
Ammo Gang	"The No Ammo Gang seems vaguely interested, but you didn't insert yourself enough as part of the conversation."
Art Erd	"[he-she-c] mumbles 'er, drat' and then something about how money is very, very nice."
Dr Tera	"[he-she-c] mumbles 'er, drat' and then something about how money is very, very nice."
Reserved Deserver Dr Severe	"Shockingly, [deserver] has very little to say."
promise imposer	"The promise imposer also seems to like to impose silence."
passport	"Try using its features instead."

volume reflexive blather tables

table of ordeal reload reflexive blather
him-asked	him-told
Report Porter Perrot	"Perrot's views would be biased."
Elmo	"You already know about his mission and what he's done to help you. No time for small talk."
Respect Specter	"'I'll give you help if you [b]SCAN[r] me. But as an undead, I can't talk much beyond what's allowed.'"

table of stores reflexive blather
him-asked	him-told
nestor	"[if store k is touchable]'Want...friends...man!'[else]'Friendship, all you need, dude!' Nestor smiles at the tokers.[end if]"
tokers	"[if store n is touchable]'Missing our friend, man!'[else]You get the impression there's not much to ask.[end if]" [bold-ok]
blabber babbler	--
Rehabs Basher	"'I'm nothing without [bab-name]'s help.' This continues for a minute, after which you sort of wish the Rehabs Basher WOULD be, or say, nothing. How [i]tedious[r]." [bold-ok]

table of routes reflexive blather
him-asked	him-told
Brother Horbert	"He mentions he cannot do much--the Same Mesa needs magic to undo the curse, but the list-o-toils is on the wall[if list o toils is examined], as you've seen[end if]." [reflex ROUTES]
Gast	"[Gast] is already talking about [him-her]self, [his-her] complaints, and so forth."
Oscar	"'I'm just this guy, in this house, with that ashtray [if pipe soot is in adobe]full of nice smelling pipe soot[else]some self-appointed do-gooder cleaned out. Well, I can make more[end if].' Nope, he doesn't seem to have much to say."
Pat	"'[one of]No dine. Done in[or]Not much to munch[or]Food? Us? Doofus[cycling]. No [pat-rant][randbla] or [randbla][pat-rant]. [pat-on-pit].'"

to say pat-rant: now pat-whine is whether or not pat-whine is false; [this is for asking pat anything to get random deli foods]

to say pat-on-pit: say "[if stupor sprout is off-stage]Can't even explore the seed pit[else]Don't have your guts to explore the seed pit, either[end if]"

table of troves reflexive blather
him-asked	him-told
Trevis Vister	"Oh, if it were the real version, you'd regret asking him about himself."
Si Reed	--

table of presto reflexive blather
him-asked	him-told
plebe	"You figure you should grill him about how worthless he thinks he is, but you lack the right word or words."
Rand	"Rand gives a whole new dimension to small talk. But not for long, thankfully."
Leo	"Leo gives a whole new dimension to small talk. But not for long, thankfully."
hogs	"The whole 'Who do you think you are' won't go well with these hogs. They're here to guard you from what's beyond, and that wall is helping."
Zo Mavelt	"'If you scan me and go north, I'll go away, and someone else might appear.'"
Tom Avlez	"'If you scan me and go north, I'll go away, and someone else might appear.'"
Lev Tzoma	"'If you scan me and go north, I'll go away, and someone else might appear.'"

table of oyster reflexive blather
him-asked	him-told
trolls	"They'd affirm their right to privacy before asking YOU personal questions. Trolls, sheesh."
pesty types	--
Casper	"[mumble-swap]Once he starts talking about himself, he won't stop. All sorts of random stuff: '[randbla]'[mumble-swap]"
clam	"Asking the clam about its feelings is a start."
sabot boats	"They're too far away for proper conversation. Maybe you can do something bold to show them you're worth having aboard."
carps	"Asking these punks who they think they are won't stop them."
pikes	"Asking these punks who they think they are won't stop them."
trout	"[if trout is in Anger Range]You don't need to ask if he's being picked on,[else]'Well, I try my best and stuff.'[end if]"
aunt tuna	"She's talking about herself every move, pretty much[if trout is reflexive]. You can probably help Tortu instead[end if]."
sardine	"[one of]The sardine spends time babbling about his sensitive hearing, saying you couldn't possibly understand. But you sort of do[or]You don't want to hear the sardine on himself again[stopping]."
sausage	"It makes ghostly noises and talks about how it wants its jewel back."
walleyes	"Now's not the time to upbraid baddies for being bad. Sneak past them instead."
yapper	"'I'm a dedicated public servant. I'm not paid to chat. But I'm not paid enough to keep you out, no matter what.' He winks."
agnostic	"'I like gadgets and building things! [if bot boat is off-stage]I just need one more cool tool[else]I'd love you to try my boat, here[end if]!'"

casper-rand-mumble is a truth state that varies.

to say mumble-swap: now casper-rand-mumble is whether or not casper-rand-mumble is false;

table of towers reflexive blather
him-asked	him-told
dreads adders	"The adders sit around and look intimidating."
repents serpent	"[serp-say]."
realist tailers	--
denier nereid	--
lois the hostile	--
hostile is he lot	--
natives site van	--
snider diners	"'Can't talk with our mouths full,' they exclaim, dryly. You'd like to rain on their parade, even a little. You seem to have interrupted their talk, and maybe LISTENing would help."
sweatier wait seer	--
promise imposer	--
bluster butlers	--
unripe ur pine	--
resident trendies	--
fluster self rut	--
pirates	--
keycar	--
grailman	--
Lars Eede	--
Elsa Erde	--
bonker	--
stinger	--
ingrates	--
organised	--
mardier admirer	"'But enough about me! What about you?' You need a way to make them less interested in you."
Dr Yow	"Dr. Yow is too modest--and focused on [his-her] science--to bang on about previous achievements or imprisonment."
atheists	"'[one of]This eats...'[or]Set, it has,'[in random order] they muse languidly over some philosophical point. You feel dumb not being able to figure it out, but you feel sort of compelled to listen for more."
Tetris Sitter	"[if top opt pot is moot][The tetris sitter] thanks you for aiding her spiritual growth. Just go out and come back in if you need help with that palace[else if anodyne is moot]St. Teri looks almost perfectly ready to help, but she can't quite, yet[else if itster is not moot]St. Teri wants to help, but she can't quite, yet[else][The tetris sitter] ignores you, working on her high score[end if]."

table of otters reflexive blather
him-asked	him-told
Ed Riley	"'I'd ... LEERY!' Ed booms, puffing himself up a bit."
whiners	--
players	"Their opinion would be slightly biased. You can probably learn more about them by observing them."
Gretta	"She's got enough people asking about her right now."
Elmer	"'Slightly more interesting than my friend.'"
Merle	"'Slightly more interesting than my friend.'"
Mr Lee	--
gore ogre	--
le mer	--
eels	--
snail	--
hornets	--
racoon	--
ocelots	"[if ocelots are reflexive]They seem too shy to talk[else]They point to themselves and give a thumbs up[end if]."
satyr	--
leopard	--
badger	"[if badger is reflexive]It covers its exposed parts and turns away[else]It fumbles happily with its now-clothed chest[end if]."
sly imp	"It nods its head as if to say it's all right and it knew you'd ask."
Elvira	"She sniffs haughtily. As if you have to ask! As if you're NOT too biased to believe the good things about her!"

table of others reflexive blather
him-asked	him-told
Curtis	"'The more fruits, the better, for my biotech business. Unfortunately, those disgusting yorpberries Elvira made folks plant elsewhere aren't good for much.'"
Len Craig	"'I'm a businessman. A trader. All kinds of goods to swap. Let's haggle.'"
ammo gang	"They are low on conversational ammo, too, but you get the feeling they'd just like you around. Well, not quite around."
Art Erd	"'Traded a dead rat...' he mumbles."
Dr Tera	"'Traded a dead rat...' she mumbles."
passport	--

section others auxiliary

check asking Curtis about: if second noun is a fruit, say "'[if second noun is moot]Yes, thanks for that, again[else]That'd work well, yeah[end if].'" instead;

volume specific subject dialogue tables

table of ordeal reload subject blather
him-who	person-subj	him-say
Elmo	settler	"This shouldn't be available."

table of stores subject blather
him-who	person-subj	him-say
Rehabs Basher	blabber babbler	"The [Basher] nods enthusiastically."
Rehabs Basher	Elvira	"'She didn't get to her position of power by using DRUGS.'"
nestor	Elvira	"'So bogusly repressive!'"
nestor	Store N	"'Man, it was actually kind of sort of like fun in there. Until it wasn't.'"
nestor	tokers	"[if tokers are touchable]Nestor gives them a thumbs-up, they cheer drippily, and he cheers back[else]'Dude! Could you magic them back somehow?' he pleads[end if]."
tokers	Store K	"'Man, it was actually kind of sort of like fun in there. Until it wasn't.'"
tokers	Elvira	"'A bummer of authoritarianism, dude! She says her personality is all the drug you need!'"
tokers	nestor	"[if nestor is touchable]They thank you for finding him[else]They weep at hearing the name of a lost friend[end if]."
tokers	mangiest steaming	"[if Cruelest Lectures is visited]You know more about it than they do[else]'Er, free reefer!' they say. Going through those fumes might provide experience, of a sort[end if]."
blabber babbler	Elvira	"You probably missed the pro-Elvira introduction, which is all for the better."
blabber babbler	blabber babbler	"You probably don't have to ask to hear the blabber babbler's personal anecdotes."

table of routes subject blather [ask x about thing they know about]
him-who	person-subj	him-say
Brother Horbert	spoon	"'[if spoon is moot]I hope you used it wisely[else]It may help you figure where to go[end if].'"
Brother Horbert	mantle	"[one of]Brother Horbert shudders a bit[or]Best not to press him[stopping]."
Brother Horbert	list o toils	"[if list o toils is unexamined]Why not examine the list yourself?[else if stupor sprout is off-stage]You've gotten everything.[else if number of held quest-items is 0]You tell Brother Horbert you haven't found any items on the list. He says he has faith in you.[else]You show Brother Horbert your progress. He nods and smiles.[end if]"	[horbert tells about quest items elsewhere]
Brother Horbert	form	"[if form is off-stage]Brother Horbert mutters something about the gift of second sight.[else]Brother Horbert says, 'If you found the reagents, surely dealing with that form will be easier!'[end if]"
Brother Horbert	Pat	"[lost-faith]"
Brother Horbert	Oscar	"[lost-faith]"
Brother Horbert	Gast	"'Well-meaning, but [his-her] wrath is misplaced. I can hear [him-her] from here. You [if Gast is moot]did well to listen to [him-her][else]may profit from listening to [him-her], but there is really nothing to fear[end if].'"
Brother Horbert	Elvira	"'Perhaps she was good once. But her influence on religion is...disturbing.'"
Gast	sit a nag	"There's not much dispute over the ownership. And [Gast] isn't trying to shoo you away. Maybe you should listen to [him-her] in general."
Gast	Elvira	"[Gast] becomes momentarily more vocal and upset."
oscar	ashtray	"[if player has pipe soot]Best not to call attention to your thievery.[else]'It's not pretty, but it's mine.'[end if]"
oscar	pipe soot	"[if player has pipe soot]You don't need to mention you have it.[else]'Potpourri. Don't think you can just take it with me looking.'[end if]"
oscar	pat	"'I went there once. That seed pit...ugh.'"
oscar	Gast	"'Keeps my home less quiet, I'm sure!'"
oscar	Brother Horbert	"'[bh-mw].'"
oscar	Elvira	"'Hmph. Glad she's kept away from ME, so far.'"
oscar	oscar	"Oscar grumbles. 'I'm ME, you know?'"
pat	pat	"'Still holding on to the Idle Deli here.'"
pat	seed pit	"'[if stupor sprout is off-stage]It scares[else]Well, it didn't scare YOU, but it'll still scare[end if] customers. It was nicer before the Poison Stripe, but I can't afford to remove it.'"
pat	oscar	"'Him and his filthy pipe. Not welcome here.'"
pat	Gast	"'Probably not good for business.'"
pat	Brother Horbert	"'Brother Horbert means well, but he's too unfocused to DO anything by himself.'"
pat	Elvira	"'Business is bad enough. I don't need trouble with her.'"

to say lost-faith: say "'One of many of my flock who have lost faith they can help.'[no line break]";

to say bh-mw:
	say "Brother Horbert means well, but he's too unfocused to DO anything by himself"

table of troves subject blather
him-who	person-subj	him-say
Si Reed	Elvira	"Si Reed nods pointedly."

table of presto subject blather
him-who	person-subj	him-say
plebe	Elvira	"[one of]The plebe looks distinctly uncomfortable but nods. Perhaps they don't agree with Elvira, but their job is to serve and protect, blah blah, especially when intimidated by authority. Hey. Maybe you could be that authority[or]You don't need to ask them again. They, like any good plebe, are intimidated by authority[stopping]."
plebe	Leo	"[if leo is touchable]You tell the plebe Leo might push him aside, but no dice. Maybe a brutish word, not brute force[else]Leo would be more intimidating if he were nearby[end if]."
plebe	Rand	"[if rand is touchable]You tell the plebe Rand might push him aside, but no dice. Maybe a brutish word, not brute force[else]Rand would be more intimidating if he were nearby[end if]."
Rand	yak	"[pal-yak]" [chum=Leo]
Rand	plebe	"[no-plebe]"
Leo	hogs	"[if Saps Pass is unvisited]You haven't seen any hogs yet.[else if lawl wall is moot]'Dat was fun. You was clever.'[else]'If only you was our size, we could just take [']em. But you ain't. No offense. Maybe you can out-clever [']em like you did us.'[end if]"
Rand	Leo	"[if Rand is washed up and Leo is washed up]'We're washed up, boss. We could use a nice word.'[else if Rand is fightin]This is no time for conversation![else]He flashes a thumbs-up at his friend.[end if]"
Leo	Rand	"[if Rand is washed up and Leo is washed up]'We're washed up, boss. We could use a nice word.'[else if Leo is fightin]This is no time for conversation![else]He flashes a thumbs-up at his friend.[end if]"
Leo	Elvira	"'I guess she's good but I'm not smart enough to know why.'"
Rand	Elvira	"'I guess she's good but I'm not smart enough to know why.'"
Lev Tzoma	Elvira	"'I'm safe from her in this maze. I think?'"
Zo Mavelt	Elvira	"'I'm safe from her in this maze. I think?'"
Tom Avlez	Elvira	"'I'm safe from her in this maze. I think?'"
Zo Mavelt	volt maze	"[maze-end-clue].'"
Lev Tzoma	volt maze	"[maze-end-clue].'"
Tom Avlez	volt maze	"[maze-end-clue].'"
Zo Mavelt	Lev Tzoma	"'[maze-later].'"
Zo Mavelt	Tom Avlez	"'[maze-later].'"
Tom Avlez	Lev Tzoma	"'[maze-later].'"
Tom Avlez	Zo Mavelt	"'[maze-before].'"
Lev Tzoma	Zo Mavelt	"'[maze-before].'"
Lev Tzoma	Tom Avlez	"'[maze-before].'"
hogs	popgun	"They snicker at the memory."
hogs	Rand	"They size him up and give a thumbs-down. Then they give you a double thumbs-down. Ouch! No respect."
hogs	Leo	"They size him up and give a thumbs-down. Then they give you a double thumbs-down. Ouch! No respect."
hogs	keys	"They snicker at the thought of you being clever or strong enough to get the keys."
hogs	Elvira	"They snicker and nod."
hogs	yourself	"The hogs smirk and flex a bit, to show they're bigger and stronger."

to say plebe-threat of (per - a person): say "[if per is touchable]You tell the plebe [per] might push [him-her] aside, but no dice. Maybe a brutish word, not brute force[else]The plebe wouldn't go AWOL over to [Dirge Ridge]. You can take care of them and [per] in any order[end if]."

to say pal-yak:
	say "'[if yak is touchable]'Dat thing looks sleepy but it'll bite your hand off[else if Leo-traveled is true]'Dat yak we saw is too heavy for us! But I bet even you could push it around yourself. No offense[else]'My mouf? Oh, a yak, not a yap[end if].'";

to say no-plebe: say "'I respect da military too much to push him outta da way. Plus I can't yell clever neither.'"

to say maze-end-clue: say "'I was told not to congratulate myself if I made it to the start, from point Z to point A. Not that I was told the way through";

to say maze-later:
	if guide-loop is true:
		say "[maze-you-met]";
	else:
		say "Oh! He'll drop by later. I hope you don't need his help too much"

to say maze-before: say "[maze-you-met]"

to say maze-you-met: say "Oh! You met him? I hope he helped you a bit. He told me about the weird scanner you have"

table of oyster subject blather
him-who	person-subj	him-say
LOLstr trolls	OH NERD HERD NO	"'The horned hedron's even more fun than here. Maybe we can get a job there some day.'"
LOLstr trolls	Casper	"[one of]'A great man! We're sure his books are great, if you have nothing better to do than read. But he LIVED his books.'[or]'Wanna know about him, ask HIM.'[stopping]"
LOLstr trolls	Elvira	"'An inspiration and an example to keep our job fun!'"
LOLstr trolls	capers	"[if stein is moot][yeah-cute][else]'Hard-hitting stuff, we're sure. He's told us what's in there. Poke at it wrong, you'll upset the man himself.'[end if]"
LOLstr trolls	stein	"[if stein is moot][yeah-cute][else]'Don't go putting it somewhere stupid and breaking it.'[end if]"
LOLstr trolls	tunes	"[if tunes are moot][yeah-cute][else]'Don't be messing with the tunes or the amper on the jukebox. Annoy a lot of people.'[end if]"
LOLstr trolls	gins sign	"[if sign is reflexed][yeah-cute][else]'Lotsa people think they're really cute, like they've got something special can make them disobey that sign.'[end if]"
LOLstr trolls	tips pits	"[if tips pits are reflexed][yeah-cute][else]'Best to cough up some tips in there. For the wait staff.'[end if]"
LOLstr trolls	sausage	"[one of]'Hasn't bugged us yet. What, you scared of it? Aww.'[or]Asking again would just make them snicker more.[stopping]"
pesty types	Casper	"'Weirdo. With his books. Even if they're books where people drink a lot.'"
pesty types	LOLstr trolls	"'They rather keep us in and make us spend more than kick us out.'"
pesty types	Elvira	"You endure annoying pro- and anti-Elvira half-drunken banter for a bit."
Casper	sausage	"'I heard it's buried on the other side of the shore. Need to bring it something lost.'"
Casper	LOLstr trolls	"'They are rough and ready types. I will include some of their gritty dialogue in Capers Recaps. With their permission, of course.'"
Casper	capers recaps	"Casper wants you to acknowledge he's writing it, but he's not going to hand out spoilers."
Casper	Elvira	"'She certainly knows how to seek out power. She showed that anagram chump what's what. [if player is female]She's no woman[else]He's no man[end if] of action.'"
carps	trout	"[mean-fish]!" [chum=pikes]
carps	Aunt Tuna	"[mean-fish]!"
carps	Casper	"They probably like books more violent than Casper Spacer's. If they read at all."
carps	Elvira	"'All the cool kids look up to her.'"
carps	sausage	"They are probably too coo-ool for ghost stories."
carps	pikes	"You could maybe set them against each other, but really, you're the strongest...life form here."
pikes	carps	"You could maybe set them against each other, but really, you're the strongest...life form here."
pikes	Elvira	"'All the cool kids look up to her.'"
trout	carps	"[if player is in Anger Range]You can ask about them later. They're pretty clearly picking on him here[else if trout is reflexive]He gives a blank look of fear[else]He feels like he can handle them and their taunts now[end if]."
trout	Elvira	"'I heard those carps and pikes liked her.'"
trout	sausage	"'S-s-s-scary[if trout is reflexed], even after you helped me[end if]!'"
trout	pikes	"[if player is in Anger Range]You can ask about them later. They're pretty clearly picking on him here[else if trout is reflexive]He gives a blank look of fear[else]He feels like he can handle them and their taunts now[end if]."
trout	aunt tuna	"[if carps are touchable]The carps are already asking mean questions.[else]'She sure is grateful you rescued me.'[end if]"
trout	Casper	"'I don't like his books. Too violent. But Aunt Tuna thinks I read the dirty bits, anyway.'"
aunt tuna	casper	"'Those books of his! I cannot approve.'"
aunt tuna	tea	"'[if tea is moot]Goodness! I cannot share the recipe[else]Try it! You'll like it[end if].'"
aunt tuna	pikes	"[bbbullies]."
aunt tuna	carps	"[bbbullies]."
aunt tuna	sausage	"'It is searching for a stolen treasure. They say it will wreak terrible havoc on the possessor.'"
aunt tuna	walleyes	"[fish-these-days]."
aunt tuna	sardine	"[fish-these-days]."
aunt tuna	yapper	"[fish-these-days]."
aunt tuna	OH NERD HERD NO	"'The Horned Hedron is a terrible place full of horrible people! But we cannot organize to drive them out.'"
aunt tuna	Elvira	"'A horrible person! No, I have never met her. But Yorpwald is the worse for her arrival.'"
aunt tuna	trout	"'He is a good boy despite no fine uncle influence, [if trout is reflexed]and you have helped him to ward off those weirdos so wired in the future[else]but those weirdos so wired may still pick on him[end if].' Tortu blushes at being treated like he might be eavesdropping."
aunt tuna	ruby	"Aunt Tuna wouldn't believe you knew anything about the jewel[if player has ruby], and seeing it might cause her heart failure[end if]."
aunt tuna	Casper Spacer	"'A vile man, I'm sure! And those BOOKS of his! Or so I've heard!'"
sardine	sausage	"'I'd be scared of it, if it existed. And if I was the one stole its jewel. We all would. Well, weak-os are, anyway.'"
sardine	Elvira	"'I wouldn't have this job if it weren't for her.'"
sardine	OH NERD HERD NO	"'I work here. Well, I guard the outside.'"
sausage	ruby	"It acts all ghostly and asks you to take it where the ruby might be."
sausage	Elvira	"'Horrible! Broil her!'"
walleyes	sausage	"'Anything to keep the sheeple scared.'"
walleyes	ruby	"'Bet we could sell it to raise funds for the Base! But we'd keep a nice cut.'"
walleyes	sardine	"'We'll have fun narcing him out for letting you in. What? He's already gone? Eh.'"
walleyes	Casper	"'Nice books, love the violence, but too many big words.'"
walleyes	Horned Hedron	"'Nice place, eh? Especially for not being very nice at all!'"
walleyes	Elvira	"'Helps fund our little social club here.'"
yapper	dialer	"'Very complex machinery! Shouldn't be used without proper certification.'"
yapper	gleaner	"'Very pretty! I--well, I know a friend who could be bribed by it.' The yapper winks."
yapper	Casper	"'That one book. About how beating people up was more fun than riches? Rubbish.'"
yapper	ruby	"'The ruby would've been a good gift, but it's gone, now.'"
yapper	sausage	"'I'm sure I'm safe from it here. Unless--that pearl's not its jewel? No? Good.'"
yapper	sardine	"'Pft, foot soldiers, working for mere salary.'"
yapper	walleyes	"'Pft, foot soldiers, working for mere salary.'"
yapper	Casper	"'Too much violence in his books, not enough money making.'"
yapper	Elvira	"'She's called on the dialer a few times.'"
yapper	OH NERD HERD NO	"'That's where we are.'"

to say yeah-cute: say "[if silly-acts is 1]The LOLstr trolls patronize you not to try any more funny stuff.[else if silly-acts is 2]The LOLstr trolls mention they can still take a little more of your destructive nonsense. They've seen worse. And dealt with it, too.[else]The LOLstr trolls shoot you a look that says both stay here and get lost at once. Best not to bait them any more.[end if]";

to say mean-fish:
	say "They'd have nothing nice to say, and you don't need to encourage them. Take action instead";

to say bbbullies: say "She seems more worked up about them than Tortu was[if trout is reflexed], even after your lesson[end if]. But she means well"

to say fish-these-days:
	say "Aunt Tuna probably has a lecture prepared about fish these days. One that won't help you go hunt a hangout";

table of towers subject blather
him-who	person-subj	him-say
butlers	Elvira	"'Well, you'd think she'd want someone active working as bouncers, but she wants quieter. What's up with that?'"
diners	Elvira	"The diners extol her taste in food. Any drip knows she's no wet blanket."
denier nereid	Elvira	"The denier nereid mentions Elvira is one person not worth denying."
pirates	Elvira	"The pirates explain colorfully how Elvira's rule has been good for piracy. Not the software or music sort that deserves jail time, but the stuff that takes real guts."
sweatier	Elvira	"The wait-seer frowns and shrugs and seems to sit extra hard, as if waiting for her reign to end."
sweatier	curst palace	"The wait-seer points to the palace and shrugs, as if to say, why?"
ingrates	Elvira	"'She's been terrible for Yorpwald! But anyone else would be even worse. That's life!'"
mardier admirer	Elvira	"'You both have your faults and your good sides. You might have more faults than her.'"
mardier admirer	curst palace	"'Well, I bet you could make it there. You're clever enough, but what would you do once you got there?'"
imposer	Elvira	"'She has promised so much to Yorpwald! We must promise back to her.'"
grailman	Elvira	"'Even--or especially--Elvira does not deserve to see the grail yet. One of the two. I'm not sure.'"
grailman	curst palace	"'You can get there without getting by me, I bet!'"
realist tailers	Elvira	"'Elvira certainly has shaken things up around here! We keep away from politics, but she does tweak the sort of people we hate!'"
resident trendies	Elvira	"'We've got lots of good reasons to like her, but if she's defeated, we'll have lots of good reasons why we should've never trusted her.'"
Lars Eede	Elvira	"'If it weren't for her I wouldn't have this job. Which kind of stinks, but...'"
Elsa Erde	Elvira	"'If it weren't for her I wouldn't have this job. Which kind of stinks, but...'"
tailers	Elvira	"'Elvira certainly has shaken things up around here! We keep away from politics, but she does tweak the sort of people we hate!'"
atheists	Elvira	"The atheists begin yelling FACTS about Elvira, pro and con, very loudly back and forth. They contradict each other quickly. You're sorry you asked."
lois the hostile	Elvira	"'I could do even better than her...Yorpwald is missing out...'"
hostile is he lot	Elvira	"'Any one of us could do even better than her...Yorpwald is missing out...'"
organised	Elvira	"Staring at the ego-drains for a bit, you have to admit Elvira shows leadership, initiative, etc. You turn away feeling more self-conscious than before."
natives site van	Elvira	"The natives mention she says everyone deserves their own place, unless they're lame, which the natives aren't."
natives site van	curst palace	"'Why go there when you could live in the Wildest Wilteds?'"
fluster self rut	Elvira	"You hear nothing and imagine Elvira laughing at you."
bonker	Elvira	"'She has increased bonker production by 1000%!'"
bonker	curst palace	"'It must be guarded by a thousand like me!'"
agnostic	Dr Yow	"[if agnostic is lonely and Dr Yow is in ropins]'I heard [he-she] was imprisoned. But I'd love to learn from [him-her].'[else if agnostic is lonely][one of]'Wow! You rescued [him-her]? You're almost as awesome as [he-she] is!' [ag-fol][or]'Tell me something I don't know. Or get Dr. Yow to. No offense'[stopping][else if agnostic is following]'I wanna see Dr. Yow!'[else][he-she-c]'s zoned you out, what with Dr. Yow [yow-around-gone].[end if]"
agnostic	Elvira	"'I don't get why other people say she's so cool. They say I'm too lazy to.'"
agnostic	bot boat	"'Man, I'm learning to build stuff! [if bot boat are off-stage]Like a bot boat! [end if]But I need someone to try them.'"
agnostic	keycar	"'Those things are annoying! But it'd be neat to know how they worked.'"
agnostic	curst palace	"'It's big and scary! But it'd be fun to live in if it weren't.'"
agnostic	atheists	"'Boy! Tell them religion has a point, and they get huffy. Thanks for deep-sixin['] [']em!'"
agnostic	hostile is he lot	"'Boy! Ask one question about their religion, they get huffy. Thanks for deep-sixin['] [']em!'"
agnostic	lois the hostile	"'Boy! Ask one question about her religion, she gets mad. Thanks for deep-sixin['] her!'"
agnostic	settler	"'Wow! I'm real impressed with who built this! Whatever it is. [if bot boat is touchable]All I can build is mechanical stuff[else]I'd like to build something, too[end if].'"
agnostic	gizmo	"[if gizmo is off-stage]'I could use a weird tool to build things.'[else if player has gizmo]'Wow! Maybe if I knew how to build something, I could have it?' You could probably [b]GIVE[r] it to the agnostic, once [he-she]'s inspired to build something.[else]It's be kind of rude to ask for it back. The agnostic'll use it better anyway."
agnostic	duck	"'I'm not real big on biology. But I guess ducks are cute.'"
agnostic	toaster	"[if toaster is in Actionless Coastlines]'Gee, thanks for that! I'll do something cool to, I mean with, it!'[else if toaster is in Topside Deposit]You think back to the toaster [hereish of Topside Deposit]. It might be worth giving to [agnostic], as a nice gift, if you ever leave.[else]You show the toaster to [agnostic], who's very interested, but [he-she] says [he-she][']d feel guilty taking it before actually helping you.[end if]"
Dr Yow	duck	"[if Shaven Havens is unvisited]'I miss my duck! When they captured me, I was clear in a west waste.'[else if duck is not in Obscurest Subsector]'I--I'm too exhausted to get my duck. If you could bring it back--it just needs to hear my voice.'[else]'Very loyal to me. It might ignore you now, but...thank you.'[end if]"
Dr Yow	gizmo	"[if Dr Yow is in ropins]'Not enough sharp edges. It's for making things...crafting.'[else]'I'm too tired to make anything, but maybe an eager apprentice...it's a newfangled device for younguns anyway.'[end if]"
Dr Yow	bonker	"[one of]Dr. Yow facepalms a bit. You can imagine listening to that bonker was even worse if you were imprisoned, too[or]No need to dredge that up, again[stopping]."
Dr Yow	lake	"[doc-on-lake]"
Dr Yow	agnostic	"[if agnostic is in Actionless Coastlines]'It would be fun to tutor someone!'[else if agnostic is in Obscurest Subsector]'I bet I could teach [him-her] if I kept it interesting and exciting.'[end if]"
Dr Yow	Elvira	"Elvira probably had Dr. Yow put here, so you decide against asking."
Tetris Sitter	Elvira	"'[if top opt pot is not moot]She drags us all down[else]I feel like she doesn't have to drag us down any longer. I will do what I can to help you with the curst palace, if you need[end if]!'"
Tetris Sitter	curst palace	"'It can be something super special. [3-random]? If only...' You got no concrete clues, but St. Teri's observations were a help[new-mislit-clue]. Maybe you can come back for another, later, if you still have no luck outside."
Tetris Sitter	crocus	"[if anodyne is touchable]'Flowers? I almost could... no offense, but I'm not quite in the right mood, yet.'[else if itster is not moot]'Flowers? Oh, I don't know. They're nice, but ... they only help so much.'[else if top opt pot is moot]Don't push-poll her about your generosity.[else if crocus is in top opt pot]Just give her the crocus.[else]'I haven't enjoyed flowers for a long time.'[end if]"
Tetris Sitter	top opt pot	"[if anodyne is touchable]'Nice, yes, but...' You seem to need one more thing to change St. Teri's mood.[else if itster is not moot]'Worthless, with or without a flower in it.'[else]'From Renato, eh? Very nice.'[end if]"
Tetris Sitter	Ornate Atoner Renato	"[if itster is not moot]'There's a name. I sort of miss him.'[else if top opt pot is moot]'Thank you for passing his wonderful gift on to me.'[else]'I miss him. I'd like any sign from him.'[end if]"

to say yow-around-gone: say "[if Dr Yow is touchable]around[else]gone"

to say doc-on-lake:
	if agnostic is in Obscurest Subsector:
		say "The agnostic almost seems to interrupt you saying the lake isn't THAT far across.";
		continue the action;
	if agnostic is in Actionless Coastlines:
		say "'It's treacherous to get across the lake. I am too physically tired to make anything[if Dr Yow is in ropins] even if I escaped[end if]. I could use an apprentice. Maybe you. Or you can find me one.'";
		continue the action;
	say "'My student will help you--there may be some risk. The carelessness of youth. You may be surprised what can be overlooked.'[run paragraph on]"

section towers auxiliary

before objasking agnostic about bot boat:
	if bot boat is off-stage, say "'Ooh, I'd like to make one. I just don't know enough, yet.'" instead;
	try entering bot boat instead;

book otters

table of otters subject blather
him-who	person-subj	him-say
Ed Riley	Elvira	"'She got me this job here! It's not REAL close to where she is, but hey. She's gotten lots of people jobs, telling others what they can't do. It's a lot more fun than I thought it would be.'"
players	Elvira	"'She is too good even for us. She deserves to have time by herself in the Edictal Citadel to the west.'"
eels	Elvira	"'The eels crackle and light up menacingly at the sound of her name.'"
Le Mer	Elvira	"'She must be defeated[if eels are reflexed]. You can lead the troops to do so[end if].'"
Mr Lee	Elvira	"'She must be defeated[if gore ogre is moot]. You must be the one to lead us[else if ghoul hat is moot]. You might be that person. Just one more sign[else]. If you are not with her, show me a sign[end if].'"
Gore Ogre	Elvira	"The Gore Ogre makes a loud EORG."
ocelots	Elvira	"They shudder[at-elvira]."
satyr	Elvira	"He shudders[at-elvira]."
leopard	Elvira	"It shudders[at-elvira]."
badger	Elvira	"It shudders[at-elvira]."
snail	Elvira	"It shudders."
snipe	Elvira	"It shudders."
racoon	Elvira	"It shudders."
hornets	Elvira	"The buzzing seems almost angry."
Elmer	Merle	"'Almost as interesting as me.'"
Merle	Elmer	"'Almost as interesting as me.'"
Merle	Elvira	"'She is up to something interesting to the west, you'll have to admit. And you'll have to trust us.'"
Elmer	Elvira	"'She is up to something interesting to the west, you'll have to admit. And you'll have to trust us.'"
Elvira	Gretta	"'Not as unselfish as she thought she was.'"
Elvira	Mr Lee	"'Hopeless. Paranoid.'"
Elvira	eels	"'Their electric shocks would be useful--but they didn't let me harness them.'"
Elvira	Le Mer	"'Not dangerous.'"
Elvira	Merle	"'He will get his reward. Even if he hadn't let you by.'"
Elvira	Elmer	"'He will get his reward. Even if he hadn't let you by.'"
Elvira	Ed Riley	"'I didn't expect much from him.'"
Elvira	whiners	"You explain you got past [the whiners], and she shrugs. Henchmen these days. That's why they're henchmen and not leaders."
Elvira	sly imp	"You explain you got past [the sly imp], and she shrugs. Henchmen these days. That's why they're henchmen and not leaders."
sly imp	Elvira	"'Oh, you know her too? Of course you don't! If you did, you'd know you couldn't go beyond here.'"
whiners	Elvira	"They bang on about how Elvira would be furious if they let someone see the animals to the south."
Elmer	Elvira	"'She is a great leader. You do not deserve to visit her to the west.'"
Gretta	Elvira	"[if players are touchable]Gretta cringes even more at hearing Elvira's name, but she can't do much with those [pla-ma]s around, and neither can you[else]You are already talking about Elvira[end if]."

to say at-elvira:
	say " at the name. You quickly give assurance where you stand"

table of others subject blather
him-who	person-subj	him-say
curtis	rampage note	"'[if rampage note is off-stage]What note? You can't pin that on me.[else]None of your business.[end if]'"
curtis	mopeage rant	"'[if rampage note is off-stage]What note? You can't pin that on me.[else]None of your business.[end if]'"
curtis	Art Erd	"[one of]Curtis breathes deeply and gives a look of contempt and shakes his head[or]No point asking again[stopping]. Curtis probably doesn't want to know if any fruit came from [him-her]."
curtis	Len Craig	"'A bit of a salesman, but he has some goods. Just--we're not on great terms, so maybe you can...'"
curtis	Elvira	"'She was terrible for business and innovation. Things are picking up again now, though.'"
Art Erd	curtis	"'There's people with silly science ideas like him. Pfft. Then there's REAL high-powered businessfolk like ME.'"
Art Erd	So Great Storage	"'[if So Great Storage is in Scape Space]It's very valuable! I could maybe part with it for the right price, though[else]You bought it, you own it. No refunds[end if].'"
Art Erd	len craig	"[icy-len]"
Dr Tera	len craig	"[icy-len]" [this just gets rid of an annoying error at the start]
Art Erd	Elvira	"'She wasn't as bad as she was smeared to be!'"
len craig	curtis	"[one of]'Nice fella, interesting ideas about agriculture, but kinda bossy. Just sits looking for someone to do his dirty work for him. You don't...'[or]You don't want to admit Curtis has you gofering. Though, really, it's been not too bad, with your powers.[stopping]"
len craig	tekno token	"[one of]Len inspects the token and assures you it's valid[or]If you ask again, Len might question its validity[stopping]."
len craig	elvira	"'Less said, the better.'"
len craig	Art Erd	"Len snorts and shakes his head. 'What a weasel.'"
Ammo Gang	mango	"Yes, we sell them. Come join our conversation the right way. You turn red, briefly, thinking it can't be too hard to figure how to get a mango."

to say icy-len:
	say "'Nicely? Len? Icy!' [he-she] mutters. 'Cut Len's cluster...'"

volume hint-done-notes tables

[ropins	"[one of]The prison ropins are locked.[plus][or]What could change that?[plus][or]Or make the ropins UNLOCKED? There's an NPC.[plus][or]The Lone Duck could make the gaol unlocked.[cycling]"]

table of troves hint-done-notes
hint-entry	advice-entry
Pa Egg Pea	"Pa, Egg, Pea can't help you any more. Well, it never did, except to get a last lousy point."
stop post	"Now you've spotted the post, it is only good for another clue if you examine it."
evil bee	"You can get past the bee now[if bee-score is 1], though you can deal with it one more way[else], having dealt with it both ways[end if]."
SNORE SO ARENA	"[by-bee]."
diapers	"You figured what to do with the diapers."
praise	"[by-rivets]."
rivets	"[by-rivets]."
ME ARTS	"The [b]ME ARTS[r] inspired you enough, [if lobster is moot]though you can knock off that lobster if you want[else]as much as the lobster, in fact[end if]."

to say by-bee: say "You can get past the bee now[if bee-score is 1], though you can deal with it one more way[else], having dealt with it both ways[end if]"

to say by-rivets: say "You've been inspired enough by the statue[if praise spirea is reflexed and rivets are reflexed], more than enough, in fact[else], though you could still get a bit more inspiration[end if]"

table of routes hint-done-notes
hint-entry	advice-entry
scripture picturers	"The scripture picturers helped you get in, but they're just there to help other people now. Maybe."
sit a nag	"You got [Gast] to the [sit a nag]. Now you need to deal with [Gast]."
side art	"You positioned yourself well to put up with [Gast]'s tirades. Time to try a new direction."
seed pit	"You got what you needed from the seed pit."
hurt hog	"The hurt hog has been healed. You can do no more for it."

table of presto hint-done-notes
hint-entry	advice-entry
dart	"[if dart is in popgun]You're done with the dart, except for firing it at the right time[else if Marines Seminar Remains is unvisited]It'd be nice to find a weapon for the dart[else]Maybe the dart can fit in the popgun[end if]."
tsar star	"[if Marines Seminar Remains is visited]The tsar star has done its duty[else]Wearing the tsar star may help you get the authority to get by someone else who knows about decorations[end if]."
boing go bin	"The boing-go bin works fine now."
maze walls	"The walls hold no great secrets beyond a clue to volt maze's essence itself."
log ons letters	"[other-let]."
alert letters	"[other-let]."
ought letters	"[other-let]."
Im Le Cop polemic	"You got things compiling. No more worries there."
TBA key	"[if TBA key is part of keyboard]It's fit in now[else]It's part of the keyboard. You can put it in[end if]."

to say other-let: say "Try either of the other letters. With variety, [l-n-r] will take the hint"

table of oyster hint-done-notes
hint-entry	advice-entry
frat raft	"Now you're on the frat raft, you need to find a way to use the oars."
snarled darnels	"You had your say about the snarled darnels."
knob	"The knob's been dealt with."
heaps	"I can't give any artistic advice. They're--good enough, I guess. Better than before."
lance	"I can't give you details on how to fight, but now your lance is clean, you'll be able to use it when need be."
gleaner	"[if gleaner is unexamined]You just need to examine the gleaner to figure what to do with it[else if Plasm Lamps is visited or tenfold is visited]The gleaner's not particularly valuable to you any more. But maybe it could be to someone else[end if]."
lever	"The lever was designed not to give extra points for pulling it too much."

table of towers hint-done-notes
hint-entry	advice-entry
turbos	"You fixed the turbos. [if blaster is reflexed]The blaster, too. You can just [b]ENTER BOAT[r][else]Now maybe try the blaster[end if]."
blaster	"You fixed the blaster. [if blaster is reflexed]The turbos, too. You can just [b]ENTER BOAT[r][else]Now maybe try the turbos[end if]."
Tetris Sitter	"Now St. Teri's sick of Tetris, [if top opt pot is moot]and you gave her a gift, she can help. [b]ASK[r] her about the palace, and when you get outside, there'll be a new clue item[else]maybe you can give her a priceless gift of sorts instead[end if]."

table of otters hint-done-notes
hint-entry	advice-entry
bleary barley	"You've cut it down enough. Who needs that much barley anyway?"
medals	"The medals are in good enough shape. They will help you speed up when you need to."
Elmer	"You can't take on [e-n-m] by yourself--you need some allies."
Merle	"You can't take on [e-n-m] by yourself--you need some allies."

volume nowhere tables

book ordeal reload

table of ordeal reload nowheres
theloc	thereject
Largely All Grey Gallery	"You can probably go back up, or you can go in if you're ready to face what's beyond."
Farming Framing	"No time for mooching around your means manse. You probably need to take [if sitar is touchable]a[else]that[end if] secret passage in, or down."
Highest Heights	"You can go back [b]IN[r] to the study, though you don't need to, or you could try [if pram is touchable]to get the pram out of the way[else]going [b]DOWN[r] the ramp[end if]."

book stores

table of stores nowheres
theloc	thereject
Cruelest Lectures	"You fear a 'BE RASH? EH, BARS!' from the Rehabs Basher. And anyway, the trumped-up charges and the teleological lectures have conked your sense of compass directions worse than drugs ever could.[paragraph break]But there must be a generic way to leave!" [bold-ok]

book routes

table of routes nowheres
theloc	thereject
Idle Deli	"Nowhere to go but out. Yup, not only does this restaurant lack ambiance, but it also lacks washrooms."
Adobe Abode	"This do be a one-room place. You can really only go outside."
Ripe Pier	"You've lost all sense of direction here, but you need to figure how to get on that boat."
Harms Marsh	"Far into a rift? No. You can't [if darkness is touchable]see far enough to [end if]rely on directions, here[if darkness is touchable]. You'd likely wind up in Smasher Marshes or Shamers['] Marshes, far from No-Lag Logan[end if]."
Cripple Clipper	"Floats would make you the, uh, last of, unless you are St. Olaf or So Flat. Drowning ails or roils a sailor."
Sonancy Canyons	"You might run into the spheric ciphers. You still don't have your sense of direction back."

book troves

table of troves nowheres
theloc	thereject
Loather Rathole	"Consciously going into any hurt-thru might leave you vulnerable. You need to find [if race acre is touchable]motivation to get through the Race Acre. You need to catch that thief![else]temporary warmth now you were kicked out from [heat].[end if]"
Bustle Sublet	"The reastier arteries lead nowhere good. You still have a lot to look for."
Boarded Roadbed	"A voice says 'Bad! Redo!' when you try to drift away from where [cellar] must be. [if bee-score is 0]Besides, that bee might chase after you. Maybe if you disabled it a bit, you could have a brief walk that would help you think[else]There's a chance you might wind up in ruts: Rustin['] Ruin St.![paragraph break]Nevertheless, on your brief walk, [one of]you saw a red [first custom style]Ell Car[r] (Yorpwald public transport) rattle by[or]you ran into construction by [first custom style]LC Lear[r]--the name written in red[or]you ran into construction by [first custom style]Larlec[r], written in red[cycling][end if]." [bold-ok]
Drain Nadir	"No. You're so low, you [if diapers are in Drain Nadir]might just walk off to [b]SAD PIER[r] and end it all, maybe after eating a few rad pies that won't make you see red[else]can picture yourself slipping on a rind or dinar. 'I... darn.' You need to build yourself up here, somehow[end if]."
Boredom Bedroom	"Running into a wall--or unprepared into the Real World--would leave your bod more red: boom! Study what's in the bedroom, and how it can make you better."
Browse Bowers	"You are definitely going places, but you are going even better places than the Miser Emirs Mires. To you, they are un-go-ish housing. Maybe you can learn to want and expect more."
Econ Cone	"The Save Aves are a well-off place, to be sure, where everyone has a nice vase, but only one. You can do even better!"
Upscale Capsule	"You couldn't just run out on your company and your responsibilities like that! You would need to leave a note or something first. And, of course, you would need to mentally prepare yourself to. [if salt is off-stage]And you couldn't just run out for no reason at all[else if salt is touchable]And you'd need to have proved yourself. You haven't, yet[else]I guess you could leave now, if you did the right thing, first[end if]."

book presto

table of presto nowheres
theloc	thereject
Char Arch	"East or west would be an alpinist tailspin ('CHARGE! Eh, crag.') Try north or south, instead."
Dirge Ridge	"The vile veil seems to almost repel a leaper except where it opens to the north. Note if it were an evil veil, it would probably pull you down the side of the ridge, maybe even to the evil vlei. You couldn't leg such gulches."
Austerer Treasure	"The treasure room has no secret passages, so you can only go back east."
Marines Seminar Remains	"While you're impressed with people who can navigate sport ports, you [if sport ports are reflexed]already saluted them. No need to do more[else]couldn't do much more than show respect for them, if you need a distraction from your main quest[end if]."
Nowt Town	"Nowt Town holds no secrets. You can only go west or south."
Unwary Runway	"[if number of npcish people > 0 and symp-yet is false][random npcish person] waves frantically at you NOT to touch the east and west walls. They may be extra shocking here[change-symp]![else]The unwary runway is a straight north-south shot. And who knows what horrible shocks the walls could give here?[end if]"
Saps Pass	"[if lawl wall is not moot]There's no way around the hogs. You need to get rid of them[else]It's best to stay on the Phat Path[end if]."

to say change-symp: now symp-yet is true;

book oyster

table of oyster nowheres
theloc	thereject
Posh Hops Shop	"[posh-cant-exit]."
Olde Lode	"Something seems to tell you 'Lo! Lo! Deed!' It can't be too hard. The [if clam is in Olde Lode]clam[else]urn[end if] isn't that complex."
Disease Seaside	"The matterless streamlets, err, don't matter. They might even lead to a not-safer seafront. Going back to the Olde Lode or Posh Hops Shop seems pointless, too.[paragraph break]You need to cross to the north for more action."
Fighter Freight	"Directions aren't what matters here. You just need some sort of action to get off the boat."
Hardest Trashed Dearths	"Trying to follow a direction without purpose, you would probably run into one of the spark parks and get zapped. You need something to follow." [oyster]
Lean Lane	"Though you are a guest, probably best not to go poking around. You can go back west."
Lapsin Plains	"With the sloppy polyps on most all sides, you can only go back south or[if span pans are in Lapsin Plains], once the span pans are neutralized,[end if] inside."
Sclerous Closures	"You can only go north to the Horned Hedron[if sardine is in Sclerous Closures], once the sardine is gone,[end if] or east back to Anger Range. The Handsome Sand Home blocks you west and south."
Horned Hedron	"The main exit is south, though [if Rascal Craals is visited]you can go back west to the Rascal Craals[else]an area west is in disrepair[end if]. You can also go [b]IN[r] to the [if pol art portal is touchable]portal[else]ol['] trap once you disarm it[end if][if walleyes are touchable], though you probably don't need the walleyes watching you try[end if]."
Rascal Craals	"The round bay boundary blocks you from going any way but back east."
End Den	"You're disoriented here, but you can go back [b]OUT[r] to get to the Horned Hedron."
Plasm Lamps	"It's you against the ant! There's no running, but it can't be too hard to defeat."
Tenfold Teflond Den Loft	"While you can go back outside, you can just finish things here[unless-max]."

to say posh-cant-exit:
	if noun is not outside:
		say "You just got here, so direction means nothing. So you can only really go out, but those LOLstr trolls will just coax you back inside. Unless you can out-cool them";
		continue the action;
	say "'This ain't the E-Z Beer Breeze-Beezer, here,' one of the LOLstr trolls says. You haven't paid, and you have no money, but you need to leave somehow. And straight-up exiting doesn't seem to be the way.[paragraph break][trolls-mood]";

to say unless-max:
	let my-tot be poss-score of oyster - cur-score of oyster;
	if lever is reflexive:
		decrement my-tot;
	if bogus-derail is reflexive:
		decrement my-tot;
	if bogus-redial is reflexive:
		decrement my-tot;
	say "[if my-tot is 0], and you've done everything else[else], or maybe you can look around to get more points[end if]";

section oyster auxiliary

to say trolls-mood:
	if silly-acts is 3:
		say "You get the feeling the LOLstr trolls wouldn't mind seeing you go since you might be bad for business";
	else if silly-acts is 2:
		say "Yet, the LOLstr trolls aren't that enthusiastic. They remember that disruption you caused and, in some weird way, respect your own trolling";
	else if silly-acts is 1:
		say "The LOLstr trolls hesitate a bit, though. Your behavior wasn't perfect. Maybe if you did more, they'd be glad to see the back of you";
	else if silly-acts is 0:
		say "So, the LOLstr trolls are convinced you're the sort of square who can be pushed into doing what you're told. Maybe you can shake that image";
	else:
		say "BUG--you annoyed people too much. You should've gotten killed. Please let me know how you did this"

book towers

table of towers nowheres
theloc	thereject
Loftier Trefoil	"[if number of moot picaros < 3]One look from Rodney, and you stay put[else]Taverns are generally meant to make you forget compass directions, among other things. You probably just want to deal with Rodney and go out[end if]."
Topside Deposit	"The Wildest Wilteds are too dangerous any way but[if Scope Copse is visited] back[end if] north[if dreads adders are touchable], and the dreads adders are in the way right now[end if]."
Outer Route	"The sway-ways are not reliable. You probably just want to go back east."
Actionless Coastlines	"[if noun is southwest]You don't need to explore the natatorium or Hatchery[else]You can't get across Leak Lake without some sort of craft[like-boat][end if]."
Dourest Detours	"Oh, man! You're so negative and un-energetic. Too tired and upset to try a wrong way, much less a right one. You need a way to change that."
Fringe Finger	"[if noun is down]The logged dogleg prevents you from jumping to your doom[else if noun is cardinal]You try the logged dogleg's [noun] entry, get twisted around, and come out the [dogleg-other of noun] entry[else if noun is planar]The logged dogleg has no diagonal entries[else]You can't sneeak around the dogleg that way. You can only go back east[end if]."
Lost Lots	"Any exit through the gasfield--especially without die flags (and there are none in the game) to guard you--would be false, dig?"
Obscurest Subsector	"A log-gaol blocks any way other than back west. If it didn't, the subsector wouldn't truly be obscurest, now."
Shaven Havens	"[one of]You wander off, but you hear hikers shreik 'Shrike! Shrike!'[paragraph break][or][stopping]Not worth it. Any direction but back south might drive you too far from the palace."
Rawest Waters	"Spirited riptides! [if noun is east]You'll never reach the [neaters] with physical exertion. A bit of magic[else]That'd only make the [neaters] further away[end if]."
Mislit Limits	"[if noun is south or noun is southwest]You don't want to go back across Leak Lake[else]The scaly clays are too treacherous. You need to find the word to restore the curst palace to its former glory[mislit-clue][end if]."

to say like-boat: say "[if bot boat is touchable], like the boat, which [agnostic-first] will let you enter[end if]"

to say dogleg-other of (myd - a direction):
	let NE be number of entries in dogleg-dirs;
	let X be a random number from 1 to NE;
	if myd is not entry X in dogleg-dirs:
		say "[entry X in dogleg-dirs]";
	else:
		increase X by a random number from 1 to NE - 1;
		if X > NE, now X is X - NE;
		say "[entry X in dogleg-dirs]";

to say mislit-clue: say "[if mesprise premises is unvisited]. Maybe there is a clue to the west[end if]"

section towers auxiliary

dogleg-dirs is a list of directions variable. dogleg-dirs is { north, west, south }.

book otters

table of otters nowheres
theloc	thereject
Clarthead Cathedral	"[no-coma]."
Shiner Shrine	"[no-coma]."
Loop Pool	"The pool is wide and long. You can only go back south."
Bran Barn	"You don't need to explore Mr. Lee's property. Your only way out is back north."
Lamer Realm	"You can only go back south. [if adjsolve < 3]Yup, lame[else]The Blest Belts are private to animals and those who helped them[end if]."
Perverse Preserve	"[one of]You feel jolted as you go that way. You may not be able to see it, but you know the tell-tale signs of a [critters restrict] field. It is even, err, STRICTER for animals than for humans, but it still hurts a lot![paragraph break]Looks like you can only go back north[or]The [critters restrict] field isn't worth risking[stopping][dsknow]."
Reclusion Inclosure	"The coevals['] alcoves north and south may seem less intimidating, but you really should be focused on what's to the west."
Rancho Archon Anchor	"Even without the Edictal Citadel that way, Elvira wouldn't let you anywhere into her private chambers. Neither will her creations. Maybe you can sneak back east."

to say no-coma: say "The coma camo may be detectable, but you can't change it"

to say dsknow:
	now know-restrict is true;

section otters auxiliary

know-restrict is a truth state that varies.

book others

table of others nowheres
theloc	thereject
Rustic Citrus	"[if swell wells are visited]You can only go north[back-to-wells][else]With greenish sheering all around, one direction seems as good as any other. Maybe you need to [curtis-next][end if]."
Filed Field	"[if barriers west are touchable and noun is west]The barriers west block you. Maybe they don't lead anywhere, but they might become something more useful[else]With all the foilage foliage and [and-pen], the only way to say I fled is to go back east[end if]."
Scape Space	"One look at the warding drawing disabuses you of any notion of going anywhere except back up."
Clangier Clearing	"You don't need anything in the superstore. You might get lost, anyway."
Gates Stage	"You don't want to know how effective the gropin['] roping is. The gates are more interesting, anyway."

to say back-to-wells: say " back to the Swell Wells and beyond"

to say curtis-next: say "[if player has moss cap]tinker with the moss cap[else]help Curtis a bit more[end if]"

to say and-pen: say "[if lie pen app is moot]even without [the lie pen app][else][the lie pen app] too[end if]"

volume scannotes tables

[these table gives clues after you scan, although usually it may be approrpriate to give hints only in cheat mode.]

[??pad question mark / scan elmer / scan merle]
[note we start with the pram which is not in the first room so we can define thing-to-note as not-scenery. Don't change this.]

book ordeal reload

table of ordeal reload scannotes
thing-to-note	b-only	clue-only-once	clued-yet	bothscan	postscanclue
pram	false	false	false	true	"[cheatfid]."
tables	false	false	false	true	"[cheatfid]."
niche	false	false	false	true	"[cheatfid]."
beams	false	false	false	true	"[cheatfid]."
meet bans	false	false	false	true	"You fiddle with the cheat button. The eighth entry turns purple with cheats on, red with them off."
palest pastel plates	true	false	false	false	"Hmm, maybe the question mark isn't as vague as you're worried it is."
Respect Specter	false	false	false	false	"'[respect-help].'"

to say cheatfid:
	say "You fiddle with the cheat button and note that nothing happens to the reds and yellows"

to say respect-help:
	if cheat-on is false:
		say "With cheat off, you'll know what's a vowel and what's a consonant for sure. This may help nail down ambiguous readings from cheat mode";
	else:
		say "[one of]Six ambiguous readings may seem like a lot, but you can maybe stop to think if any need to be vowels or consonants. You can [b]SCAN[r] again if you want more hints[or]You may notice slots 1 and 7 both have to be consonants. Number one can only be R or S, number 4 is P or C, and number 7 can only be T or R[or]You may notice that slots 3, 5 and 6 can't be defined. That's tricky! But a bit of deeper logic can cut down the possibilities[or]In this case, the two vowels must be in slots 3, 5 and 6, so you can just try putting the only possible consonant in 3, then in 5, then in 6[or]I can't tell you the full solution, but you may also note that slot 1 and 7 both possibly being R can cut down the possibilities, too. You may need guesswork at the end if you can't see the word, but there are less possibilities than you think. In this case, you may stumble across the answer, so I can't say anything specific[or]This example was sort of formulated. It may be easy to guess. You may also be able to assume you can't have three or four consonants in a row, which can help. But I'm here just to show all the future possibilities[g-thru-resp][or]That's all. Thanks for listening. I can repeat things one step at a time if you need a recap[cycling]"

section ordeal reload auxiliary

to say g-thru-resp: now got-thru-respect is true;

book stores

table of stores scannotes
thing-to-note	b-only	clue-only-once	clued-yet	bothscan	postscanclue
tropes poster	true	true	false	false	"I guess it's a trope that something with a trope might help you with the general principles of when the settler is vague. Perhaps you can knock out one of the first two letters."
suit ode douse it	true	true	false	false	"Well, that's a lot of question marks, but if you're sharp, maybe you can figure it out from this or find other clues."

book routes

table of routes scannotes
thing-to-note	b-only	clue-only-once	clued-yet	bothscan	postscanclue
worst ad	true	false	false	false	"Hm! The worst ad seems like it should be simple, but maybe you need to [b]READ[r] the whole ad to see where the weird reading is coming from."
lairage regalia	true	false	false	false	"OSCAR'S SOS ARC doesn't leave many possibilities. And only one ambiguous reading means you might be able to use standard logic." [bold-ok]
adsorbing signboard	true	false	false	false	"While signboard is nine letters, the text on it suggests a four-letter solution. If only you could figure where the vowel was, it'd be a slam-dunk."
anti sag sit a nag	true	false	false	false	"Hmm! Maybe the weird name for the (not) bench can help you sort things out."
Rude N Nuder	true	true	false	false	"Only one inconclusive clue, and you have some direct hits. This shouldn't be too bad."
a bev o be ova	true	true	false	false	"That's a lot of questions for such a small bottle, but it can't be too hard."
MORF FORM	true	true	false	false	"Well, you shouldn't be surprised the settler gives weird readings for something that changes so much. But with only four letters, how hard can it be?"
null it unit	true	true	false	false	"The [null it unit] seems to leave things double-unlit. But with one ambiguous reading, how bad can it be?"
noon gag	true	true	false	false	"Only one letter for sure, but five letters overall. Maybe a well-placed guess will knock this out."
odd run on aura	true	true	false	false	"With only one ambiguous setting, the light should soon go on for you to figure where and how to go."
data dim mists	true	true	false	false	"Well! The data isn't dim from the settler. There's a lot to work with, here."
admits mist ad	true	true	false	false	"Like most ads, it doesn't pose any great logical problems."
thickness sketchins	true	false	false	false	"Those three sentences are certainly tangled, but ... well, they do give a lot of data. Perhaps the question marks are not tough to decipher at all."

book troves

table of troves scannotes
thing-to-note	b-only	clue-only-once	clued-yet	bothscan	postscanclue
Pa Egg Pea	true	true	false	false	"Man! It's making the settler go crazy. Between the title and the author's name, there's a lot to consider. Maybe it will shake out."
tears taser	true	true	false	false	"The tears taser whirrs menacingly. Perhaps it recognizes you'll do what it takes to defeat it, or perhaps it looks down on someone who needs that much help. But either way, you've got some info on it now."
eh at heat	true	true	false	false	"Well, it's only four letters, and you're not sure whether to feel glad things start easy or to feel like your intelligence is insulted."
race acre	true	true	false	false	"Eh, two question marks in just four letters? You feel bummed you were given a second short puzzle in a row, then bummed you're (almost) not up to THAT."
sob ever verbose	true	true	false	false	"The question marks ... hmm. Oh, you get it now."
mussier misuser	true	true	false	false	"Those question marks ... hmm. Oh, you get it now. Not super-sneaky, but the mussier misuser isn't, either, really."
stop post	true	false	false	false	"Well, that's a bit confusing. You'd think a four-letter word wouldn't have too many possibilities, but maybe [b]STOP[r] and [b]POST[r] are clashing."
l clear cellar	true	false	false	false	"That question mark is perhaps, um, clear if you think about it."
a sty tasty say	true	false	false	false	"Hmm. That's a lot of uncertainty. Or, if you sit and think, maybe it isn't."
pleaser leapers	true	false	false	false	"You extract more joy out of knowing you can probably work out the ambiguous entries than from the leapers themselves."
large regal lager	true	true	false	false	"There's only one unstable color for three names in the Large Regal Lager, so that seems like a nice break."
bortles lobster	true	true	false	false	"Whoah! A lot of letters up in the air but a lot of matches, too. Maybe the matches will give you an idea about the uncertain letters."
me arts	true	true	false	false	"Well! There are a lot of clues here, with Mr. East Stream Tamers and all, but this might make for some variety in the puzzle."
LEAD	true	true	false	false	"Man! Only one stable red at the end. That whole title is certainly odd. Perhaps PART OF LEADING IS BEING ABLE TO THINK WHEN MACHINES CAN'T TELL YOU EVERYTHING. How very inspirational!"
praise spirea	true	false	false	false	"Odd readings. Maybe the words from the praise spirea will help you in a different way, or maybe there's enough here to figure out, if you're clever."
rivets	false	true	false	false	"Hmm, along with the information for scanning Trevis, you might really have something here." [??what if already STRIVEd]
sectarian craniates	true	true	false	false	"Wow. You have even more to think about, now! It's certainly a thoughtful piece of art, whatever it is. You are sure the reading provides you with a good deal of concrete and subjective thoughts to analyze."
marble blamer mr beal	true	true	false	false	"[beal-or-balmer]."
marble blamer balmer	true	true	false	false	"[beal-or-balmer]."
salt	true	false	false	false	"Hmm. Well, four letters can't be bad. The vowel must be in one of those two places."
Sister Tressi Siters	true	false	false	false	"Hmm. Sister Tressi seems to be glaring extra, as if the settler's ambiguous settings are what you get for cheating, and she also seems to be saying, well, if life isn't 100% as you'd expect, maybe you'd better learn to think your way around it."
trance nectar	true	true	false	false	"Well of course the final challenge wouldn't have any positive IDs, and the two variable colors seem like a slap in the face. It's not even clear which is the vowel and which is the consonant! Maybe you could start with the first letter..."
creationism reactionism	true	true	false	false	"Well, it's a big book, so you probably can't figure out everything you need to do with it. Perhaps some heuristics need to be combined with regular letter logic."

to say beal-or-balmer: say "Wow! Three names. You don't know if, say, [other-mbb] would be easier but, well, you do what you can"

book presto

table of presto scannotes
thing-to-note	b-only	clue-only-once	clued-yet	bothscan	postscanclue
maze walls	false	false	false	false	"Whoa! You'd think, in Nowt Town, it'd only be four letters. But maybe there is a longer solution than that. It'd, like, give you more satisfaction or something. Maybe."
n e recs censer	true	true	false	false	"This cannot be too hard to figure out, but nonetheless, your settler is giving funny readings."
boing go bin	true	true	false	false	"Well! No matches, but the name is short enough, you might be able to eliminate things that clearly don't work. Then, eureka!"
sods gone odes song	true	true	false	false	"My heavens, that's not a lot of positive clues! But the one variable letter may help things work out okay. And there're a lot of consonants."
sport ports	true	true	false	false	"Maybe you can find where the vowel is. That could help."
hawt thaw	true	false	false	false	"Wow! Three ambiguous letters out of four. But you wonder if they won't help in their own way, or if you really need a huge hint."
alert	true	false	false	false	"Hmm. The settler is giving a weird result, but the sheer number of question marks indicates [b]ALERT[r]/[b]ALTER[r] has a lot right between them."
starch charts	true	true	false	false	"Starch is calorically and consonantally (if that's a word) heavy. This must help."
Clack Ops Locs Pack	true	true	false	false	"Ugh, no matches for so many letters. Yet the definitive colors may have clues."
be troo e robot	true	true	false	false	"You wonder if you need a step back to take a new look at the ambiguous clues."
Im Le Cop polemic	true	true	false	false	"Well! You can probably figurer what the undefined color is, and maybe reading the polemic will provide more clues."
bub dude egg	true	true	false	false	"Only one color for sure? And you don't even get any clues from [bub dude egg]? Well, perhaps there is some detective work here."
USB	true	true	false	false	"Hm, [b]USB[r] seems pretty straightforward. Maybe there are two solutions, each equally good."
Drive E	true	false	false	false	"Given it's both [b]DRIVE E[r] and [b]E DRIVE[r], you suspect that's where the confusion is coming from. But maybe the extra data can help you straighten things out, if you think about it."
Drive A	true	false	false	false	"It's [b]DRIVE A[r], [b]A DRIVE[r] and [if drive a is not examined]something else you can [b]READ[r], if you want[else][b]VARIED[r][end if], which may be what's causing the whole jumble."
peels speel	true	true	false	false	"Oh man. Even small puzzles are getting to you. Ones you should be able to knock off easily, but they add up. Fatigue..."

book oyster

table of oyster scannotes
thing-to-note	b-only	clue-only-once	clued-yet	bothscan	postscanclue
gins sign	true	true	false	false	"Hmm. Whatever the variable colors are, you think you can do something with the fixed ones."
capers recaps	true	true	false	false	"Casper and Recaps may be linked. You could probably bulldoze through with the information from scanning both."
casper spacer	true	true	false	false	"Casper and Recaps may be linked. You could probably bulldoze through with the information from scanning both."
perma amper	true	true	false	false	"It's a perma-amper, so that might account for the twitchy light."
Lil Ps Pills	true	true	false	false	"The pills can't be that fidgety. The particular brand must be a clue, too."
LOLstr Trolls	true	true	false	false	"Well, of course it's not perfectly straightforward with trolls. And yet, as with other trolls, there may be simple ways to reason around them and put them in the past."
frat raft	true	true	false	false	"You're pretty sure you can get this one quickly. I mean, you've been given one of the letters."
sabot boats	true	true	false	false	"It can't be too hard to get the boats['] attention. Something brute-force must work. Once you've figured this out, you may want to proclaim how great you are. That could help!"
snarled darnels	true	true	false	false	"So very tangled! No vowels showed up for certain, which makes it tougher ... or does it?"
Achers Chaser Arches	true	true	false	false	"You note they're also [b]CHASER[r] arches, so maybe that accounts for some of the conflicting readings in the settler."
HUNTER HUNT AREA	true	true	false	false	"You feel mad the letters settler isn't giving you information RIGHT NOW. Then you feel mad imagining the Respect Specter saying 'You know, sometimes, that's more helpful than straight-up clues.'"
use saga sausage	true	true	false	false	"The [sausage]'s moans envelop you and almost make you believe your settler is giving these weird readings on purpose. But no. They must be revealing something, if you think about it."
Paw R Wrap	true	true	false	false	"Fourth wall note: there were no multiple possible answers when this was just (bubble) wrap. Now there are. Like, two instead of one. So I hope that's okay."
general gleaner	true	false	false	false	"You step back, mentally. Having a big-picture view may mean the ambiguous readings aren't so bad."
bogus-plains	false	true	false	false	"Your settler appears to register this all across the plains."
span pans	true	true	false	false	"There are two entries that are ambiguous, but--maybe knowing they're span pans might actually make things kind of easy, here."
papery yapper	true	true	false	false	"Oh no! Where is the orange/y? It'd be easier if that was one of the stable colors. But you can figure that out quickly enough. Hopefully."
templar ramplet	true	true	false	false	"With so little positive information, this might be tough to bulldoze. Still, maybe you can focus on certain clumps of consonants being pronounceable, or not."
natant ant	true	true	false	false	"You grumble a bit. But with just six possibilities, it may be easier to brute force things than to work out the logic."
bogus-psalm	true	true	false	false	"Perhaps finding where the vowel is would be a good start."

book towers

table of towers scannotes
thing-to-note	b-only	clue-only-once	clued-yet	bothscan	postscanclue
Yo Rend or Deny Rodney	true	true	false	false	"Perhaps Rodney's over-florid title will wind up being a weakness."
dreads adders	true	true	false	false	"Well, that's a bit ambiguous to start. Still, if you got by the prosaic picaros who had only one name, the dreads adders give a double clue."
bluster butlers	true	true	false	false	"Hmm, no vowels nailed down in cheat mode. Maybe if you do a big of legwork to figure where they should be, some extra stuff will fall out."
snider diners	true	false	false	false	"The snider diners sniff at the beeping from the settler. They notice you look confused at the question marks--well, momentarily. 'What's this? Such distracting noise!' They go on to mention, drily, that a sophisticated palette will serve you better than knowing how gadgets work."
denier nereid	true	true	false	false	"You can almost hear the denier nereid kibitzing that you didn't need to use the settler. There can't be many possibilities, with the two ambiguous readings."
try us yurts	true	true	false	false	"Well, the orange kind of gives things away. And even with brute force, you can probably guess where the vowel is."
diverse deviser	true	true	false	false	"You can almost hear a voice from the Campiest Campsite say 'Buck up, sport! I believe in you! Turn that frown upside-down! Gosh, those ambiguous clues might be even more interesting and useful than the usual!'"
traipse pirates	true	true	false	false	"Boy, these guys are tough! No matches, and ... well, maybe one of the vague readings can be worked out. You may want to try to talk with them or run past, though."
fluster self rut	true	true	false	false	"You stare at the fluster self rut a bit, confident you won't let it make you upset over the inconclusive letter readings."
angriest ingrates	true	true	false	false	"Hmm, there are some matches, and maybe one of the two variable settings will work itself out."
mardier admirer	true	true	false	false	"Ugh! Maybe the four inconclusive readings are interrelated somehow. Perhaps certain combinations can't both be consonants."
realist tailers	true	true	false	false	"The realist tailers take time to sniff at that ... whatever it is. You shouldn't need hand-holding for whatever you're doing. Even if some of the entries don't give any concrete information, so they can't possibly be useful. The tailers, of course, deserve access to state-of-the-art tools."
resident trendies	true	true	false	false	"The trendies point and laugh at your settler and how it has apparently malfunctioned. Perhaps if they had more technical knowledge, they wouldn't be so self-assured."
raves saver	true	false	false	false	"Man! Four of the six entries (and you'd expect five) are blinky. That doesn't seem to mean anything...OR DOES IT. Maybe it's the brand you can/should worry about."
sporties ripostes	true	true	false	false	"You might have to read through a lot of possibilities even if you can quickly figure what the third letter is."
mended mini denim	true	true	false	false	"Hmph. Perhaps it would be an easier clue if it were just denim. But three names could give a lot of clues."
bogus-dandier	true	true	false	false	"You cringe, waiting for a voice to boom 'WHAT? YOU EXPECTED A COMPLETE SOLUTION?' You probably have enough to work with." [bold-ok]
drained dreadin	true	true	false	false	"Oh goodness. More ambiguous readings. But even after you figure things out, there's still a hole above that's too high to reach."
nerd aid diner ad	true	true	false	false	"The ad must be helpful in its own way. But of course it is just aid and not an outright spoiler, so you have a bit of mental work to do, here."
sweatier wait seer	true	false	false	false	"The letters blink from red/yellow to purple/green and back."
organised ego drains	true	true	false	false	"With nine letters, it was never going to be easy. (Fourth wall note: this is the hardest ambiguous reading in the game. That's why it's optional.) Perhaps you can try talking or running by the drains for clues. Lateral thinking, yay!"
alarming grailman	true	false	false	false	"The one letter blinks between green and yellow."
asset hit atheists	true	true	false	false	"Those question marks could be annoying, but with two t's and two s's, that restricts the number of guesses a lot."
he lot	false	true	false	false	"Well, this is tricky. Their sort of double name affords a couple interpretations for the settler, but maybe that's a bit of a clue."
lois the hostile	false	true	false	false	"Well, this is tricky. There's her name, and it's probably interacting with itself. Maybe if you think, you can figure a few shortcuts."
reb nok bonker	true	true	false	false	"Seeing ambiguous readings is probably better than seeing stars from actually getting hit, you muse."
reading a dinger	true	true	false	false	"Well, this may be more intellectually challenging than the book itself. Lots of reds."
docile old ice	true	true	false	false	"Hm, it's certainly docile old ice, so the confusing letter may not be so confusing."
fries us fissure	true	true	false	false	"The fissure's jabbering may provide an alternate way to free Dr. Yow from operating the luck node. It's up to you which you feel will be easier."
Dr Yow	false	false	false	false	"[if Dr Yow has been rowdy and Dr Yow has been wordy]Dr. Yow has already been wordy and rowdy. You suspect these readings just say you can make Dr. Yow wordy or rowdy again[else if Dr Yow has not been rowdy and Dr Yow has not been wordy]The settler flashed RYRRO on and off. That doesn't usually happen. Perhaps it represents a range of Dr. Yow's emotions[else if Dr Yow has been rowdy or Dr Yow has been wordy]Hm, maybe Dr. Yow has more emotion than what you already brought out of [him-her][else]BUG--but Dr. Yow has two states[end if]."
natives site van	true	true	false	false	"You get the feeling the natives can be swayed more than one way, here."
bogus-rousted	true	true	false	false	"You're momentarily bummed you have two letters to decipher, but it's a small pick-me-up that figuring them out will be worth it."
seismal samiels	true	true	false	false	"You're almost worried it will be too easy to figure things out, now. Too hard, too easy, too normal ... everything leaves you in the dumps."
weirder red wire	true	true	false	false	"Hm, looks like the red wire doesn't make you see any extra red. You were never an electrical whiz, but maybe general logic will help rearrange the tangled connections."
earnest eastern neaters	true	true	false	false	"That's some ambiguous readings, but I guess before you get help, you'll need to help yourself. Good thing the settler's even working despite the potential for water damage!"
curst palace	false	false	false	false	"[scannotes-curst]."
repents serpent	true	true	false	false	"That is a lot of blinks, but those blinks have to be almost as good as a purple or green."
nastier stainer retinas	true	false	false	false	"Boy! Over half the readings are ambiguous! Nastier than usual, indeed. Though actually, if they were only 'stainer retinas,' you'd have one-half the possibilities. Sometimes evil is like that. The more evil it is, the more intimidating it seems, but the more it can leave itself vulnerable to good guys just plodding away."
tetris sitter	true	true	false	false	"With only two vowels, this word may be a bit irregular. But having the two t's in sitter is nice."
done any anodyne	true	false	false	false	"For a moment you guess you've, err, done enough, and you don't have to get rid of the anodyne for Teri. But you also figure, what's one more logic puzzle after all you've been through?"

to say scannotes-curst:
	if palace-let < 6:
		say "Wow, lots of blank data. You may want to get closer to get fuller clues about how to restore the palace[if palace-let >= 5 and cheat-on is true]. [sadly-curst]";
		continue the action;
	else if palace-let is 11 and cheat-on is true:
		say "The final entry blinks alternately with the fifth--neither is purple at the same time. The settler usually isn't this slow, but maybe you can take advantage of it having so much data to process";
	else if cheat-on is true:
		say "[sadly-curst]";
	else:
		say "Even if the reds and yellows were all in place, there'd still be a lot of possibilities[if max-pal-seen < 8][one of]. But it should still help to get closer ro the Curst Palace[or][stopping]";
		repeat through scannotes of mrlp:
			if thing-to-note entry is curst palace:
				now b-only entry is true;
				 continue the action;

section towers auxiliary

to say sadly-curst:
	say "Sadly, the ambiguous fifth entry doesn't seem like you could figure it easily, even if you had a full report from the settler";

book otters

table of otters scannotes
thing-to-note	b-only	clue-only-once	clued-yet	bothscan	postscanclue
bleary barley	true	true	false	false	"That is a lot of matching for six letters. And you haven't seen anything like the brown before. You're pretty sure. But if you forgot what Elmo said, you can probably guess."
cinders	true	true	false	false	"Hm, that's weird. Your sci-nerd side says perhaps there are two things you can do with the cinders, though it also sees red at the thought of giving them up entirely."
parleys splayer players	true	true	false	false	"The players certainly do dance around a lot with their talk, so it's no surprise the settler can't pin them down. But maybe all those words can give you more data."
yer all a yell'r	true	true	false	false	"Well, you've got to figure that decoding the ambiguous settings will be as complex as the song. Which is to say, not very."
t-formally	true	true	false	false	"Two question marks in nine letters--well, seven--might be a little sticky. The [players] said two things."
t-tearily-irately	false	true	false	false	"Wow! That's a lot of question marks and possibilities. But maybe [b]REALITY[r] can be bent a couple overwrought ways."
t-steamily	true	true	false	false	"Well, you have a feeling you know what that question mark should be."
t-silently	true	true	false	false	"Wow! Three things to consider here. This might be tricky."
medals	true	false	false	false	"[if cheat-on is true]The medals clink back and forth and unwind as you scan them. Maybe that might help you. But since you're an old hat by now, and the questionable slots seem -- well, not as bad as a puzzle near the end could be. [end if]The seven slots suggest it's not the medals that need attention but what[if medals are examined]'s[else] might be[end if] engraved on the medals."
cut ya all cult laya	true	false	false	false	"The words of the [laya] certainly swirl around you, having no full substance, yet perhaps offering a clue of how to cut them down. So it's no surprise the same thing happens with the settler reading."
atmo moat	false	true	false	true	"You feel sheepish having used the settler, but it's been a long journey."
sullenness us	true	false	false	false	"The voices seem bummed at your settler's ambiguous readings, unaware (as you are by now) that that can make things easier."
aside-llp	true	true	false	false	"Hmm. The two yellows can't mean something like LREME. So it must be they are ideas aides."
stray satyr	true	true	false	false	"The satyr seems physically hard to tame, and the two ambiguous settings seem like resistance -- but there are only five letters."

book others

table of others scannotes
thing-to-note	b-only	clue-only-once	clued-yet	bothscan	postscanclue
sated stead	true	true	false	false	"Three of five letters is a lot of ambiguity, but you are pretty sure what sort of thing you need, so it can't be too bad."
coins	false	false	false	false	"Even the reds and yellows seem to be blinking here. It's as though the coins need to be changed twice."
s-c	true	true	false	false	"You're a pro at all this, now, so two question marks don't bother you. Yes... they have to be..."
pipe panel lie pen app	true	true	false	false	"Hmm. There are a lot of P's. Maybe that helps."
auction caution	false	false	false	false	"Hm, that certainly cuts things down a ton[if caution is unexamined], or it should, once you read that sign--caution has four vowels, but the settler indicates three[else if cheat-on is true]. Just one possibility[else]. Just three possibilities[end if]."
prices precis	true	true	false	false	"Whoah, only reds and greens. Interesting."
melon	false	false	false	false	"Now this is weird. It looks like there should be a space, but it's jumping back and forth. Maybe there are two very similar ways to ask Len about that melon."
i solve voiles	true	true	false	false	"You make sure it's not just the [voiles] fluttering about that give such an ambiguous reading. No, it is not."
ammo gang	true	true	false	false	"The No Ammo Gang doesn't seem too hard to hang with, and your settler's clues probably reveal enough, too, to put this mystery away quickly."
a banna	false	false	false	false	"The message on the/a banna['] must be interfering with the/a banna['] itself." [scape space]
a brr hub	false	false	false	false	"Wow, seven letters, odd. It must be *a* brr-hub. Maybe poking it would give another clue or so."
Reserved Deserver Dr Severe	true	true	false	false	"Dr. Severe rolls [his-her] eyes. 'My arguments certainly merit analysis, but there is no quick way to grokking them.'[paragraph break]Whatever Dr. Severe rattles on about seems less important than how many letters are repeated, and that has to help cut down possibilities."
concisions	false	true	false	false	"Whoah, that's odd. You thought the sonic icons were what you needed. Maybe there's one more cool thing you can do."

volume specific help for things you need to flip

table of ordeal reload spechelp
xtrhelp	helptxt
meet bans	"The ten beams creak slightly. Maybe not all of them. But a few."
palm	"You think you feel the palm shake a bit, but nothing terribly magical happens."
niche	"Hm, no, the niche--my niche--won't unfold that way."
latches	"You think you feel static through the latches. But they remain the same. Maybe there's some easy way to change them."
tables	"The tables seem to shift a bit."
giant pin	"The pin wobbles."
pavement	"[dior-hint]."
event map	"[dior-hint]."
crabgrass	"[dior-hint]."
brass crag	"[dior-hint]."
platform	"[dior-hint]."
farm plot	"[dior-hint]."
pedestal	"[dior-hint]."
steel pad	"[dior-hint]."
sitar	"You hear a sad-sax noise from the sitar. Well, a sitar version. 'Rats, I...' you think, seeing red."
stria	"'Rats, I...' you think as you see red. That's not quite it."
ISBN bins	"The [bins] creak slightly."
plates	"The plates shine slightly and rattle."
plaster	"The plaster crackles and shines slightly."
pram	"The pram creaks back and forth slightly."
rifle	"Elmo bobbles the rifle slightly, and you think he may've nodded encouragement at you."

to say dior-hint: say "Hmm. Nah. That's not quite it. Your skills are a bit rusty, but you'll figure it out. Or you can [if diorama is examined]re[end if]examine the diorama"

table of stores spechelp
xtrhelp	helptxt
Store B	"The smell from Store B becomes fruitier and more delicious."
Store H	"Store H looks totally different for a second."
Store K	"An odd sweet smell from Store K, for a second."
Store N	"'Dude, you like must be close!' you hear from Store N."
Store P	"You hear old forgotten magic words which seem like they might almost apply if they were in the right order."
Store T	"You hear various unrecognizable animal noises."
Store U	"Store U seems to light up with lines and curves for a second, but no, that's not quite right..."
Store V	"A single paper currency flutters off from Store V, lost forever."
Store W	"Store W seems to push up from the ground and go narrower for a second."
Store Y	"You hear grinding, then a slimy gulp, from store Y. But nothing definitive."
Suit Ode Douse It	"That tune in the background, [suit ode], takes an odd turn. But it doesn't quite shut down."

table of routes spechelp
xtrhelp	helptxt
THE BEAN	"[the bean] rolls back and forth a bit."
worst ad	"The ad seems slightly nearer, for a moment."
scripture picturers	"You feel you're not quite ready to enter the Cleric Circle, thinking like that. Well, not precisely like that. Your thoughts are close, but jumbled."
lairage regalia	"You twist and tilt your head but can't figure out how to interpret the regalia. But you must be close."
adsorbing signboard	"You struggle a bit. The signboard should be pretty simple, being [b]PAT'S[r]. It'll come to you."
anti sag sit a nag	"You hang around the [sit a nag], hoping for something to happen, but nothing happens. Though it seems like it should."
side art	"[if Gast is off-stage]There's something in the side art, but you're not sure if you need to figure it out just right now[else]Oof! That doesn't quite work. It could have, though. You glance at the side art for clues[end if]."
WOE BOW BELL	"You seem like you should be able to find shelter from [the WOE BOW BELL], but you may need to mix things up a bit."
MORF FORM	"The [morf form] rocks in the air, as if it's about to fall."
pipe soot	"The soot smells a bit stronger than before for a moment."
seed pit	"The seed pit seems to bubble slightly."
Rude N Nuder	"The pages of [Nuder] flutter a bit."
odd run on aura	"You thought you saw an un-road for a second, but ... not quite."
NULL IT unit	"You feel it's quite near the right time for [the null it unit] to shut down, for the darkness to lift. And you must be on the right track."
noon gag	"You think of how to find a way to No-Lag Logan's boat."
data dim mists	"Hmm, you almost see a way past the [mists]."
thickness sketchins	"Your craft rocks and makes negligible forward progress. Still, it's a start."
hurt hog	"The hog grunts."
bent ewe	"The bent ewe stretches a bit."
raptest patters	"The raptest patters subside a bit, but ... suddenly you miss them, in an old way. Maybe you can get rid of them for good, though you probably don't need to."
yob den	"Some different noises from the yob den."

table of troves spechelp
xtrhelp	helptxt
Pa Egg Pea	"You gloss blankly over [i]Pa, Egg, Pea[r], but you're not quite doing it right."
tears taser	"The tears taser makes an odd noise, as if it is recalibrating."
Eh At Heat	"You feel slightly less cold but mad at yourself for not doing better."
Race Acre	"For a second, things almost seem to matter. Then, back to the normal hopelessness. You must have been on to something, though."
sob ever verbose	"The sob ever verbose remains that way--mixing up subjects and making you consider things you hadn't before, in an effort to suck up attention from anyone around."
stop post	"The stop post continues its silent defiance. You might need to look at it from a slightly different angle."
mussier misuser	"The mussier misuser looks around a bit, worried someone might be out-thinking them."
a sty tasty say	"No. You pause. That can't be it. You need to do something, or nothing, differently."
LEAD	"You reflect that to [b]LEAD[r], you must also put certain things in order. You know there are only so many ways."
SNORE SO ARENA	"The [SNORE SO ARENA] flashes weirdly."
evil bee	"The bee's buzzing goes off-kilter for a bit. You gain a bit of faith you're on the right track."
L Clear Cellar	"It's...hmm...you remember all the clues, but what order to place them in, now."
diapers	"Staring again at the diapers, you are depressed you couldn't even get being depressed right."
large regal lager	"No...that is not quite the way to fight the temptation of the wicked brew."
lobster	"That's not quite the way to deserve that lobster."
ME ARTS	"That's not quite the way to focus on the [b]ME ARTS[r]."
pleaser leapers	"The leapers almost seem to dance around for a bit."
Si Reed	"Si Reed booms encouragement to WANT and BELIEVE more. You're almost THERE!" [bold-ok]
rivets	"Staring at the rivets, you get the feeling you've not quite found the right way to try. Or want."
praise spirea	"That's not quite the way to look forward to praise. But it may be a start."
sectarian craniates	"Ideas flash through your mind. Wow! That's what art can do! But ... nothing conclusive, yet."
END PRONER POD	"The [end proner pod] seems to pulse slightly."
red vees	"The red vees seem like they should link together somehow, but you don't have things right."
DIVORCES	"[b]DIVORCES[r] suddenly seems more alluring and more rubbish at once."
salt	"You don't quite draw inspiration from the salt, but there can't be that many alts."
Id Cede	"You try to groove to [Id Cede], but that's not quite it."
Sister Tressi Siters	"Sister Tressi seems a bit more upset than usual."
marble blamer balmer	"[mbb] seems slightly taken aback."
marble blamer mr beal	"[mbb] seems slightly taken aback."
trance nectar	"Your willpower is not quite strong enough to give it all up yet. But you must be on the right track."
creationism reactionism	"You seem to need to force yourself to be more whimsical. Which seems contradictory, but hey, figuring [creationism] is the toughest optional puzzle in the game."

table of presto spechelp
xtrhelp	helptxt
lamb	"The lamb looks confused. Maybe you could be more forceful. Verbally, not physically."
hump	"The hump suddenly looks a bit smaller. But not enough."
n-t-air	"You feel defiant. But not defiant enough to ditch Nowt Town for good! Well, not yet."
dart	"The dart seems a bit closer, but...dang! Not quite."
tsar star	"The tsar star seems to wiggle a bit, but not enough to pull it out."
plebe	"The plebe looks confused, as if you garbled what you said."
sport ports	"The sport ports seem even shinier for a second."
Leo	"There aren't that many things to do with Leo. So few, you could probably brute-force how to get by his, uh, brute force."
Rand	"There aren't that many things to do with Rand. So few, you could probably brute-force how to get by his, uh, brute force."
wzup	"You mumble a greeting that doesn't quite seem to work. Hm, that's not quite it."
odes song	"The odes song sounds warpy for a second or two. Who knows, maybe you could get rid of it. You've heard worse on top-40 radio stations, though."
ether	"[if ether is prefigured]No, you definitely need to say [b]THERE[r]. You just need to have backup and maybe weapons[else]The ether pulsates, but you still can't see through it[end if]."
ye hoop	"The hoop dips a bit as if to taunt you."
boing	"You try something that doesn't [i]quite[r] work, but now you're that much closer to an a-ha moment."
maze walls	"The [if player is in Grey Gyre]volt maze rumbles[else]maze walls rumble[end if] a bit. You must have all the right letters to bring [if player is in Grey Gyre]it[else]them[end if] crashing down in style."
n e recs censer	"That feels right, but it's not enough yet. You don't need anything grumbly, here."
Hogs	"The hogs snicker a bit, but they seem a little nervous, too."
Keys	"The hogs snicker a bit, but they seem a little nervous, too."
hawt thaw	"The hawt thaw crackles slightly."
alert letters	"[l-r-bye-hint]."
log ons letters	"[l-r-bye-hint]."
ought letters	"[l-r-bye-hint]."
starch charts	"The starch charts flutter about aimlessly. They seem harmless, but then, it couldn't hurt to dispose of them correctly, if you see the way."
disk	"[if skid is moot][sk2dsk][else]The disk seems to want to expand, but not quite into that. You must be close[end if]."
escaroles	"The escaroles seem slightly meatier."
coal	"Microscopic bubbles seem to form on the coal and burst in the air."
flea	"The flea makes a crinkly noise but still seems quite dead."
drab yoke	"It'd take too long to type out all the possibilities, but that seems basically right. Hmm."
TBA key	"The [b]TBA[r] key rattles within the keyboard a bit."
USB	"Hmm. There are only five possibilities, and more than one may be right. You've done the tough stuff."
trim socks	"You don't have the available memory in your head to see all the possibilities, but yes, something like that should work."
Clack Ops Locs Pack	"NO, REARRANGE AND TRY AGAIN, you think." [bold-ok]
fount	"Hm, might be nice to try another guess. Or useful. Maybe even [b]FUN TO[r]."
gum	"Ugg... umm... you stare at the gum. Not many ways to stretch it, really."
be troo e robot	"The [robot] gives a futile kick, but it's trying. Some sort of command like that must work."
peels speel	"Whatever you thought seemed a bit of a tired mess."
Im Le Cop polemic	"Man! That's the thing about compiling. Switch one or two characters, and foom, it's just as bad as if you were completely off-base."
skid	"Bleah. Did all this high-tech work make you forget the skid was a disk? Yes. Yes, it did."
BUB DUDE EGG	"Hmm. Fixing code you've compiled is tricky. Once it's fixed, if you have even one thing in the wrong order, it does nothing right. That has to be what's happening here, why [bub dude egg] is showing."
drive a	"Hmm. Drive A coughs for a bit but doesn't really catch. It could be running more efficiently."
drive e	"Hmm. Drive E (the E drive) has something wrong with it. Maybe you can work things out, even if you don't know right away, but that's not it."

to say l-r-bye-hint: say "It's kind of tough to say goodbye, firmly but kindly, and--that isn't quite it. You feel a bit jumbled"

to say sk2dsk: say "No, skid <=> disk is about it. There's no tricky third way"

table of oyster spechelp
xtrhelp	helptxt
Capers Recaps	"You think of mocking Casper's writing style, but that's not quite it. Something more direct and physically insulting, maybe."
gins sign	"Nobody pays attention to your performance as you disobey the sign. Or try to. I guess the sign doesn't strictly disallow THAT."
tips pits	"The tips pits rattle a bit as you try to do ... something ... to them."
tines	"Hmm. There must be some way to destroy the stein, but that's not it."
perma amper	"You can't change the bad music selection. But you can neutralize it--the jukebox has instructions."
tunes	"The tunes grow slightly less annoying, for a moment."
trolls	"The trolls laugh at you a bit, but nervously."
clam	"The clam still seems enraged."
urn	"The urn sits there, daring you to walk away."
sabot boats	"Perhaps if you were louder and more confident, the sabot boats would hear you."
frat raft	"The frat raft rocks slightly."
oars	"The oars splash around in the water, briefly rising out, as if they don't belong there."
eeks	"You guess the eeks must be there--no, there!"
pale plea	"Yes, the pale plea is calling and warning you to leave. But how?"
carps	"The carps and pikes laugh at--whatever you tried. But you know bullies are like that when someone is onto them. Hm, how to fix things."
pikes	"The carps and pikes laugh at--whatever you tried. But you know bullies are like that when someone is onto them. Hm, how to fix things."
snarled darnels	"The [darnels] rustle a bit."
cans	"You wonder if there is some odd-yet-familiar way to clean the cans up. That's not it, though."
dent	"Fixing the dent is a tricky business. Get two things out of order, and it might get worse. But you must be close."
trout	"[if player is in Anger Range]The best way to help the trout at the moment is to deal with the carps and pikes[else if wrap is off-stage]You try to describe how to fight, but that's not it[end if]."
tea	"You anticipate Aunt Tuna telling you to stop playing with your food, already."
wipes	"You try to take the wipes, but you worry you're not fast enough."
wrap	"That's not quite the way to pop the [paw r wrap]."
HUNTER HUNT AREA	"You need a slightly more organized way to reveal what's under the ground[if digger is off-stage], and you don't have a digging instrument, either[else] with your rigged digger[end if]."
bogus-trace	"The crate's from there! No, there! No, there! Well, you thought you had an idea, but it was a bit jumbled."
crate	"The crates that missed you wobble a bit. You know what'll happen, just not what to do...quite yet."
knob	"The knob rattles slightly."
skis	"The skis momentarily seem more polished."
span pans	"The pans wobble slightly."
bogus-plains	"You feel like making a big speech about what you've done and what you plan to do, but not quite like that."
waste	"You make an effort to clean the waste but feel you could do better."
heaps	"The heaps still look ugly as ever."
tubs	"Hm. The tubs shake slightly. Maybe if you were more forceful."
prod	"You juggle the prod a bit, but it doesn't change into anything new."
lance	"The lance glimmers slightly. It has potential to be shiny."
Achers Chaser Arches	"Hm, you almost thought you found something. But you have more finding to do. Or stuff to do before you find something."
ruby	"No, that's not quite it. The ruby dulls as if covered by dirt."
use saga sausage	"You're a bit tongue-tied, but that seems close."
ol trap	"Hm, no, that's not quite how to cover all the ground looking for the ol['] trap."
gleaner	"The gleaner remains too small to read."
papery yapper	"'Quit yer mumblin, ya perp!' the yapper yells, turning red. 'You here to do business or not?'"
bogus-derail	"[di-cli]."
lever	"You look at the lever, wishing it would be a little more fun to pull."
pins	"You look at the pins. They're in the way, but they don't look particularly sturdy."
bogus-redial	"[di-cli]."
templar ramplet	"There has to be a way to storm down the templar ramplet. But not that."
bogus-psalm	"The plasm lamps flicker slightly."
natant ant	"There must be a simple way to take down the ant. You haven't quite got it right yet, though."

to say di-cli:
	say "[if yapper is in tenfold]The yapper might alert its cronies if you try anything. Even something not quite right, like that[else if bogus-derail is touchable]The dialer seems to click slightly[else]The dialer must have another setting, but that's not quite it[end if]"

table of towers spechelp
xtrhelp	helptxt
Andres	"Andres looks a bit more tied up at the moment."
Andrew	"Andrew suddenly looks as if he's been told he did something wrong."
Archie	"Archie looks a bit pained."
Barney	"Barney looks around a bit."
Blake	"Blake looks a bit unhappier."
Bredo	"Bredo yawns."
Cedrick	"Cedrick cringes slightly."
Daryl	"Daryl pinches his sides and shakes his head."
Demitri	"Demitri shivers a bit."
Dewey	"Dewey seems momentarily less muscular."
Edwin	"Edwin hiccups."
Eldon	"Eldon looks slightly wrinkled for a moment."
Ernest	"Ernest seizes up."
Geno	"Geno looks around, as if he's about to bolt."
Goldy	"Goldy starts to fold his hands in prayer but thinks better of it."
Leander	"Leander makes an a-ha gesture--no, only for a second."
Marcel	"Marcel breathes slower for a second."
Marlon	"Marlon looks a little less weird for a moment."
Preston	"Preston almost slips for a second."
Reggie	"Reggie sniffs the air."
Royce	"Royce looks a bit less aggressive."
Shane	"Some color drains from Shane's face."
Terrance	"Terrance looks around as if he wants to run off."
Tyson	"Tyson looks slightly less emotional."
Wade	"Wade's eyes get bigger for a second."
Rodney	"Rodney looks around, as if he is sick of this place."
dreads adders	"The adders look downcast for a minute before resuming a threatening pose."
snider diners	"The diners glare at you, then look up at the sky, slightly worried."
try us yurts	"The yurts sway slightly. They may not be guarding much, but maybe you could do for them."
diverse deviser	"You thought you heard a brief hum from the diverse deviser for a moment there."
pirates	"The pirates blanch a bit but quickly regain their swagger."
realist tailers	"The realist tailers moan in exasperation, completely not sure what you're trying to do. But they're sure it's going to fail. They wouldn't have said anything if you were on the wrong track."
fluster self rut	"You feel a bit more agitated. Relax. Breathe. Etc. It may not be critical, but you'd like to figure what to do, and you think you will."
strudel	"You almost expect the strudel to hop up[if player does not have strudel] into your arms[end if], but the moment passes."
ingrates	"The ingrates seem to wonder if it's worth complaining to you for a moment. You get the feeling that they may start off angriest, but if you could bend their mood, they might lose their willpower and give up."
fissure	"Bizarre animal noises continue to emanate from the fissure. It is beyond your control to counter[if Dr Yow is not in ropins], but the duck's already figured it[else if duck is touchable], but the duck seems to look curiously at it[else], and you wonder who or what could tinker with it[end if]."
bonker	"'TANGENTIAL HIT!' blares the bonker. 'THE MARAUDING HORDES ARE ON TO US!'" [bold-ok]
stinger	"The stinger fizzles a bit."
weeds	"The weeds almost seem to shrug."
raves saver	"The 'replay player' letters brighten for a second."
denier nereid	"The denier nereid seems to be pulled away towards Leak Lake for a moment."
organised ego drains	"The drains sizzle slightly but go back to menacing quiet."
mardier admirer	"The mardier admirer looks askance, then returns to evaluating you some more."
natives site van	"The natives inside the site van look almost ready to be suckered by flattery or just a tall tale in general, but that look passes."
alarming grailman	"The grailman seems almost average for a moment."
promise imposer	"The promise imposer seems a little less intimidating."
Reeds Ale	"[el-la-full] listens to what you're saying for a minute, but--no, you didn't quite get it right. [he-she-c] goes back to reciting [his-her] tired sales pitch."
sweatier wait seer	"The wait-seer looks bored and distracted for a second."
bluster butlers	"The bluster butlers cough slightly and look around furtively."
asset hit atheists	"The atheists momentarily ditch their timed snark for a few quick hitters, but then it's back to normal."
resident trendies	"The resident trendies sniff a bit. No, that's uncool, they say. But they look a little rattled."
keycar	"The keycar sputters momentarily."
lois the hostile	"Lois the Hostile momentarily gives a fake smile, but it's not as fake as it could be. Progress."
Hostile is He Lot	"The Hostile-Is-He Lot mumble, hmm, if we saw things THAT way...but the moment passes."
luck node	"You twiddle the luck node for a bit, and it seems to be working, until you ... hit a bit of bad luck. Maybe you need to make your own luck, or make your own luck better."
dinger	"[Agnostic] blinks and ruffles [dinger] and yawns before flipping a page, slightly less interested than before."
atblock	"[agnostic-first] scrunches [his-her] eyes to try to keep even more attention, but it doesn't quite work."
mended mini denim	"The mended mini-denim bends and warps, but you hear no tearing noise. That's not how to expose any flaws in dem. Err, it."
bogus-dandier	"You feel slightly less depressed you tried something. You can't be too far off."
bogus-rousted	"You feel slightly more awake, but not quite enough. Yet. The detours do seem a little less dour."
seismal samiels	"The seismal samiels change intensity for a bit."
sporties ripostes	"The ripostes seem less cutting for a moment."
docile old ice	"The old ice seems to glimmer a bit."
turbos	"[jet-nq]."
blaster	"[jet-nq]."
weirder red wire	"You think you see how to untangle some of the mess inside the/a bot-boat, but you don't want or need to do anything unless it's all just right."
earnest eastern neaters	"You feel less split from everyone else for a second."
repents serpent	"The serpent calms down for a split-second[serp-try]."
ur pine	"The ur-pine shrinks, slightly. I mean, it recedes, but it doesn't quite get smaller."
Tetris Sitter	"[The tetris sitter] breaks her glassy smile for a moment."
done any anodyne	"The [anodyne] rattles."
curst palace	"Hmm...[if player is in Mislit Limits]only faint rumbling from the curst palace. Big words have all sorts of possibilities[else]that's good practice, and a good guess, but even if it were right, you don't know if you could change the curst palace from here[end if]."

to say jet-nq: say "Despite your lack of technical knowledge, you think you almost did...something to improve the boat";

to say serp-try: say "[one of][or], again[stopping]";

table of otters spechelp
xtrhelp	helptxt
bleary barley	"The barley rustles in an imaginary wind--but hardly at all."
Ed Riley	"Ed Riley looks askance at his deli rye, as if it had some bad aftertaste. If only he said things less loudly, boomingly, startlingly..."
asyllabic lilac bays	"You almost hear music as the lilac bays rustle."
cut ya all cult laya	"The jabber from [the laya] turns slightly less inane for a moment."
motleyer	"[imp-nag]."
butlery	"[imp-nag]."
legendary	"[imp-nag]."
callosity	"[whin-nag]."
tallyhoing	"[whin-nag]."
jollity	"[whin-nag]."
raptor	"The raptor recoils slightly."
cinders	"The cinders glow and even warm up for a bit."
aside-llp	"[e-n-m] rock back and forth a bit."
parleys splayer players	"The [players] slip for a moment but quickly resume their incessant dialogue."
Yer All a Yell'r	"[yer all] changes its beat. Maybe it's a remix even worse than the original! Wait, no, you were sort of on the right track."
holy nest	"The holy nest flutters silently."
atmo moat	"Hm, that's not it, but it must be elemental. No, elementary."
sea cube	"The sea cube shakes a bit."
eels	"The eels swim a bit faster."
owls	"Hmm. The owls still swarm and swirl too fast."
ghoul hat	"Mr. Lee shakes his head and adjusts the ghoul hat."
gore ogre	"The gore ogre lets out a not very logical or convincing roar. Maybe you're onto something, here."
vow here	"The vow here quiets down for a moment."
thrones	"The thrones seem to buzz a bit."
nails	"[one of]O[or]Another o[stopping]ne of the nails seems to bend a bit."
pines	"The pines rustle as if an animal climbed through them."
corona	"The corona scurries about for a bit before settling down again."
ocelots	"The ocelots squint at you through their clip-ons."
leopard	"The leopard almost seems to un-cuff its hands."
badger	"The badger flexes imaginary suit lapels, then quickly goes back to brooding."
satyr	"The satyr puts a hand on its chin as if pondering deeper things."
medals	"The medals waver noiselessly. Hm, that's not quite it."
weltish whistle	"[if player has whistle]The sound you make is experimental and groovy, in a new age jazz sort of way, but it's not quite right[else]Probably best to have the whistle before changing it[end if]."

to say imp-nag: say "The imp looks slightly annoyed for a second. You may be on the right track";

to say whin-nag: say "The whiners manage to shush you more noisily than you've ever been shushed. You may be on the right track";

table of others spechelp
xtrhelp	helptxt
moss cap	"The cap itches for a bit, then seems to try to spin you around."
coin	"The coin looks a bit more artistic for a moment--no, it's too drab, again. Hmm. You must be close."
coins	"The coins jingle promisingly."
icons	"The icons rattle promisingly."
s-c	"The sonic coins hum almost questioningly."
lumps	"The lumps seem almost ready to burst."
pagers	"The pagers light up slightly. Maybe give it another go."
slime	"The slime shifts about slightly, but not enough--yet."
spear	"The spear stays as-is. But it can't be that hard to change."
sated stead	"The sated stead bubbles slightly."
eerie blurbs	"The blurbs turn a few shades of purple before settling again."
harmonicas	"The harmonicas whistle, as if something happened."
mad train	"The train emits some fake smoke and seems ready to blow up--but no."
magenta rope	"The magenta rope and other items you uncovered briefly seem as one."
omen prism	"You must be on the right track--but nothing happens. Yet."
peanut cola	"The peanut cola smells slightly fruity for a minute."
green stain	"Parts of the green stain turn orange-ish but is too small to be oranges."
miser ruble	"The miser ruble turns a bit purpler."
PSA Elp	"You don't fully seem to be grokking the PSA [']Elp. Your thoughts are a bit jumbled."
riot cap	"Nothing happens. Your magic skills feel like the pits for a second."
sorer bogey	"The bogey's tone changes slightly for a second."
stucco	"The stucco looks almost hairy for a second."
barren cries	"The briar screen seems to turn dark reddish, and the barren cries seem like they could change--or is it a dream to you?"
pipe panel lie pen app	"The pipe panel lie pen app rattles slightly."
barriers west	"You feel the barriers west pulling towards you."
buried raft	"You loaf a bit after thinking that, hoping for something to happen. It doesn't."
mean trowel	"You had the seed of an idea there, you thought."
rapt figure	"The rapt figure frowns as if it's eaten something sour."
pryer bars	"The pryer bars briefly turn very red."
barber sickle	"The barber sickle darkens a bit. You must be on the right track."
Ammo Gang	"You must not be mingling right with the No Ammo Gang." [No Ammo Gang]
auction caution	"Everyone promises quick payment, but what are you promising to pay quickly for? Hmm..."
lemons	"[l-frown]lemons."
melon	"Hm, there must be a better melon than that, but how to ask Len, now."
nectarine	"The nectarine seems a little less shiny and new. But not enough."
peach	"The peach still looks too expensive."
i solve voiles	"The [voiles] rustle slightly."
prices precis	"Something glints off the prices precis."
quince	"That certainly sounds foreign--but it doesn't seem to sway Len."
a banna	"The (a) banna['] flutters about for a bit."
a brr hub	"The (a) brr hub seems to swirl closed for a bit."
orange	"The orange seems a bit closer for a bit."
Reserved Deserver Dr Severe	"You seem to see a mirror image of Dr. Severe for a moment."
viewer	"That's not the way to learn from the viewer--it's probably not that complicated. You hope."
searcher	"That's not the way to learn from the searcher--it's probably not that complicated. You hope."
fleeing feeling	"It hurt to be called a perp. But maybe you can figure a way to spin that and heal the pain. Not quite like that, though."

to say l-frown: say "[if player is in Clangier Clearing]Len frowns[else]you frown[end if] at the ";

volume done rejects

table of ordeal reload done rejects
specdone	spectalk
lamp	"If you mess with the lamp, at least you wouldn't see those idiots outside once they got in. But you couldn't run from them, either."
painting	"The painting really goes better with the study than the giant pin."
chimney	"You probably just want to go [b]UP[r] the chimney."
stair	"The stair helps you get around more easily, so it doesn't need to be changed back."
ramp	"The ramp is useful now. Best keep it."
letters settler	"Tinkering with the satchel, wherever it's gone, would not be helpful. The super purse is big enough, and you don't want to do anything that might damage the letters settler."
ISBN bins	"The [bins] are secure. Best not tinker."
staple	"Those plates were a mess, and now they're a tidy staple. It's better that way."
stapler	"The plaster was cracking anyway, before you made it a shiny stapler. You don't need to change it again."

table of stores done rejects
specdone	spectalk
store b	"You're a hero[if player is female]ine[end if] and all, but only one sample per day. [if otters is not solved]Just think of the field day Elvira'd have if she found out[else]Yorpwald is democratic, and stuff[end if]!"
solid idols	"[got-e of solid idols]."
course source	"[got-e of source course]."
Tastee Estate	"[got-e of tastee estate]."
odorant tornado	"[got-e of odorant tornado]."
truster turrets	"[got-e of truster turrets]."
balancer barnacle	"[got-e of balancer barnacle]."
Throes Hoster	"[got-e of throes hoster]."
tokers	"They are who they are[if nestor is off-stage]. You should maybe try to get their friend back[end if]."
nestor	"You rescued him, and that's enough."

to say got-e of (to-enter - a thing): say "You should just enter [the to-enter]. No need or way to seal [it-them of to-enter] back up"

table of routes done rejects
specdone	spectalk
scripture picturers	"The picturers were pretty strict about what they suggested. Not much else you can do with them."
lairage regalia	"You twist your mind a bit, but no, there's probably only one way to enter."
adsorbing signboard	"No, you don't see any other way around the signboard to enter. You don't need one, either."
gast	"[if Gast is moot][giant-over][else if side art is not reflexed]You already leaned on the [sit a nag] right. You look around it and wonder if the side art could stop [gast]'s tirades[else]The [sit a nag] itself isn't as important as what's happening around it[end if]."
anti sag sit a nag	"The anti-sag sit-a-nag isn't important with Ian Gast gone."
side art	"[if Gast is moot][giant-over][else if nuder is in Same Mesa]Maybe deal with Rude [']N Nuder, now[else]You got on the [sit a nag] right. Time to start ducking[end if]."
Rude N Nuder	"You don't want [the woe bow bell] to come back."
U NERD ENDUR REDUN	"You don't need to do anything fancy with U NERD ENDUR REDUN. Brother Horbert will do that."
pipe soot	"Brother Horbert will work his magic with that."
stupor sprout	"That'd be a double negative, to [if player is not in idle deli]go back and [end if]re-enter the seed pit. Your argument would be so won, it's lost."
THE BEAN	"The [morf form] has, uh, morphed enough. Deal with [the bean]."
un road	"You know where the un-road is, but how to navigate it?"
odd run on aura	"The underground is already lit. Un-unlit."
bent ewe	"The bent ewe and hurt hog seem to be at peace. Maybe you can move on. Maybe the hurt hog thinks it's okay."

to say giant-over: say "The [sit a nag] isn't important with [Gast] gone"

table of troves done rejects
specdone	spectalk
Pa Egg Pea	"You probably did what you could. Or not-did."
heat	"Don't need to overheat, or overhate."
a sty tasty say	"You can't over-stay your staying power, or something."
SNORE SO ARENA	"Drowning something without reason further in reason is unreasonable."
evil bee	"The bee's already taken enough of your in-my-heartitude."
praise spirea	"You're wanting praise too much, now."
rivets	"You're striving too hard, now."
sectarian craniates	"Oh, man. You don't want to be contemplating art too much, here. Of course, you want to own expensive artwork. But thinking like this, it might own you."

table of presto done rejects
specdone	spectalk
tsar star	"No need for additional arts."
dart	"The dart's just fine as-is."
boing go bin	"You can't force another revelation, but you don't need to."
sport ports	"You don't need to praise military activity and sacrifice too much. Countries where people feel obliged to are at risk of authoritarianism."
Leo	"Giving Leo flashbacks to his humiliating loss would be a bad idea. He may've forgotten who beat him, already."
Rand	"Giving Rand flashbacks to his humiliating loss would be a bad idea. He may've forgotten who beat him, already."
wzup	"You don't need to greet [l-n-r] again."
log ons	"[no-rehash]."
alert	"[no-rehash]."
ought	"[no-rehash]."
rom sticks	"Man, it would be too easy to mess the rom sticks up. Better not tinker like that."
casserole	"The casserole is mixed up enough."
leaf	"You can't bring the flea back to life--or do anything else to the leaf."
ALocalCo Cola	"No need to go technologically backwards. Plus the cola was processed enough before it got in the bottle."
futon	"The futon could be a little less lumpy, sure, but that's beyond your magic powers."
caps lock	"YOU HAVE WHAT YOU NEED."
mug	"[if ALocalCo cola is moot]You'd get cola all over you if you tried anything with the mug[else]The mug is no longer manipulable[end if]."
screen	"The screen is less ancient than the censer, but you can't do any better. It works, so you don't need to fiddle."
keyboard	"You don't need to resummon the bored yak. And programming exercises can become enough of a drab yoke."
be troo e robot		"No need to reboot twice."
TBA key	"No, the [b]TAB[r] key is what it should be."
Im Le Cop polemic	"After compiling, you often need to make small tweaks, but not like that."
peels speel	"You've had enough comforts from cots to do the programming you need. You might re-wake weaker."
BUB DUDE EGG	"You had to consider all sorts of combinations while debugging, but things will be easier now."

to say no-rehash: say "[if leo is touchable]That'd be an awkward rehash. You need another way to say good-bye[else]With [l-n-r] gone, your fumbling for a third way to say good-bye is only emotionally useful[end if]"

table of oyster done rejects
specdone	spectalk
tips pits	"You can't and don't want to do anything else to the tips pits."
capers recaps	"Casper has suffered enough indignities. You should annoy someone else."
gins sign	"There's no other way to disobey the sign."
tines	"You destroyed the stein, and that's enough."
frat raft	"The frat raft has fuel. It needs to use that fuel, now, with the oars."
snarled darnels	"It's okay to get mad, but staying mad? No."
trout	"Retutor? Torture. Rot. True!"
wipes	"Now that you've got the wipes, you need to find how to use them constructively. Maybe there's something worth using them on."
crate	"Besides identifying it as a rect, you can't do much else with the crate."
bogus-plains	"You start up a grand lecture again, but you feel something spinal and think 'I...plans.' Time to move on."
lance	"It's clean enough. You can't, like, make it sharper or anything."
rigged digger	"You managed to get a digger from a prod, and that's good enough."
heaps	"You figure the heaps are at a point where you can't change them for the better."
Achers Chaser Arches	"Further searching proves fruitless."
pol art portal	"You discovered the portal. No need to look further."
use saga sausage	"Don't oversell it! Just take [the sausage] to where it was probably (heh) the walleyes who buried the ruby."
thin hint	"It was enough to bury the ruby."
gleaner	"It's already been made bigger. Not much more you can do with it[if gleaner is unexamined] except examine it[end if]."
lever	"You riff on your previous celebrations, but it doesn't feel as cool."

table of towers done rejects
specdone	spectalk
diverse deviser	"You already repaired [the deviser][if dagger is moot] and got what you needed[end if]."
old ice	"Twist the ice too much, it might not look right."
raves saver	"The raves saver is as glitzed-up as it'll get."
strudel	"You'd have to drop the strudel on the ground and get it germy to try that again. Eww."
turbos	"The turbos are working. Best not tinker."
blaster	"The blaster is working. Best not tinker."

table of otters done rejects
specdone	spectalk
nude dune	"You've dealt with the barley. You can move around a lot more, now."
asyllabic lilac bays	"The [lilac bays] are quite nice as-is after your brilliant plant-whispering."
parleys splayer players	"You've already made the macks/players talk a bit slower. Now you need to deal with their arguments."
eels	"The eels have done enough."
parrot	"The parrot can be changed back into a raptor, but not into anything new."
whistle	"The whistle's already in tune."
medals	"You already got a boost from the medals."

table of others done rejects
specdone	spectalk
compass	"The compass is accurate enough. Changing it might ruin things."
icon	"The icon seems good as-is, yet ... you can't help think it could become more later, once you've seen, done and known more."
s-i	"The sonic icons seem right. No use meddling."
kumquat	"You corrected the prices precis enough."
olives	"The olives are just find as they are. They're even pitted! No need to change them. I mean, what if they became SO EVIL?"
lemons	"You sour on changing the lemons further."
melon	"The melon is fine as-is. It's better than the one that was on display, for sure."
peach	"You got enough of a discount. Really."
mango	"Snag mo['] mangos? No mas, G."
papayas	"You've already established yourself as a prompt payer."
fleeing feeling	"Don't want to over-prep[win-north]."
searcher	"You've done enough researching[win-north]."
viewer	"You've done enough reviewing[win-north]."

to say win-north: say ", and now you [if gate-level is 2]can just go north[else]need to try something else[end if]"

volume tables of hintobjs

[parts of the settler first]
table of general hintobjs
hint-entry	advice-entry	parallel-entry	spoil-entry
pedanto notepad	"You can [b]CONSULT[r] the notepad about things. It contains no game-critical hints, but it can help you remember a lot of shortcuts and such, so you can think sharper."	a thing	text
red writing	"The red writing provides a clue of what the letters can't be."
yourself	"[one of]You have the same power you had in [shuf].[plus][or][if Report Porter Perrot is off-stage]Try opening the door and having a chat. You'll see some, err, patterns.[else]Report Porter Perrot's chat contained a good many things.[end if][plus][or]You had the ability to flip objects into anagrams of each other. [this-game] shows a different side to that power.[minus][cycling]"
question mark	"[if player has inducted deductin][deductin] has more detailed information on how to read a question mark.[line break][else if inducted deductin is off-stage]There'll be a hint item later that explains how to sort out ambiguous readings from the settler in cheat mode.[line break][else][end if][one of]A question mark in cheat mode for the settler is not as hopeless as you'd think. In fact, it may cut down the possibilities. It may occur when there are two possible solutions or, more likely, when something to change has a double-anagram, e.g. [b]TAPES SPATE[r], a matching anagram, or [b]MERE MOOR[r], which is ([b]EMOR[r]) times two.[plus][or]So if you have an eight-letter word, an ambiguous reading may leave two possibilities, but a vowel or consonant may turn up four. Thus, an ambiguous reading works out better.[plus][or]You can also switch to non-cheat mode to clear up ambiguities, but often, you don't need to. I'll use the [b]TAPES SPATE[r] sample below.[plus][or]If [b]TAPES SPATE[r] gives R?R??, we have a good bit to work with. The first letter must be P, since it is a consonant.[plus][or]The second letter must be A. This is the sort of jump that makes cheat mode with ambiguity powerful. Slot 3 must be a consonant, and slots 4 or 5 can be E or a consonant. That leaves A for slot 2.[plus][or]However, for the end bit, there is ambiguity. E can go in slot 4 or 5.[plus][or]You thus have [b]PATES[r] or [b]PASTE[r], so [b]TAPES SPATE[r] is potentially ambiguous. No critical puzzles will be in [this-game]. But you can also see how ambiguous readings can drastically cut down possibilities.[minus][cycling]"
colorful logo	"The logo provides hints as to the mechanics of the settler. You may want to try examining it with teach/cheat mode on or off."
whichs shwich	"[one of]The whichs shwich button toggles whether or not you know characters are in the right position. Details on what the colors mean will follow if you [b]HINT[r] again.[plus][or]More specifically, red/yellow=wrong, purple/green=right.[minus][cycling]"
decal	"[one of]The Y's on the decal are orange. This seems like a clue.[plus][or]Orange is red and yellow.[plus][or]Y is the only letter of the alphabet that is...[plus][or]...a consonant and a vowel![minus][cycling]"
backside	--	laced decal
slider	"The slider will allow you more detailed hints about how close a guess is. But it has limited uses."
receptors	"Electricity is beyond me. But the rest of the settler could help you."
a tech etcha	"[one of]The/a tech etcha['] can be switched to vary the level of hinting. Cheat/teach on potentially gives more. Some NPCs may [if strip of profits is visited]have helped[else]help[end if] you with it, but if you want the quick spoilers, [b]HINT[r] again.[plus][or]A tech etcha['] shows different readings for certain letters. In some cases, the readings are ambiguous, but usually, they aren't.[plus][or]A tech etcha['] may cause some entries to be purple or green instead of red or yellow.[plus][or]The tech etcha['] adds blue in some cases.[plus][or]If a letter is in the right spot, the/a tech etcha['] adds blue. Red + blue = purple for consonants. Yellow + blue = green for vowels.[plus][or]Undefined settings indicate one or more, but not all, letters in a compound anagram are right, but not both.[plus][or]A simple example would be [b]EAST SEAT[r] going to [b]TEAS[r]. Letters 2 and 3 would give question marks. For a full explanation of how this could help you, [b]HINT QUESTION MARK[r].[minus][cycling]"
output	"This is the display that analyzes the last thing you meaningfully scanned."
pen	"Not much you can do with a pen other than write."
latches	"[one of]The latches seem useless, but they are your parting gift from [gtmn][if Largely All Grey Gallery is visited], so you probably want to 'solve' them before moving on[end if].[plus][or][if treatise is off-stage]You should examine the latches. There's a note inside them which is useful.[else][gtmn] also said it would be pretty simple to figure out what to do with the latches.[end if][plus][or]Did you notice anything about the treatise's wording that might give a hint about the latches?[plus][or]Lots of anagrams in the treatise, but they have something in common.[plus][or][gtmn] only switched the first and last letters in the treatise. Maybe you can do that with the latches.[plus][or]You can get a [b]SATCHEL[r].[minus][cycling]"
letters settler	"[one of]The settler seems to give mostly reds and yellows. If you tinker with it, you may notice a pattern.[plus][or]Reds mean one thing and yellows mean another. If you've solved and scanned a bit, you may know which is what.[plus][or]Also, the coloring of the words [b]LETTERS SETTLER[r] is a clue. If you have the teach/cheat button on.[plus][or]As is, to get fourth-wall, [b]A ROILING ORIGINAL[r].[plus][or]But the settler is all you need.[plus][or]With teach/cheat on, note that e-t-t are halfway different colors. That's because they match.[plus][or]Specifically, if the current object differs from the target object in one letter, the color will be red if the target is a consonant and yellow if it's a vowel.[plus][or]If you have 'cheat' on, you can see that green is a correct vowel and purple is a correct consonant. Red and yellow are incorrect consonants and vowels.[plus][or]There are also orange and brown, but they are rarer. Since orange = red + yellow, you can guess what it may be.[plus][or]The letter Y.[plus][or]There should be a separate document describing basic strategies for using the settler.[plus][or]One last thing: the equals sign is there so as not to spoil puzzles that are a bit on the easy side. It's fully optional and just part of what I hope is something that helps calibrate play to be more fun based on how tough you find these sorts of puzzles.[minus][cycling]"
equals sign	"[one of]The equals sign is useful if you don't want things to be too easy.[plus][or]The equals sign will give squealings if you scan something and the information might make the puzzle trivial.[plus][or]You can override the equals sign with [b]SY[r] (scan with correct letters) or [b]SN[r].[line break][sy-sn][minus][cycling]"
super purse	"[one of]The super purse can't be changed, but it's there to circumvent some common adventuring tropes.[plus][or]The purse is a bit of a catch-all, so your huge inventory seems reasonable. It hides what you don't need nicely, and it shows what you do.[minus][cycling]"
Gird Grid	"The Gird Grid has information on the various stores to explore."
Inducted Deductin	"[in-ded-hint]."
X1	"[in-ded-hint]."
X2	"[in-ded-hint]."
X3	"[in-ded-hint]."
X4	"[in-ded-hint]."

to say sy-sn:
	pad-rec-lump "sy";
	pad-rec "sn";

to say in-ded-hint: say "Inducted Deductin and its sub-pages are just there to examine, to help you understand how to reason when the settler's cheat mode gives ambiguous readings"

table of ordeal reload hintobjs
hint-entry	advice-entry	parallel-entry	spoil-entry
a rich chair	"[if player does not have notepad]You can take the pedanto-notepad from the rich chair, for starters[else if latches are not off-stage]The/a rich chair hid the latches. You have them now[else]You can [b]SEARCH[r] a rich chair to find something, though it will turn up in the course of play anyway[end if]."
Report Porter Perrot	"You can pump [perrot] for information if you want."
isolani liaison	"The isolani liaison is just a door. It isn't there for any puzzles but just to communicate with the outside world[if Report Porter Perrot is not off-stage]. But after taking to Report Porter Perrot, it's not useful[end if]."
notice	"For reading."
beams	"[one of]It's important there are [b]TEN BEAMS[r].[plus][or]The ten beams lead somewhere below.[plus][or]What is a place that's below in a house?[plus][or]Open the [b]BASEMENT[r].[minus][cycling]"
platform	"[dio-part]."
pavement	"[dio-part]."
pedestal	"[dio-part]."
crabgrass	"[dio-part]."
farm plot	"[dio-part]."
event map	"[dio-part]."
steel pad	"[dio-part]."
brass crag	"[dio-part]."
painting	"The painting clues all the ways out of the Dusty Study, but you don't need to do anything more to it."
niche	"[one of]'My niche' above the diorama leads upwards.[plus][or]What is a household accoutrement that leads up? If you use the settler, you may know what the last letter is.[plus][or]'My niche' can be a chimney.[minus][cycling]"
closest closets	"The closets [if closets are touchable]are[else]were[end if] just for transporting around the Means Manse quicker, to or from the Dusty Study."
vertical stripe	--	act ruin curtain
horizontal stripes	--	act ruin curtain
small holes	--	act ruin curtain
palm	"[one of]Well, you need a light source, but a palm [b]absorbs[r] light.[plus][or]It wouldn't be bright to stumble into the palm...[plus][or]...but changing the palm would be.[plus][or]If you wait around, you get some hints of what to do with the palm. Note the purposefully bad spelling.[plus][or]One four-letter shuffling of [b]PALM[r] is indicated. Hopefully.[plus][or]You can change the palm to a [b]LAMP[r] by just saying so.[minus][cycling]"
lamp	"The lamp will last as long as you need it to."
meet bans	"[one of]The ten beams guard something downstairs. What?[plus][or]The number of beams is important.[plus][or]What's a common downstairs place in any house?[plus][or]The beams guard a [b]BASEMENT[r].[minus][cycling]"
tables	"[one of]The tables seem out of place in such a posh mansion.[plus][or]What's more posh than tables?[plus][or]The tables can be a [b]STABLE[r].[minus][cycling]"
chimney	"You can [b]CLIMB[r] the chimney or go up it."
stair	"You can go up or down the stair."
giant pin	"[one of]The pin's hanging from a wall, but things like that usually don't hang from walls.[plus][or]What generally hangs from a wall to make a room look nicer?[plus][or]A picture or...[plus][or]A painting.[minus][cycling]"
sitar	"[one of]You need a way down, but the sitar doesn't allow that.[plus][or]Rearrange two letters in sitar.[plus][or]The sitar becomes a stair.[minus][cycling]"
stria	"[one of]Embedded in the ceiling, the stria split it a bit. Maybe they offer a way up?[plus][or]The stria can become a [b]STAIR[r].[minus][cycling]"
pram	"[one of]The pram gives you a sinking feeling to look at it.[plus][or]You need a way down and out of reach. Something you could even crawl down.[plus][or]The pram can become a ramp.[minus][cycling]"
ramp	"Just go down or in to walk down the ramp."
diorama	"[one of]The diorama provides things you can flip around. You don't get any points for them, since they're labeled, but I hope they help.[plus][or]First, the platform and pavement give only reds and yellows, even in teach/cheat mode. Cheat mode doesn't help.[plus][or]What pattern do you see in reds and yellow on the diorama?[plus][or]The crabgrass and pedestal have colors that change in some places.[plus][or]Note the colors change from red to purple or yellow to green. What is similar about these?[plus][or]Adding blue. And which letters change?[plus][or]cRAbgrass, bRAss crag.[plus][or]The letters that are correct![plus][or]So, blue = correct.[minus][cycling]"
ISBN Bins	"[if isbn bins are reflexed]You figured how to secure [the bins]. Nothing more to do.[else][one of]The [bins] are pretty hefty, but they're easy to enter.[plus][or]Maybe you could add a bit of security before leaving. Not that you need to. But if you want all the points...[plus][or]It's an unusual word, but then, there are only twenty-four of them.[plus][or]You can make a [b]SNIB[r].[minus][cycling][end if]"
teariest treatise	"[one of]The treatise describes how to use the settler.[plus][or]The treatise cuts off near the end, but the first paragraph gives enough hints.[plus][or]The treatise provides information on what to change the latches to, as well as what's beyond.[minus][cycling]"
evac cave	"The evac-cave is your way out[if Elmo is touchable] once you get rid of Elmo[end if]."
rifle	"[one of]The rifle's more powerful than words. [b]OR IS IT[r].[plus][or]The rifle makes you wonder if you're on a wanted poster or something.[plus][or]The rifle can become a much more harmless [b]FLIER[r].[minus][cycling]"
Respect Specter	"[one of]The Respect Specter isn't necesary to solve the game, but it can help you with puzzles if you use cheat mode.[plus][or]First, the actual thing to change to is easy.[plus][or]Make, or ask for, a [b]SCEPTER[r]. Spelling is important. But you can do more.[plus][or]The specter may give more information about ambiguous readings if you scan it different ways.[minus][cycling]"
plaster psalter	"[one of]Plaster generally covers up holes. You need to bust through that plaster.[plus][or]If you used the settler, you might notice it, uh, settles a lot about the plaster.[plus][or]The plaster becomes a [b]STAPLER[r].[minus][cycling]"
palest pastel plates	"[one of]The plates are embedded, but they have a metal rim. Well, sort of.[plus][or]The plates are also square, with metal half-square rings.[plus][or]They become a [b]STAPLE[r].[minus][cycling]"
staple	"[one of]What does a staple go in?[plus][or][if plaster is touchable]Something the plaster can change into.[else]The stapler.[end if][plus][or]PUT STAPLE IN STAPLER.[minus][cycling]"
stapler	"[one of]What goes in a stapler?[plus][or][if plates is touchable]Something the plates can change into.[else]The staple.[end if][plus][or]PUT STAPLE IN STAPLER.[minus][cycling]"
act ruin curtain	"[one of]What does the act-ruin curtain--with its design--remind you of?[plus][or]The act-ruin curtain is meant to look like lined paper. The sort of essay paper you might procrastinate for a class. Hence why it stops you from acting. The holes in the upper corner look like they were made by a stapler.[plus][or][if plaster is touchable or plates are touchable]You've got some work to do before you can do any stapling[else]You've got what you need to staple the curtain and peel it back[end if].[plus][or][b]STAPLE CURTAIN[r][if staple is not in stapler] once you've put everything together[end if].[minus][cycling]"
Mole Elmo	"Mole Elmo's not a very enthusiastic captor. It's as if he wants you to do something to the rifle."
high sign	"[one of]3, 4, 1, 2, 5. What do those numbers mean?[plus][or]The rifle has five letters, so that is a clue.[plus][or]Letter 3, letter 4, letter 1, letter 2, letter 5.[plus][or]3-4-1-2-5 of rifle.[plus][or]Elmo is cluing the rifle can become a [b]FLIER[r].[minus][cycling]"
sad ads	"Err, mostly anagrams that couldn't fit into puzzles. I hope you find them amusing."

to say dio-part: say "Not a puzzle per se but helps you understand what to do with [if settler is off-stage]an analytical object you may uncover[else]the settler[end if]"

table of stores hintobjs
hint-entry	advice-entry	parallel-entry	spoil-entry
megaton magneto montage	"The [montage] gives clues about the sort of words each area needs. The text highlighting changes with each area you solve."
Store B	"[one of]Store B contains some sort of mystery food, but people seem too lazy to figure it out.[plus][or]The two names provide red-clues, but you can also tell from the smells from Store B.[plus][or][b]SORBET[r].[minus][cycling]"
Store H	"[one of]If you haven't solved the game proper, you won't be able to get into Store H.[plus][or]Store H appears radically different from the rest of the store. It's probably where stuff that doesn't fit in goes.[plus][or]ES Roth mentions that you can't face the hoster or call it directly.[plus][or]What's a word for stuff sluffed off to the side?[plus][or][b]OTHERS[r]. If you want the quick way through, you will need to restart the game.[plus][or]You need to [b]ROVE OVER[r] when you are in the Means Manse.[minus][cycling]" [bold-ok]
Store K	"[one of]Store K is not critical, because it's a bit of American slang.[plus][or]What is the suspicious smelling smoke?[plus][or]The smoke is marijuana, but [b]STONER[r] doesn't quite work on Store N.[plus][or]The residents of Store K want to REST, OK? That hint knocks out the vowels with the settler.[plus][or]Also, they yell don't have a [b]STROKE[r]![plus][or]You can also assume they are plural, so S is last.[plus][or]They are [b]TOKERS[r].[minus][cycling]" [bold-ok]
Store N	"[one of]Looks like there's a guy in Store N. You need to figure his name.[plus][or]Items fall out of Store N if you keep poking or examining.[plus][or]The toners/Sterno give a lot of clues.[plus][or]The mythology and Tintin clue may tip you off.[plus][or][b]NESTOR[r] is his name.[minus][cycling]"
toners	"The bottle of toners, being red, helps cut down the name of the person in Store N."
Store P	"[one of]You seem to need a magic word, and the tropes poster plus Store P give you a few hints.[plus][or]In particular, you see two blinking colors, which means the first two letters are P/T O/R.[plus][or]But the second must be a consonant. Also, [b]TROPES[r] means you know where the vowels are.[plus][or]Process of elimination gives [b]PRESTO[r].[minus][cycling]" [bold-ok]
tropes poster	--	Store P
Store T	"[one of]Cute squeaky noises from burrows in Store T. There must be many such animals. As if there's some animal that this industrial buildup has displaced.[plus][or]There are four choices left, if you use the settler, but what is a riverside animal?[plus][or][b]OTTERS[r].[minus][cycling]"
Store U	"[one of]The roads in Store U. What's another word for that? They're numbered, too.[plus][or]The settler's a big help here, as it knocks out the vowel. Then you can try where T should go. Or better yet, you can guess that whatever it is is plural, and that knocks things out logically.[plus][or]Not just any old roads but ones with signs for bus stops, etc.[plus][or][b]ROUTES[r].[minus][cycling]"
roads	--	Store U
Store V	"[one of]You see sparkling inside Store V if you look at the right angle. Well, several angles.[plus][or]Hmm, treasures. Where do you find treasures? (Word-logic clues follow before the solution.)[plus][or]If you use the settler, you can figure which vowels are where.[plus][or]Then you can figure the first letter, since two starting consonants cut down the possibilities.[plus][or]You should wind up with [b]TROVES[r].[minus][cycling]"
voters	"You can scan the voters if you can't figure what Store V should be."
Store W	"[one of]You may wish to look at the description of Store W, though [b]RESTOW[r] also allows a clue.[plus][or]Store W seems taller than the other stores, like it has several levels. It's just an illusion. Plus, the store seems to blur into separate halves when you look at it.[plus][or]What's a name for a tall building, or tall buildings?[plus][or][b]TOWERS[r].[minus][cycling]"
shells	"The shells clue that Store Y might become something that lives in a shell."
Store Y	"[one of]Hm, store Y looks slimy on the inside, and it smells like saltwater too. It's also a weird shell shape, Store Y is. What sea life do you know that has a Y in it?[plus][or]Also, if you use the Letters Settler, you'll notice a letter that's a new color--orange. A combination of yellow and red.[plus][or]What letter can be a vowel or a consonant?[plus][or]Y. So the settler gives you three letters.[plus][or]You probably see by now--or can use process of elimination--to note Store Y becomes an [b]OYSTER[r].[minus][cycling]"
solid idols	"[if you-can-advance]You've solved enough to get past the solid idols[else if patcher is off-stage]You need to solve more stores to have the strength to make it past the solid idols[else]You need to solve more stores, or zap them with the patcher, to make it past[end if]."
course source	"[just-e of course source]."
Tastee Estate	"[just-e of Tastee Estate]."
balancer barnacle	"[just-e of balancer barnacle]."
odorant tornado	"[just-e of odorant tornado]."
Throes Hoster	"[if roved is true][just-e of Throes Hoster].[else]You need to save Yorpwald first.[end if]"
truster turrets	"[just-e of truster turrets]."
engravings	"[one of]Whether a word is italicized or bolded reflects something.[plus][or]Try changing a store and looking again.[plus][or]The italicized words relate to the stores you've figured.[plus][or]Bolded words means an area is solved.[plus][or]For instance, 'someone' is bolded, so you solved an area.[plus][or]The engravings are a hint to the figures of speech in the new areas, so you solved an area with nouns.[plus][or]Store W makes 'evil' go italic, so you may guess what sort of words are behind it.[minus][cycling]"
patcher	"[one of]The patcher can be used to skip certain areas. It's a bit fourth-wall, but it'll do.[plus][or][b]ZAP[r] (store X) to zap a single store.[plus][or][b]SWITCH PATCHER[r] to zap them all.[minus][cycling]"
Nestor	"[if tokers are off-stage]Nestor's pals are in store K[else]Nestor's back with his pals. Not much to do with him now[end if]."
tokers	"[if nestor is off-stage]You can find the tokers['] friend in store N[else if blabber babbler is reflexive]They'll give you a treat if you solve the side quest[else]They're of no use to you now[end if]."
mangiest steaming	"[if blabber babbler is reflexive]You can enter the steaming for a mini-side-quest[else]You've been in the steaming. After how you upended things, it'd be unwise to go back[end if]."
passage	"If you go there, you'll get a big hint."
pamphlets	"They are completely useless for actual life lessons, but the settler on 'cheat' mode will knock a vowel out from [b]I USED TO[r]."
Rehabs Basher	"[one of]You need to get the Rehabs Basher and the blabber babbler out of the way. Nouns won't work here.[plus][or]If you listen, a song may give you clues, too[plus][or]The Rehabs Basher's pamphlet is a hint.[plus][or][b]TEDIOUS[r] + [b]I USED TO[r] should give you a clue what to anagram. Studio E may clinch it.[plus][or]You need to throw the bums [b]OUTSIDE[r].[minus][cycling]"
Suit Ode Douse It	--	Rehabs Basher
blabber babbler	--	Rehabs Basher

to say just-e of (th - a thing): say "Just [b]ENTER[r] [the th]"

table of routes hintobjs
hint-entry	advice-entry	parallel-entry	spoil-entry
poison stripe	"[one of]The poison stripe's name is a clue to what to do here.[plus][or][if cur-score of routes > 0]You've already figured one word[else]It's a certain sort of word[end if].[plus][or]Directions are confusing here, and standard ones don't work, but there's another way to get around.[plus][or]PREPOSITIONS.[minus][cycling]"
sit a nag	"[one of]It's just a bench, but the name brand indicates an anagram.[plus][or]Touching the [sit a nag] does nothing. How to cover more of it?[plus][or]Lean [b]AGAINST[r].[minus][cycling]"	--	"AGAINST"
scripture picturers	"[if cleric circle is visited]You've gotten inside. The chantries and picturers are no longer useful clues.[else][one of]Going in to the church is not so easy. Simply saying [b]IN[r] isn't churchy enough.[plus][or]You need to be a little more flowery to enter the church. Is there any clue?[plus][or][b]DIE SIN[r] becomes something new.[plus][or]You can kick the sign to change it to [b]SIN DIE[r] for another clue.[plus][or][b]INSIDE[r].[minus][cycling][end if]"	--	"INSIDE"
snatchier chantries	--	scripture picturers
Brother Horbert	"He'll mix the reagents once you get them."
summary	"It's there for background: why you're doing what you're doing. Oh, about Mum Ray, I can't tell you. It's too sad/confidential/unbelievable."
snoop spoon	"Examine the snoop spoon for a hint when you need it."
list o toils	"The list-o-toils tells what you need[if stupor sprout is moot]ed[end if] to get. There is one item in each aboveground Routes location besides the Cleric Circle."
rs	"They're there to re-enforce your lack of direction."
worst ad	"[one of]How would you approach the worst ad?[plus][or][b]RADWOST[r] is what the ad sells, whatever that is. That plus the settler gets you the vowels. A big clue for this Last Lousy Point.[plus][or][if cur-score of routes is 0]I'll check if you want to find what sort of words work here before going on[else]There are only so many prepositions in the English language[end if].[plus][or][b]TOWARDS[r].[minus][cycling]"	--	"TOWARDS"
adsorbing signboard	"[one of]You can't walk into Pat's as normal. It moves, and you never seem to get to the door.[plus][or]You just need to flip two letters to enter Pat's.[plus][or][b]PAST[r] works.[minus][cycling]"	--	"PAST"
resto store	--	adsorbing signboard
lairage regalia	"[one of]You can't walk into Oscar's as normal. It moves to the other side.[plus][or]What's a preposition that's anagrammatic to Oscar's?[plus][or]Not down to enter Oscar's--perpendicular.[plus][or][b]ACROSS[r].[minus][cycling]"	--	"ACROSS"
uhh tut hut	--	lairage regalia
Gast	"[if Gast is off-stage]The giant is not in view yet. You need to examine the list-o-toils in the church[else if Gast is moot]You're done with [Gast][else]BUG. You should be directed to the [sit a nag] or relevant part you need to figure, now[end if]."
side art	"[one of][Gast] seems to want you to listen to [his-her] tirades.[plus][or]This is a bit tricky--but the letters settler may help quite a bit. You know where the T is, and three consonants in a row aren't common.[plus][or][b]ASTRIDE[r].[minus][cycling]"	--	"ASTRIDE"
tirades	--	side art
WOE BOW BELL	"[one of]The [b]WOE BOW BELL[r] doesn't have a ten-letter anagram, but a five-letter one.[plus][or]Since the [b]WOE BOW BELL[r] makes you see red, that also helps with what the letters should be, if you don't want to scan things. There's a direction you can go that might make you feel better about avoiding the bell.[plus][or]Go [b]BELOW[r].[minus][cycling]"	--	"BELOW"
Rude N Nuder	"[one of]The contents of [Nuder] are probably worse than [Gast] ranting. But again, you need to avoid [his-her] flailing entirely. You need to duck something that's over.[plus][or]On cheat mode, [Nuder] scans oddly and gives you the solution.[plus][or]You need to go [b]UNDER[r].[minus][cycling]"	--	"UNDER"
Oscar	"Oscar has little to say, [if U NERD ENDUR REDUN is in Adobe Abode]but the pipe soot is something you may need[else]and you got the pipe soot[end if]."
Pat	"Pat has little to say, other than to discourage you from the seed pit, [if seed pit is reflexed]but you got through there[else]so you need to enter it despite Pat's objections[end if]."
U NERD ENDUR REDUN	"U NERD ENDUR REDUN is part of the spiers['] potion that will help let people see directions again[if Cleric Circle is unvisited]. But you need to get into the Cleric Circle first[end if]."
a trashy ashtray	--	pipe soot
pipe soot	"[if pipe soot is not in Adobe Abode]You got the pipe soot.[else][one of]You can't just walk over to the ashtray and get the pipe soot. Oscar wants you facing him.[plus][or]How can you face someone and be far away?[plus][or]Be completely [b]OPPOSITE[r].[minus][cycling]"	--	"OPPOSITE"
seed pit	"[one of]Pat's not going to let you have the stupor sprout you probably need from the seed pit.[plus][or]However, Pat mentions a lot are worthless. The seed pit is too dangerous. You need to say something to ignore the seed pit warning.[plus][or]Tell Pat you'll go in [b]DESPITE[r] the warnings.[minus][cycling]"	--	"DESPITE"
stupor sprout	"The stupor sprout is part of the spiers['] potion that will help let people see directions again[if Cleric Circle is unvisited]. But you need to get into the Cleric Circle first[end if]."
cravings carvings	"The cravings carvings clue how to get into the seed pit."
MORF FORM	"[one of]The [b]MORF[r]-[b]FORM[r] may be what was needed.[plus][or]It needs to change physically. What it is, and where it is.[plus][or][b]MORF[r] is spelled wrong on purpose.[plus][or]It's threatening, where it will be. How can you not worry about where it will be?[plus][or]Make it [b]FROM[r].[minus][cycling]"	--	"FROM"
be ova	"[one of][be ova] doesn't signal the end. Maybe the end of the beginning, or the beginning of the end.[plus][or]The letters do seem a bit forced, but there are five. You need to look somewhere instead of at [be ova].[plus][or]You need to look [b]ABOVE[r].[minus][cycling]"	--	"ABOVE"
THE BEAN	"[one of]The Bean has given you a place to go or look--or, rather, a not-quite-direction.[plus][or]The ground feels a little shakier since [the bean] landed, but not enough to go straight down.[plus][or]PUSHing the Bean seems useless.[plus][or]You can go [b]BENEATH THE BEAN[r].[minus][cycling]"	--	"BENEATH"
NULL IT unit	"[one of]The [b]NULL IT[r] unit is producing the darkness and has for a while.[plus][or]You need an adjective of time.[plus][or]The are was unlit, but now it is...[plus][or][b]UNTIL[r].[minus][cycling]"	--	"UNTIL"
darkness	--	NULL IT unit
odd run on aura	"[one of]The odd run on aura gives directions of a sort. It will help you look. Where? How?[plus][or]Use the odd run on aura to look [b]AROUND[r].[minus][cycling]"	--	"AROUND"
un road	"You need to follow the un-road, but the all noon gag has better clues for that."
noon gag	"[one of]The all noon gag provides a new quasi-direction you need to go in, to see No-Lag Logan.[plus][or]How do we go down a path? Or follow it? Within the rules of the Routes area?[plus][or]Go [b]ALONG[r].[minus][cycling]"	--	"ALONG"
data dim mists	"[one of]The mists and ad provide a clue how to move next.[plus][or]The ad has aligned anagrams (six unique letters, then six more) and red writing, too, so it may give more clues.[plus][or]Go [b]AMIDST[r].[minus][cycling]"	--	"AMIDST"
Admits Mist Ad	"[one of]There's a lot of red writing that should be a clue, but it is a slightly odd preposition.[plus][or]You just need to go around. All over the place.[plus][or][b]AMIDST[r] will help you search everywhere.[minus][cycling]" 	--	"AMIDST"
thickness sketchins	"[one of]The poem seems to have [b]AAHRTTW[r] as the letters. It's tough to navigate, but you seem to need to go this way and that way.[plus][or]This word is a bit archaic, so you may want to use the spoon.[plus][or][b]ATHWART[r].[minus][cycling]"	--	"ATHWART"
bad oar	"The thickness sketchins will tell you how to use the bad oar."
raptest patters	"[one of]'Thou wit!' You don't really need the flattery, but it won't really derail you.[plus][or]It might be better to ignore them.[plus][or]Or not put up with them.[plus][or]Or do [b]WITHOUT[r].[minus][cycling]"	--	"WITHOUT"
bent ewe	"[if bent ewe is reflexed]Deal with the hurt hog now.[else][one of]The bent ewe feels threatened by the hurt hog. Maybe you can defuse things.[plus][or]Get in the way.[plus][or]Sonancy Canyons is another country. They do things differently there.[plus][or][b]BETWEEN[r].[minus][cycling][end if]"	--	"BETWEEN"
hurt hog	"[one of]The hurt hog won't let you by. You [if bent ewe is reflexed]dealt[else]need to deal[end if] with the bent ewe.[plus][or]With the newt bee sated, everyone will be happy, and you can go...[plus][or][b]THROUGH[r].[minus][cycling]"	--	"THROUGH"
yob den	"[one of]It's not really important. They're just a symptom of what's gone wrong.[plus][or]So how to ignore the yob den and move away from it?[plus][or]Go [b]BEYOND[r].[minus][cycling]"	--	"BEYOND"

table of troves hintobjs
hint-entry	advice-entry	parallel-entry	spoil-entry
Pa Egg Pea	"[one of]Reading Peg A. Page's book will give you hints what to do in general.[plus][or]The book has a personality-cult feel about it. Perhaps you are reading it too critically.[plus][or][b]GAPE[r] at the book.[minus][cycling]"	--	"GAPE"
tears taser	"[one of]The tears taser is optional, but you can't really react to it. You must be more physically passive.[plus][or]How to stand up to the tears taser without showing fear? Give it some of its own medicine.[plus][or][b]STARE[r] at the tears taser.[minus][cycling]"
Eh At Heat	"[one of]Man! You're just upset about what happened to you. Maybe there's a way your emotions could make you warmer.[plus][or]There's an emotion you can physically boil over with that anagrams with [heat].[plus][or]You can [b]HATE[r] for a quick surge.[minus][cycling]"	--	"HATE"
Race Acre	"[one of]You can't be bothered with the Race Acre since you're drained from that hate. You need a new approach to get going again.[plus][or]You need to [b]CARE[r].[minus][cycling]."	--	"CARE"
fretful truffle	"The fretful truffle, if you eat it, will tell you what to [if cur-score of troves is 0]type[else]think[end if] next."
verbose	"[one of]Even when someone or something is terse with you, their terseness can give you something to focus on and manipulate.[plus][or][b]OBSERVE[r] other people or things.[minus][cycling]."	--	"OBSERVE"
post	"[one of]You must persist when you are stonewalled. The second time is easier than the first and likely requires less creativity.[plus][or]You may [b]SPOT[r] something interesting on a second look.[minus][cycling]"	--	"SPOT"
mussier misuser	"[one of]The mussier misuser is not very sophisticated. You can show you think you're smarter than they are.[plus][or][b]SURMISE[r] whatever you think is important.[minus][cycling]."	--	"SURMISE"
SNORE SO ARENA	"[one of]There's no good reason for the [b]SNORE SO ARENA[r] to be there. But it may still block you from doing what you want.[plus][or]If you listen, you may get other clues.[plus][or]If you [b]REASON[r], it will disrupt but the arena and the [evil bee].[minus][cycling]"	--	"REASON"
evil bee	"[one of]Even intellectual elitists know, deep down inside, that there is an emotional component to things.[plus][or]They hope to be able to [b]BELIEVE[r] without letting the common man do so as well. Not that they need to, to achieve their goals.[minus][cycling]"	--	"BELIEVE"
A Sty Tasty Say	"[one of][tasty] is not practical to enter. You'll want to avoid it. Don't risk going in.[plus][or][b]STAY[r].[minus][cycling]"
L Clear Cellar	"[one of]To open the cellar, you need not [b]REMEMBER[r] anything and everything. Instead, just say 'Oh I know' after someone offers knowledge. It works, because, you know--well, you [b]BETTER[r] know...[plus][or]It is better to be able to [b]RECALL[r].[minus][cycling]."	--	"RECALL"
spider	--	ires pad
ires pad	"[one of]Each picture/author name in the Ires Pad has a red-letter clue.[plus][or]The objects in the Drain Nadir should give you a clue what to do next, since they're all anagrams.[plus][or]Examining yourself, you need to hit total rock bottom.[plus][or][b]DESPAIR[r].[minus][cycling]"
diapers	"[one of]The diapers symbolize ... wait, no, they just mesh with the other items to present a seven-word anagram.[plus][or]Nevertheless, diapers are pretty depressing, too.[plus][or][b]DESPAIR[r] is a last option that is hard to come back from. Except when coming back from it slingshots you past people who can't even despair.[minus][cycling]"	--	"DESPAIR"
lager	"[one of]The Large Regal Lager [if player is in Boredom Bedroom]here [end if]in Boredom Bedroom serves a purpose, but not a critical one.[plus][or]You are upset at the lager. You can make a moral statement by looking at it funny.[plus][or][b]GLARE[r] at the lager.[minus][cycling]"	--	"GLARE"
Id Cede	"[one of]Eddie C, [Id Cede]. Listening once helps you see red.[plus][or]Another time listening gives you notes, lyrics and more red.[plus][or]A third should clinch it. You want to do more. Or less.[plus][or][b]DECIDE[r].[minus][cycling]"	--	"DECIDE"
pleaser leapers	"[one of]The pleaser leapers are meant to give shallow happiness, but you may want to go for the opposite.[plus][or]You're on your way to healing, but the path is not smooth.[plus][or][b]RELAPSE[r].[minus][cycling]"
lobster	"[one of]That lobster looks delicious, but you can't bring yourself to eat it. You don't have the confidence[if ME ARTS is in Boredom Bedroom]. NB: finding what to do with the [b]ME ARTS[r] also works[end if].[plus][or]You need to boost yourself![plus][or]Or, rather, [b]BOLSTER[r]![minus][cycling]"	--	"BOLSTER"
ME ARTS	"[one of]The [b]ME ARTS[r] should relax you to feel on top of things[if lobster is in Boredom Bedroom]. NB: finding what to do with the lobster also works[end if].[plus][or]You need to be able to control, to understand...[plus][or]...or to [b]MASTER[r].[minus][cycling]"	--	"MASTER"
LEAD	"[one of]Feelings of despair are okay. Working through them can help you learn to lead. Unless they don't. Then you deserve more despair.[plus][or]If you can't [b]DEAL[r], you'll never make it.[minus][cycling]"	--	"DEAL"
See Dir	--	Si Reed
Si Reed	"[one of]Si Reed wants to help you focus on certain mental stuff.[plus][or]Do not get too hippy-trippy on yourself. Without material [b]DESIRE[r], nobody would want or build anything.[minus][cycling]"	--	"DESIRE"
dour tan rotunda	"It's what the Browse Bowers used to be called."
praise	"[one of]What do the rivets say? [b]PRAISE[r]. It should motivate you![plus][or][if rivets are reflexed]You already got what to do with the rivets, so the settler will be more merciful to you[else]The settler gives a mess because [b]PRAISE[r] and [b]RIVETS[r] go to different words, but the question mark is a clue in its own way[end if].[plus][or]How to want more without wanting more?[plus][or]You need to [b]ASPIRE[r].[minus][cycling]"	--	"ASPIRE"
rivets	"[one of]Trevis Vister (and the rivets) can help you want to be your best. Or well, worth your most.[plus][or]Scanning Trevis Vister in cheat mode doesn't turn up any question marks.[plus][or]The rivets give a critical abstract clue that Trevis doesn't, since they are red. They help with the vowels.[plus][or][b]STRIVE[r].[minus][cycling]"	--	"STRIVE" [?? hint before and after]
Trevis Vister	--	rivets
Desk Sked	"Useful for organizing tasks much trickier than playing dumb computer games."
cark rack	"Just part of the scenery."
godlings lodgings	"[if END PRONER POD is off-stage]You can't think of getting into [the lodgings] until you are in tune with Trevis Vister.[else]The [b][end proner pod][r] holds a clue how to get into [the lodgings].[end if]"
sectarian craniates	"[one of]This is optional, but you can find another way to think and move ahead.[plus][or][b]ASCERTAIN[r].[minus][cycling]"
END PRONER POD	"[one of]You don't want to wind up in the [b][end proner pod][r], but part of you still worries about the risk of failure. Or it advertises itself that way.[plus][or]You need a way to reflect, to balance your desiring.[plus][or]You can [b]READ[r] the [b]END PRONER POD[r] for clues if you want. They will logically eliminate all possibilities.[plus][or]You need to [b]PONDER[r] how to get in.[minus][cycling]."	--	"PONDER"
r cad card	"The r-cad card gives a clue, along with the [b][end proner pod][r], of how to get into [the lodgings]."
red vees	"[one of]You have to believe it's worth it for you to do something with the red vees. That you're good enough.[plus][or]You must learn to [b]DESERVE[r] to use them.[minus][cycling]"	--	"DESERVE"
DIVORCES	"[one of]You can learn something from [b]DIVORCES[r]. Not from the content, but from just how vapid and materialistic it is.[plus][or]You may have an epiphany how bad the magazine is.[plus][or]You can [b]DISCOVER[r] to put the magazine to shame.[minus][cycling]"
salt	"[one of]Anyone can make it to the top, but only those worth their salt will stay for any meaningful length of time.[plus][or]The truly great can [b]LAST[r].[minus][cycling]"	--	"LAST"
Sister Tressi Siters	"[one of]You can't fully agree with Sister Tressi.[plus][or]You're almost sick of the whole situation, but you need a way out of here. A physical way won't work.[plus][or]What's the first step to saying no?[plus][or][b]RESIST[r].[minus][cycling]"	--	"RESIST"
blamer balmer	"[one of]Blamer Balmer helps you keep your focus.[plus][or]But you'd like to wander a bit... in your mind...[plus][or][b]RAMBLE[r].[minus][cycling]"	--	"RAMBLE"
blamer mr beal	"[one of]Mr. Beal helps you keep your focus.[plus][or]But you'd like to wander a bit... in your mind...[plus][or][b]RAMBLE[r].[minus][cycling]"	--	"RAMBLE"
Creationism Reactionism	"[one of]It's a big book, [creationism], with big words, and a big thinking-verb. Something fanciful and impractical.[plus][or][b]ROMANTICISE[r][minus][cycling]"
trance nectar	"[one of]You don't want to drink it. You want to get out of the whole situation.[plus][or]How to apologize to yourself?[plus][or][b]RECANT[r].[minus][cycling]"	--	"RECANT"

table of presto hintobjs
hint-entry	advice-entry	parallel-entry	spoil-entry
curst crust	"[one of]You'll say something reflexive if you eat the crust.[plus][or][if Grey Gyre is unvisited]The crust is useful in the [b]PRESTO[r] region.[else]Eating it gives you a hint what to say.[end if][minus][cycling]"
volt maze	"[maze-solve]."	--	"[b]MAZEL TOV[r]"
zany meter	--	volt maze
n-t-air	"[one of]Nowt Town may make you feel lethargic. You can find a quick word that substitutes as an interjection but isn't really one.[plus][or]You won't get full points for the (non-profane) four-letter word.[plus][or]say [b]WONT[r] to dispel the maze.[minus][cycling]"	--	"WONT"
big l	"The big L tells you what letter the maze starts on."
big-let	"[one of]It's kind of a hint[if r10 is unvisited], and you'll find more later in the maze[else if Unwary Runway is unvisited], and you've certainly seen a lot through the maze, which seems to end here[else], and they seem to be in alphabetical order[end if].[plus][or]I've said a lot with that clue. If you've gotten through the maze, you'll know it's from L to V.[plus][or]Maze, L to V, don't congratulate yourself?[plus][or][b]MAZEL TOV[r].[minus][cycling]"
Lev Tzoma	"You can scan Lev for hints. He's not much for conversation."	--	"MAZEL TOV" [bold-ok]
Zo Mavelt	"You can scan Zo for hints. He's not much for conversation."	--	"MAZEL TOV" [bold-ok]
Tom Avlez	"You can scan Tom for hints. He's not much for conversation."	--	"MAZEL TOV" [bold-ok]
lamb	"[one of]The lamb is petrified with fear, but maybe the right fear would get it going again.[plus][or]What sort of noise can you make to get it going?[plus][or][b]BLAM[r].[minus][cycling]"	--	"BLAM"
angrier earring	"The angrier earring will do what it needs when the time is right. You haven't explored [if saps pass is visited]quite [end if]enough, yet."
censer	"[one of]The censer's black and green and really retro.[plus][or]The censer may remind you of what people used to play text adventures on a long time ago.[plus][or]It can become a [b]SCREEN[r].[minus][cycling]"	--	"to make a [b]SCREEN[r]"
dart	"[one of]The dart is stuck in the dumpster, and taking it doesn't work.[plus][or]Frustrating, eh?[plus][or]What's a good word of frustration?[plus][or]Four letters.[plus][or][b]DRAT[r].[minus][cycling]"	--	"DRAT"
tsar star	"[one of]The tsar star is stuck in the tars, and taking it is too frustrating.[plus][or]Sticky, eh? The tars and the tsar star.[plus][or]What's a good clean word of frustration?[plus][or]Four letters, but not [b]FOUR LETTERS[r].[plus][or][b]RATS[r].[minus][cycling]"	--	"RATS"
tars	--	tsar star
cretins cistern	"The cretin's cistern [if dart is in Char Arch]is[else]was[end if] only relevant because it [if dart is in Char Arch]holds[else]held[end if] the dart. You don't need to deal with it directly."
hump	"[one of]Hm, you can't get over the hump.[plus][or]What's a good word before you give a bunch of effort?[plus][or][b]UMPH[r].[minus][cycling]"	--	"UMPH"
plebe	"[one of]You need to get rid of that plebe.[plus][or][if player has tsar star or player wears tsar star]You've got something that will impress him[else]You need to find something to impress the plebe--you may want to go visit the Char Arch to the south[end if].[plus][or]What are plebes scared of? A good tongue lashing.[plus][or]The game blocks the worst profanities. But you've got a pretty general one.[plus][or]You can say [b]BLEEP[r] [if player has tsar star or player wears tsar star]now[else]once[end if] you have the tsar star.[minus][cycling]"	--	"BLEEP"
Ye Hoop	"[one of]There are two ways to deal with the hoop, err, Ye Hoop.[plus][or]You sort of have to be impressed by the hoop, and say a little something to try harder, or say the heck with your possessions, which bog you down if you try to jump.[plus][or]You can say [b]POOH[r] to give your jumps a little boost, but you can do a bit better.[plus][or]What can [b]YE HOOP[r] anagram to?[minus][cycling]"	--	"POOH"
Leo	"[if Leo is fightin][one of]You need to neutralize Leo.[plus][or]He charges at you like a bull.[plus][or]What do you exclaim to get out of the way of a bull?[plus][or][b]OLE[r]![minus][cycling][else if Rand is fightin]Deal with Rand first.[else if Rand is washed up][wash-up][else if Rand is in Hacks Shack]The sign provides a clue how to get rid of [l-n-r] so you can enter the shack.[else if ether is not moot]You may need him for a fight.[else]He can't do much more, so time to find a place to say good-bye.[end if]"	--	"OLE"
Rand	"[if Rand is fightin][one of]You need to neutralize Rand.[plus][or]Perhaps another feint can help you defeat Rand.[plus][or]What can you say to fake him out? A word of half-surrender.[plus][or][b]DARN[r]![minus][cycling][else if Leo is fightin]Deal with Leo first.[else if Rand is washed up][wash-up][else if Rand is in Hacks Shack]The sign provides a clue how to get rid of [l-n-r] so you can enter the shack.[else if ether is not moot]You may need him for a fight.[else]He can't do much more, so time to find a place to say good-bye.[end if]"	--	"[if Rand is fightin]DARN[else]WHASSUP[end if]" [bold-ok]
wzup	"[wash-up]"	--	"WHASSUP"
sods gone odes song	"[one of]The odes song is optional, but you can deal with it.[plus][or]A non-profane interjection expressing exasperation works here.[plus][or]The solution to the odes song is usually prefaced my 'my.'[plus][or][b]GOODNESS[r].[minus][cycling]"
popgun	"[if dart is in popgun]The popgun's locked and loaded.[else if boing is reflexed]You can just put the dart in the popgun.[else]The popgun is broken. More precisely, its boing-go bin, used to hold ammo, is broken.[end if]"
boing go bin	"[one of]So, the boing-go bin doesn't go [b]BOING[r].[plus][or]A eureka moment could change the boing-go bin's brokenness.[plus][or]Or, if you notice the popgun's serial number...[plus][or]...and convert the numbers to letters...[plus][or][b]BINGO[r].[minus][cycling]"	--	"BINGO"
sport ports	"[one of]The sport ports can give you a bonus point if you look at them right.[plus][or]This is a foreign language way to say 'cheers' to people who can navigate them.[plus][or][b]PROST[r].[minus][cycling]"	--	"PROST"
harpings phrasing	"[one of]The sign gives you three ways to tell [l-n-r] they've done their job[if rebuked is true], and they've been persistently loyal, so maybe you need another way to say things[end if].[plus][or]It's time to [if rebuked is true]find another way to [end if]say good-bye to [l-n-r], but you can't be all 'Obey, Dog.'[plus][or]Maybe the sign can help you say [if rebuked is true]one more thing[else]what[end if] you need to, to ditch [l-n-r]?[plus][or][sl-t-l].[minus][cycling]"	--	"[if entry 1 of byebyes is log ons]SO LONG[else if entry 1 of byebyes is alert]LATER[else]TOUGH[end if]" [bold-ok]
alert letters	"[one of]The sign indicates you may want to get rid of [l-n-r], who are not very smart.[plus][or]Say [b]LATER[r].[minus][cycling]"
log ons letters	"[one of]The sign indicates you may want to get rid of [l-n-r], who are not very smart.[plus][or]Say [b]SO LONG[r].[minus][cycling]"
ought letters	"[one of]The sign indicates you may want to get rid of [l-n-r], who are not very smart.[plus][or]Say [b]TOUGH[r].[minus][cycling]"
ether	"[if Rand is not eager or Leo is not eager]You'll need friends to get through there. Try making them down by the dumpster.[else if boing is reflexive or dart is not in popgun]Muscle isn't enough. You need a weapon.[else][one of]You can sort of make out stuff through the ether.[plus][or]If you could give [l-n-r] a word before [l-n-r] walked in, it'd be a big help.[plus][or]What to yell, so they know where to look?[plus][or][b]THERE[r].[minus][cycling][end if]"	--	"THERE"
lawl wall	"[one of]The wall can't be changed on its own.[plus][or]But the keys or hogs can be...dealt with. Try hinting either of them.[minus][cycling]"	--	"[if goshy is true]GOSH[else]SYKE[end if]" [bold-ok]
hogs	"[one of]The hogs find it funny you can't get the keys.[plus][or]If you expressed your disappointment, the hogs might get overconfident.[plus][or][b]GOSH[r].[minus][cycling]"	--	"GOSH"
keys	"[one of]You really want the keys, and there's no way to pretend you don't.[plus][or]Maybe you can pretend, sort of, and annoy the hogs.[plus][or][b]SYKE[r].[minus][cycling]"	--	"SYKE"
hawt thaw	"[one of]You can do something with the hawt thaw, but it's not critical to the game.[plus][or]You may wonder how or why the heck it exits.[plus][or]Saying [b]WHAT[r] makes it disappear.[minus][cycling]"
starch charts	"[one of]The starch charts aren't critical to the game, but what to do with them is a cross between an interjection and a noun, which signals the changes from outside the [shack] to inside.[plus][or]They seem useless, senseless.[plus][or][b]TRASCH[r].[minus][cycling]"
serial number	"[one of]The numbers can mean something else.[plus][or]Convert them to where they are in the alphabet.[plus][or]This is an alternate solution to grinding it out with the Settler.[plus][or][b]BINGO[r].[minus][cycling]"
futon	"[if peels speel is reflexed]You won't need to sleep on the futon again.[else][one of]The futon has patterns of tiresome--figuratively and literally--peels on it.[plus][or]The futon will be useful to sleep on when you need to.[minus][cycling][end if]"	--	"to [b]SLEEP[r] on the futon"
speel	"[one of]You're too tired to read the speel.[plus][or]You can't make any logic leeps in your current condition.[plus][or]Best to [b]SLEEP[r].[minus][cycling]"	--	"SLEEP"
fount	"[one of]The fount is a fount of knowledge. Dry knowledge, but knowledge.[plus][or]The fount's also very restful.[plus][or]You can probably find a way to fold the fount into...[plus][or]...a [b]FUTON[r].[minus][cycling]"	--	"to make a [b]FUTON[r]"
escaroles	"[one of]The escaroles aren't much of a meal on their own. They could be more meaty.[plus][or]The escaroles could be a dish instead of garnish. Any old dish, with all sorts of things slopped into it.[plus][or]Or a [b]CASSEROLE[r].[minus][cycling]"	--	"to fix a [b]CASSEROLE[r]."
casserole	"[if yak is in Hacks Shack or yak is moot]You can't use the casserole any more. You could've bribed [l-n-r] with it.[else][one of]You can't take the casserole--it's too hot. It's also kind of yucky for someone as sophisticated as you unless you need calories.[plus][or]Met anyone who can use calories who doesn't sweat niceties?[plus][or][l-n-r]. If you poke them when you have a tough physical task, you can get them to push the skid north.[minus][cycling][end if]"
trim socks	"[one of]The socks aren't critical to solving the game, but they do give an LLP--Last Lousy Point.[plus][or]The socks don't seem very technical, but they look like circuit chips or something.[plus][or]Maybe they'd make you go faster or something.[plus][or]Maybe they are, instead, [b]ROM STICKS[r].[minus][cycling]"
rom sticks	"[one of]You can put the sticks in Drive A to make it go faster. The game does this automatically.[plus][or]The sticks don't actually save moves or anything, though.[minus][cycling]"
gum	"[one of]Gum comes in more than six flavors at your local supermarket, but there are only five ways to change G-U-M.[plus][or]As for what it's good for, it's everlasting gum, and maybe what it changes into will help other things be everlasting.[plus][or]Oh, the solution?[plus][or][b]UMG[r], er, OMG, do you need to ask?[plus][or]You don't need to go to George Mason University.[plus][or]I just put extra clues in to give more clues than anagram possibilities, because I could.[plus][or][b]MUG[r]. In which you pour liquid.[minus][cycling]"	--	"to make a [b]MUG[r]"
mug	"[if ALocalCo Cola is moot]You will be able to drink from the mug when the time is right.[else][mug-detail][end if]"
skid	"[if yak is moot][one of]The skid has done what it needs.[plus][or]You should change it back to a [b]DISK[r] now.[minus][cycling][else if skid has not been in Saps Pass]The skid can be pushed from place to place. You will need to.[else if yak is not on skid][one of]The skid can move things that won't budge.[plus][or]There's one thing that won't budge that has something you might need.[plus][or]The yak.[plus][or]You need to bribe the yak with something else.[plus][or][leaf-or-flea][plus][or]Put the leaf on the skid, and the yak will hop aboard.[minus][cycling][else if skid is not in Hacks Shack]You need to push the skid to the shack.[else]It's the yak you need to worry about, now.[end if]"
oper rope	"The oper rope isn't useful on its own, but it lets you [b]PULL[r] the skid."
disk	"[if skid is off-stage][one of]You can change the disk to something else.[plus][or]The disk can become a [b]SKID[r].[minus][cycling][else if disk is in Drive A]The disk is taken care of.[else]The disk can go in Drive A, [once-now-shack] you've got a full computer constructed."	--	"to make a [b]SKID[r]"
keyboard	"[one of]The keyboard belongs on the table[unless caps lock is part of keyboard], and it's missing a piece[end if].[plus][or][if caps lock is touchable]Put the caps lock in the keyboard.[else]See what you can do with the Clack Ops Locs Pack.[end if][minus][cycling]"
leaf	"[if leaf is not on skid]You can put the leaf on the skid to tempt the yak.[else]The leaf's where it should be.[end if]"
TBA key	"[if TBA key is reflexive]The tab key's what it needs to be.[else][one of]The [b]TBA[r] key is not a regular keyboard key. You can change it.[plus][or]The [b]TBA[r] key can become [b]TAB[r].[minus][cycling][end if]"
signature	--	Im Le Cop polemic
ALocalCo cola	"[one of]The cola is great for drinking (without knowing it) during a long programming session. But there's only so much of it.[plus][or]You can pour the cola in [if gum is moot]the mug[else]what the gum can become[end if].[minus][cycling]"
Im Le Cop polemic	"[if signature is reflexed]Useless now.[else][one of]The signature and the I'm Le Cop polemic are clues to what to do.[plus][or]You can scan them both in cheat mode to figure where the vowels go.[plus][or]Or you can think of a computer term to get a program up and running.[plus][or]You need to [b]COMPILE[r].[minus][cycling][end if]"	--	"to learn to [b]COMPILE[r] from the I'm Le Cop polemic"
scratchings	"[one of]They give a clue what the drab yoke will be.[plus][or]Have you seen any apparatus with the numbers 1234567890 at the top, in order?[plus][or]One that is by you right now?[plus][or]They clue that the drab yoke can be a keyboard. But yaks aren't very magic, and this one's resisting in some odd animal fashion. So you need to deal with the yak.[minus][cycling]"
drab yoke	"[if yak is not moot]The yak won't let you have it. You need to make the yak inattentive.[else][one of]Whatever the drab yoke should be is probably some sort of piece of computer equipment, too. Given the end puzzle.[plus][or]The settler will tell you where the Y should go. You can also figure where the O goes, on cheat mode, and two consonants fall, too.[plus][or]But the scratchings make it obvious what the yoke should be.[plus][or]Numbers on the top, letters below it, punctuation to the side.[plus][or][b]KEYBOARD[r].[minus][cycling]"	--	"to make a [b]KEYBOARD[r]"
BUB DUDE EGG	"[one of][bub dude egg] is a warning message that gives hints.[plus][or]You may notice it has two of five different letters, and random actions point out you see red trying to make the code [b]BUDGE[r].[plus][or]More specifically, [bub dude egg] shows up because there are still bugs to fish out.[plus][or]Therefore, you need to [b]DEBUG[r].[minus][cycling]"	--	"to DEBUG the code you compiled"
slab	"You [if cpuready]already[else]can[end if] put things on the slab to build a computer."
USB	"[one of]The [b]USB[r] is pretty universal. It can become either of two things.[plus][or]The [b]USB[r] can become transport out of here.[plus][or][b]SUB[r] or [b]BUS[r].[minus][cycling]"	--	"to make a [b]BUS[r] or [b]USB[r]"
caps lock	"[if caps lock is part of the keyboard]The caps lock is where it should be.[else][one of]What does a caps lock work with?[plus][or]A keyboard.[plus][or][kboard-blah].[plus][or]Put the caps lock in the keyboard.[minus][cycling]"
yak	"[if Hacks Shack is unvisited][yak-worry].[else if yak is not on skid][one of]The yak won't give up what's on its drab yoke. You need to tempt the yak onto the skid.[plus][or]What is a good way to tempt an animal?[plus][or]Food. PUT LEAF ON SKID after you pushed it.[minus][cycling][else if skid is not in Hacks Shack]Push or pull the skid back to the shack.[else][one of]Now you need to find some way to make the yak just plain sleepy.[plus][or]Find any boring items?[plus][or]The catechism. Or the bad book that anagrams the keyboard.[plus][or]SHOW BAD BOOK TO YAK.[minus][cycling][end if]"
catechism	"[if yak is moot]With the yak dispatched, the catechism is only good for random anagrams. Or for being a prop to help you semi-plausibly learn how to program.[else][one of]The catechism is just for entertainment, but reading it may clue something.[plus][or]It is less painful and boring than [my-bad].[plus][or]You may wish to try reading [my-bad] instead. Maybe it will bore the right person to sleep, or something.[minus][cycling]"
be troo e robot	"[if be troo e robot is reflexed]The [robot] has helped you enough. The rest is up to you.[else][one of]The [robot] can do something which is tricky for you.[plus][or]There appear to be no major control buttons, but the [robot] may be able to take an order.[plus][or]What is something you should try when any computer is acting strange?[plus][or]You need to [b]REBOOT[r].[minus][cycling][end if]"	--	"to [b]REBOOT[r] with the E-Robot"
Clack Ops Locs Pack	"[one of]The locs pack is allegedly for making things quieter.[plus][or]But why is so much of its text in [b]LETTERS LIKE THESE[r]?[plus][or]Because it can become [b]CAPS LOCK[r] buttons.[minus][cycling]"	--	"to make a [b]CAPS LOCK[r] key"
flea	"[one of]The flea is surprisingly brightly and multicolored for something dead.[plus][or]What else like [b]FLEA[r] is colorful when it's dead?[plus][or]The flea can become a [b]LEAF[r].[minus][cycling]"	--	"to make a [b]LEAF[r]"
coal	"[one of]Coal. Cheap, dirty energy for machines.[plus][or]The coal can become cheap dirty energy for people.[plus][or]What do hackers like to drink?[plus][or]Mountain Dew, Pepsi, Dr. Pepper...[plus][or][b]COLA[r].[minus][cycling]"	--	"to make [b]COLA[r]"
Drive A	"[h-d][line break]"
Drive E	"[one of]You need to figure what's wrong with Drive E.[plus][or]Deduce, if you will. Well, not quite deduce.[plus][or][b]DERIVE[r].[minus][cycling]"
mutism summit	"[if player is in Hacks Shack]You need to build a computer here[else]The mutism summit is just scenery when you're in the Phat Path. But you can enter by going north[if-rand-gone][end if]."
golden dongle	"The golden dongle is just there to make it plausible to hook Drive A to other hardware."
computer screen	"[if Hacks Shack is unvisited]You haven't found anything to attach it to.[else if computer screen is not on slab]You need to attach the screen to the drive.[else]The screen's where it needs to be.[end if]"

to say maze-solve:
	say "[one of]You don't need to enter the maze to solve it[or]There's a magic word[or]Congratulate yourself before you enter. But nothing pedestrian[or]Note the Yiddish clues if you solve it[or][b]MAZELTOV[r][cycling]";

to say wash-up:
	say "[one of][l-n-r] are a bit upset you beat them, but you can fix that.[no line break][plus][or]They think they're washups.[no line break][plus][or]What could show the washups you meant no harm?[no line break][plus][or]You can talk to the washups for clues of something nice to say.[no line break][plus][or]They're not interested in stuff. Not perfect grammar here, but they're not exactly grammar cops...[no line break][plus][or]Say [b]WHASSUP[r].[no line break][minus][cycling]"

to say sl-t-l:
	repeat with AA running through byebyes:
		if AA is reflexive:
			say "[if AA is log ons][b]SO LONG[r][else if AA is alert][b]LATER[r][else][b]TOUGH[r][end if]";
			continue the action;
	say "BUG--sign should've said something";

to say mug-detail:
	say "[one of]Like the never-ending gum it came from, the mug regenerates what's in there.[plus][or]What goes in a mug? Liquid, generally.[plus][or][if coal is not moot]You can probably figure what to do with the coal to make a liquid.[end if]The cola is a liquid.[plus][or]POUR COLA IN MUG.[minus][cycling]"

to say leaf-or-flea: say "[if leaf is off-stage]You need to change the flea in the shack.[else]The leaf in the shack will work.[end if]"

to say once-now-shack: say "[if keyboard is on slab and disk is in Drive]now[else]once[end if]"

to say kboard-blah: say "[if keyboard is off-stage]You need to find a keyboard. An animal and its item may provide a clue[else]The keyboard you got from the yak's drab yoke will work[end if]"

to say yak-worry:
	say "You don't need to worry about the yak for a long time[if Leo is not touchable]. You may want to go to Dirge Ridge, south of the Char Arch, for companions[else if Saps Pass is not visited]. You need to go north of the gyre and the maze, first[end if]"

to say h-d: [??]
	if disk is in drive:
		say "[one of]The A Drive/Drive A is [b]VARIED[r], and this opens up a last lousy point.[plus][or]You may want to make Drive A go faster all the time. With more enthusiasm.[plus][or]Drive A can become [b]AVIDER[r].[minus][cycling]";
		continue the action;
	if keyboard is on slab and screen is on slab:
		say "You need to put the disk in the drive.";
		continue the action;
	say "[one of]You can put the disk in the drive, when you're done. You can also attach things to the drive or put things on the slab. Computery things.[plus][or][if yak is not moot]You need to get something to operate the computer with first, though.[else if keyboard is touchable and keyboard is not on slab]You can put the keyboard on the labs slab.[else if computer screen is touchable and computer screen is not on slab]You can put the computer screen on the labs slab.[else]You need to put find and put components on the labs slab to get the disk working.[end if][plus][or]You can push a button once you're done.[minus][cycling]"

to say if-rand-gone:
	say "[if rand is in Dirge Ridge]now[else]once[end if] [l-n-r] are gone"

table of oyster hintobjs
hint-entry	advice-entry	parallel-entry	spoil-entry
trolls	"[one of]The trolls are there to keep people in. You can't beat them up.[plus][or]You need to distract the trolls, preferably by annoying the pesty types.[plus][or]The tunes, the stein and Casper are all part of the bar[dh-true].[minus][cycling]"	--	"[b]STROLL[r] past the trolls"
tips pits	"[one of]The tips pits are for putting something in them.[plus][or]What could go in? A noun or a verb.[plus][or][b]SPIT[r] into the tips pits.[minus][cycling]"
song buttons	--	tunes
jukebox	--	tunes
perma amper	"[one of]The perma-amper is kind of complex, but knowing the right way to fiddle with it helps.[plus][or]It's something with a, e, m, p and r.[plus][or]What's another word for reconfigure?[plus][or][b]REMAP[r].[minus][cycling]"
tunes	"[one of]It's kind of complicated to change the tunes or get rid of them.[plus][or]Just pushing stuff to alter the tunes doesn't work.[plus][or]However, following the instructions can get rid of the tunes, if you do it right.[plus][or]You need to [b]UNSET[r] the tunes.[minus][cycling]"
Lil Ps pills	"[one of]What can you do with [b]PILLS[r]?[plus][or]You can pop the pills, but the lid is stuck.[plus][or]The pills can make life convenient for your adversaries, if they were on the ground.[plus][or]You would have to [b]SPILL[r] them.[plus][or]You can do so at various places.[minus][cycling]"
tines	--	stein
stein	"[one of]The stein is free.[plus][or]How does the stein hook up with the tines?[plus][or][b]INSERT[r] the stein and you're five-sixths there.[plus][or][b]INSET[r] the stein.[minus][cycling]"
casper	"[if recaps is moot]You've disturbed Casper enough.[else][casp-cap][end if]"
capers recaps	"[casp-cap]"
gins sign	"[if i-sung is true]You already managed to [b]SING[r].[else][one of]The gins sign is a last lousy point, but it's one that introduces what to do in the area.[plus][or]The drinks are named after depressing puns on popular music.[plus][or]This is a last lousy point, but because it is a hint, I'll tell you what it is next.[plus][or]You can [b]SING[r].[minus][cycling][end if]"
clam	"[one of]The clam is agitated. It probably doesn't want to attack you.[plus][or]You need to settle the clam down.[plus][or]I mean [b]CALM[r] it.[minus][cycling]"	--	"[b]CALM[r] the clam"
urn	"[one of]You can't walk away from the urn. You need to do something more decisive.[plus][or]You should [b]RUN[r] from the urn.[minus][cycling]"	--	"[b]RUN[r] from the urn"
Shoer Osher	"You might've learned something from Shoer Osher's publicist before Elvira came by, but for the game's purposes, Shoer Osher is just there for decoration and amusement."
Saccade Cascade	"[one of]There are two ways across Saccade Cascade.[plus][or]You can get the sabot boats' attention--one verb here, one in a side room--or launch the raft, which requires two.[plus][or]Hint the sabot boats or frat raft individually.[minus][cycling]"
frat raft	"[one of]Just getting on the frat raft is no fun. You want it to, well. move.[plus][or]Those oars on the frat raft would be a drag to pull around.[plus][or]Hint the oars if you can't figure out what to do with them.[minus][cycling]"
sabot boats	"[one of]The sailors aboard the sabot boats seem to like a good chat about accomplishments.[plus][or]How could you get the sabot boats['] attention with your own bragging or self-promotion?[plus][or][b]BOAST[r].[minus][cycling]"	--	"[b]BOAST[r] at the sabot boats"
crays	--	plea
plea	"[one of]You can't change the crays, but the plea offers a way out. The pale plea.[plus][or]You are feeling too jumpy to just plain jump, so you need to...[plus][or]...[b]LEAP[r].[minus][cycling]"	--	"[b]LEAP[r] by the plea"
canoe	"[one of]The canoe can be changed to make more water, but you don't need that.[plus][or]In fact, you need to do nothing with the canoe.[plus][or]Because if you make the canoe an [b]OCEAN[r], that's bad news.[minus][cycling]"
fish	--	canoe
oars	"[one of]Those oars provide propulsion.[plus][or]And not just through the water.[plus][or][b]SOAR[r].[minus][cycling]"	--	"[b]SOAR[r] by the oars"
carps	"[one of]You're bigger than they are, and your arms have more reach. You could probably beat them in a fight.[plus][or]You could brawl, tussle, or...[plus][or][b]SCRAP[r].[minus][cycling]"	--	"[b]SCRAP[r] (with) the carps"
pikes	"[one of]They, or the carps, can be beaten. It doesn't make any difference whom you attack.[plus][or]The pikes require a slightly odd verb. You can brawl, tussle, or...[plus][or][b]SPIKE[r] the pikes.[minus][cycling]"	--	"[b]SPIKE[r] the pikes"
snarled darnels	"[one of]The snarled darnels kind of make you mad. Like you want to lash out verbally at them.[plus][or]You don't have to tell the truth or anything. It won't hurt them. Or if it does, they're only darnels.[plus][or]You can [b]SLANDER[r] the snarled darnels.[minus][cycling]"
skis	"[one of]The skis are blocking the door.[plus][or]They can't be moved by force.[plus][or]You need to [b]KISS[r] the skis.[minus][cycling]"	--	"[b]KISS[r] the skis"
knob	"[if crate is reflexive]You need to deal with a crate first, but the knob will be easier.[else][one of]The knob won't budge. It doesn't seem to have a lock.[plus][or]You need to do something with it.[plus][or][b]BONK[r] the knob.[minus][cycling][end if]"	--	"[b]BONK[r] the knob"
crate	"[if bogus-trace is reflexive][one of]Someone has an unending supply of crates.[plus][or]You can't seem to find the time to open the door, still.[plus][or]The crate still requires you to do one more thing.[plus][or][b]REACT[r].[minus][cycling][else if crate is reflexive][one of]You can't figure where the debris is coming from.[plus][or]It's debris of a [b]CRATE[r].[plus][or]You want to [b]TRACE[r] it.[minus][cycling][else]Nothing more to do with the crates.[end if]"	--	"[b]REACT[r] to the crate"
bogus-trace	--	crate	"[b]TRACE[r] the crate"
fragments	--	crate
bogus-plains	"[one of]You can talk about how great you are, to all who would hear.[plus][or]What can you do in the lapsin['] plains?[plus][or][b]SPLAIN[r].[minus][cycling]"
waste	"[one of]The waste puzzle is optional.[plus][or][one of]The waste is hard to move. It requires effort.[plus][or]Taking the waste is out, but you can sift through it the right way.[plus][or][b]SWEAT[r].[minus][cycling][stopping]"	--	"[b]SWEAT[r] by the waste"
lance	"[lance-hints]"	--	"[b]CLEAN[r] the lance"
heaps	"[one of]The heaps are malleable, but they might be a pain to sift through.[plus][or]If you [b]SHAPE[r] the heaps, you get a Keep Yorpwald Beautiful Last Lousy Point.[minus][cycling]"	--	"[b]SHAPE[r] the heaps"
eeks	"[one of]There's a noise coming from somewhere. Maybe it's a clue where that trout went.[plus][or]They are [b]EEKS[r]. That leaves twelve choices.[plus][or]Two, if you use the settler.[plus][or][b]SEEK[r].[minus][cycling]"	--	"[b]SEEK[r] the eeks"
aunt tuna	"Aunt Tuna may have some good information[if trout is reflexive]. However, it's more important to help Tortu the trout[end if][if tea at a tee is not moot]. Her food is also edible. You'll want to enjoy her hospitality[end if][if trout is reflexed and tea at a tee is moot]. She's given you all she has, though[end if]."
dent	"[one of]The dent can be dealt with if you know how to futz with it, but it's a last lousy point.[plus][or]No, not futz, another four-letter word.[plus][or]You need to [b]TEND[r] the dent.[minus][cycling]"	--
wipes	"[if player has wipes][one of]The wipes, unsurprisingly, help make something less dirty.[plus][or]What is something that is very dirty?[plus][or][name-the-lance].[minus][cycling][else][one of]You can't just plain take the wipes. You are not fast enough.[plus][or]What's a quicker action than [b]TAKE[r], to get the wipes?[plus][or][b]SWIPE[r] the wipes.[minus][cycling][end if]"
tea at a tee	"[one of]Tea looks tasty. And easy to dispose of.[plus][or]You can [b]EAT[r] the tea.[minus][cycling]"	--	"[if trout is reflexive][b]TUTOR[r] Tortu the trout, then [end if][b]EAT[r] the [tea]"
trout	"[if trout is in Anger Range]You can't help the trout fight, but you can deal with the carps--or pikes.[else if trout is reflexive][one of]Aunt Tuna wants you to show her trout what you did.[plus][or]You can't attack anyone in someone's home.[plus][or]You can [b]TUTOR[r] the trout.[minus][cycling][else]You've helped the trout all you can.[end if]"	--	"[b]TUTOR[r] the trout"
raw red drawer	"[if wrap is off-stage]You need to please Aunt Tuna to get what's in the drawer[else]You got what's in the drawer[end if]."
cans	"[one of]You can get rid of them for a last lousy point.[plus][or]If you've been using the settler, you really should know this verb.[plus][or][b]SCAN[r] the cans.[minus][cycling]"
ruby	"[one of]The ruby isn't yours. It's been stolen.[plus][or]The ruby belongs to the haunter in [anger range].[plus][or]You don't want to be caught with the ruby, but maybe if you can frame someone or some other people...[plus][or]You can [b]BURY[r] the ruby in the Rascal Craals[if rigged digger is off-stage], though you need something to bury it with[end if].[minus][cycling]"	--	"[b]BURY[r] the ruby" [NOTE: we say haunter not sausage here because you can't see the sausage until the ruby is buried]
wrap	"[if warp-try is true][one of]You know the verb but not where to warp the wrap.[plus][or]Where could you annoy someone with the wrap? Someone with sensitive ears?[plus][or]The sandier sardine in Sclerous Closures will run if you warp the wrap near him.[minus][cycling][else][one of]So what's the verb to pop the wrap?[plus][or]Twenty-four choices. Six if you scan it. One if you cheat.[plus][or]You need to [b]WARP[r] the wrap.[plus][or]But you can't warp the wrap any old place. It might be fun and useful to annoy somefish.[plus][or]Who has sensitive hearing the wrap would annoy?[plus][or][b]WARP[r] the wrap by the sardine.[minus][cycling]"	--	"[b]WARP[r] the Paw-R-Wrap"
span pans	"[one of]The span pans are a five-part puzzle. You may guess the final step, which consists of dissolving the pans.[plus][or]You need to dispose of the knob.[plus][or]You need to get rid of the skis.[plus][or]The crate you keep getting hit with is a pain, too.[plus][or]See each sub-part for individual clues or, if you need help with the pans, see below.[plus][or]You can [b]SNAP[r].[minus][cycling]"	--	"[b]SNAP[r] at the span pans"
shut huts	--	span pans
tubs	"[one of]The tubs seem tough to crack.[plus][or]You could blast the tubs, or crush them, ...[plus][or]...or [b]BUST[r] them.[minus][cycling]"	--	"[b]BUST[r] the tubs"
prod	"[one of]The prod seems like it should be more than it is, but you can't figure how to operate it.[plus][or]Operating the prod is probably simple and dumb, but something you do by accident.[plus][or]To operate the prod, you need a simple standard action [this-game] doesn't usually let you do.[plus][or][b]DROP[r] the prod.[minus][cycling]"	--	"[b]DROP[r] the prod"
rigged digger	"[if ruby is off-stage]The rigged digger is used to hide something underground and to remove something from underground, but you're not ready to do either, yet[else if player has ruby][one of]The rigged digger can hide something underground.[plus][or]There's a good candidate for hiding in your inventory. Well, not quite hiding.[plus][or]You can do something with the ruby.[minus][cycling][else][one of]The rigged digger can still be used to excavate something.[plus][or]The digger allows access to the haunter in Anger Range, if you use the digger right. Hint the hunter hunt area for what verb to use.[minus][cycling]"
sardine	"[if Paw R Wrap is off-stage]To scare the guard away, you need an item from east of Anger Range. Go there.[else if Paw R Wrap is not moot][one of]The sandier sardine seems to have ear problems.[plus][or]Have anything that might make noise?[plus][or]The Paw-R-Wrap. It's just fancy-named bubble wrap.[plus][or][b]WARP[r] the wrap.[minus][cycling][else]You shouldn't need hints for the sardine now.[end if]"
OH NERD HERD NO	"That's just a warning you aren't welcome in the Horned Hedron."
Achers Chaser Arches	"[if Achers Chaser Arches is reflexive][one of]Why might the arches be guarded?[plus][or]There's something in them.[plus][or][b]X ARCHES[r] doesn't quite work. Something more thorough?[plus][or][b]SEARCH ARCHES[r].[minus][cycling][else]Nothing else in the arches.[end if]"	--	"[b]SEARCH[r] the arches"
HUNTER HUNT AREA	"[if hunter hunt area is prefigured][one of]You need something to [b]UNEARTH[r] the haunter with.[plus][or]Inside of the Lapsin['] Plains, you will find the tool you need to unearth the haunter.[plus][or]You'll also need a reason to have unearthed the haunter, which you can create elsewhere. You may need to hint other places or things for that.[minus][cycling][else][one of]The haunter is beneath here. You may need to recover it.[plus][or]What do you often do with the undead?[plus][or][b]ETAHN RU[r] is the haunter's name, and it is [b]NEAR HUT[r]. If you attack, you see a [b]HATE URN[r].[plus][or]You should be able to [b]UNEARTH[r] the haunter, [once-now-digger].[plus][or][where-is-digger].[minus][cycling][end if]"	--	"[b]UNEARTH[r] the haunter from the [hha]"
sausage	"[if sausage is reflexed][one of]Now you've gained its trust, you will want to show [the sausage] something.[plus][or]The [sausage] would love to know where the ruby is buried.[minus][cycling][else][one of]The [sausage] seems upset. How would you calm it down?[plus][or]You can [b]ASSUAGE[r] the sausage.[minus][cycling][end if]"	--	"[b]ASSUAGE[r] the Use-Saga Sausage"
walleyes	"[one of]The walleyes won't let you explore the Horned Hedron. You need to get rid of them.[plus][or]If you talk to the walleyes, they'll mention how you'd need to be a big scary ghost or something.[plus][or]You need a ghost to come along for the ride to scare the walleyes.[plus][or]Hide something the ghost wants in Rascal Craals.[minus][cycling]"
ol trap	"[one of]The ol['] trap must have a disarming switch somewhere.[plus][or]You need to cover the area to disable the ol['] trap, but not with spies watching you. The [sausage] can take care of them.[plus][or]Once [the sausage] has scared everyone away, what's an action to scour for a switch for the ol['] trap?[plus][or][b]PATROL[r].[minus][cycling]"	--	"[b]PATROL[r] the ol['] trap"
pol art portal	"[one of]You can just enter the portal.[plus][or]You won't know where to go through the portal without a gleaner.[plus][or]Find the two pearl pieces, by the arches and from Aunt Tuna's gift.[plus][or]The gleaner can't tell you how to use the portal [']til it's bigger.[plus][or][b]ENLARGE[r] the gleaner to make the portal work for you.[minus][cycling]"
thin hint	"[one of]The thin hint will remind you where you hid the ruby.[plus][or]The thin hint will also show someone else where you hid the ruby. So bring someone back.[plus][or]The [if sausage is off-stage]haunter, once you find it,[else][sausage][end if] will be glad to see what is under the thin hint.[minus][cycling]"
paler pearl	"[if tea at a tee is not moot][one of]So, you have one half of the pearl, but you want the other.[plus][or]The other pearl-half is in Lean Lane.[plus][or][a-t-check][plus][or][b]EAT TEA[r].[minus][cycling][else][one of]So, you have one half of the pearl, but you want the other.[plus][or]The other pearl-half is in the Achers['] Chaser Arches, in Sclerous Closures.[plus][or]How would you comb through the [arches]?[plus][or][b]SEARCH[r].[minus][cycling][end if]"
gleaner	"[if gleaner is reflexed and gleaner is not examined][b]EXAMINE[r] the general gleaner, now you've enlarged it.[else if gleaner is reflexed]You've done what you needed.[else][one of]The gleaner may help you with the last bit, but it is too small.[plus][or]What could you do to make the [b]GLEANER[r] bigger?[plus][or]The settler gives you where the vowels are.[plus][or][b]ENLARGE[r] the gleaner.[minus][cycling][end if]"	--	"[b]ENLARGE[r] the gleaner"
ant	"[one of]You can't outright attack the ant. You poke at it ineffectually. Something more brutish, but simple.[plus][or][b]TAN[r] the ant.[minus][cycling]"	--	"[b]TAN[r] the ant"
bogus-psalm	"[one of]The plasm lamps can inspire you to do something else. Something a templar might do.[plus][or]The action for a bonus point is more commonly known as a noun, but it works as a verb, too.[plus][or][b]PSALM[r].[minus][cycling]"	--	"[b]TAN[r] the natant ant"
stupid paper necklace	"The paper necklace gives a clue what to do with the yapper."
yapper	"[one of]The settler on cheat mode gives confusing readings here because [b]PAPERY[r] and [b]YAPPER[r] clash.[plus][or]So if you use the settler, you may note that five of the letters are right. But maybe you want to solve this the old-fashioned way.[plus][or]He seems to be asking for a bribe and not asking for one at the same time. He needs to be compensated before he lets you do anything.[plus][or]If you give the yapper an item, he indicates he could be bribed...if it were valuable. He likes the pearl.[plus][or]You can just [b]PREPAY[r] the yapper.[minus][cycling]"	--	"[b]PREPAY[r] the papery yapper"
templar ramplet	"[if lance is not reflexed]You can't do what you need to with the ramplet[else if plasm lamps is visited]You can't go back up the ramplet.[else][one of]You need to storm the Templar Ramplet aggressively.[plus][or]Not just walk or run, but ...[plus][or]...[b]TRAMPLE[r].[minus][cycling]"
intercom	"The intercom is controlled by the dialer."
jumble	"The jumble reorganizes when you set the dialer."
pins	"[one of]To fix the dialer, you need to straighten the pins out.[plus][or]The pins are tangled together, and they are too small to [b]SNIP[r].[plus][or][b]SPIN[r] the pins.[minus][cycling]"	--	"[b]SPIN[r] the pins"
lever	"[if lever is reflexed][one of]Aren't you happy to have found the lever?[plus][or]Don't last lousy points make you feel excited and like you want to party?[plus][or]Or [b]REVEL[r]?[minus][cycling][else][one of]Fiddling with the lever does nothing on its own, at first.[plus][or]You'll want to concentrate on the dialer, instead.[plus][or]Once you've done that, [b]PULL[r] the lever to do something else with the dialer.[minus][cycling][end if]"
bogus-derail	"[one of]The dialer is dangerous and destructive. But it's also flexible. You need it to do two things, but let's tackle the first.[plus][or]What's a destructive anagram of [b]DIALER[r]?[plus][or]You can submit an order to [b]DERAIL[r].[minus][cycling]"	--	"[b]DERAIL[r] with the dialer"
bogus-redial	"[one of]The dialer is dangerous and destructive. But it's also flexible. You've gotten it to [b]DERAIL[r], but it can do something else.[plus][or]Elvira wasn't happy about your attempts to [b]DERAIL[r], and she said you'd better not do it again. You need to buck her orders.[plus][or][or]The dialer can [b]REDIAL[r] as well.[minus][cycling]"	--	"[b]REDIAL[r] with the dialer"
dialer	"You've reached a fallthrough case I didn't expect. Sorry about that."

to say dh-true: now trolls-hinted is true;

to say casp-cap:
	say "[one of]Casper doesn't want to be disturbed while writing Capers Recaps.[plus][or]Capers Recaps looks like almost two blackboards folded together. It's tempting to do something. [plus][or][b]SCRAPE[r] the blackboard.[minus][cycling]"

to say lance-hints:
	if player does not have lance:
		say "[one of]The lance is part of an optional quest. It isn't clean enough to take.[plus][or]You need an item to make the lance less dirty.[plus][or]The wipes in Lean Lane can do that.[plus][or][if player has wipes]Now you need to apply the wipes the right way[else]You should be able to get the wipes unless you used the pills on Aunt Tuna. You need to take them quickly. [b]HINT[r] them if you need more clues[end if].[plus][or][b]CLEAN[r] the lance once you have the wipes.[minus][cycling]";
	else:
		say "[one of]The detour past the Horned Hedron entry opens up if you have the lance.[plus][or]Once you get there, you have an animal to defeat, which should not be hard.[minus][cycling]"

to say name-the-lance:
	say "[if lance is off-stage]You haven't found it yet, but you probably will when you see it[else]The lance in the Shuttle Hutlets[end if]"

to say once-now-digger: say "[if player has rigged digger]now you've got the rigged digger[else]once you have the right equipment[end if]"

to say where-is-digger:
	if digger is off-stage:
		say "What you want is inside the shut huts of Lapsin['] Plains to the north";
	else:
		say "Your digger should do the job[if ruby is moot], but it has another use elsewhere, first[end if]"

to say a-t-check:
	say "[if Lean Lane is visited]Why not be polite and accept Aunt Tuna's meal?[else]You need to follow the eeks and then accept that person's hospitality.[end if]";

book towers

table of towers hintobjs
hint-entry	advice-entry	parallel-entry	spoil-entry
Rosetta Toaster	"[one of]You can use it to gain hints, but you need to clear the serpent to take it.[plus][or]Just put the food in the toaster and then [b]XRAY[r] anyone blocking your path.[minus][cycling]" [begin towers hinting]
top opt pot	"[if succor crocus is off-stage]The blub bulb can't really be changed until the very end[else]Now that the pot has a succor crocus in it, the person you want to give the pot to is inside[end if]."
blub bulb	--	top opt pot
strudel	"[if strudel is not reflexed][one of]The strudel is, or was in a sled rut.[plus][or]Taking the strudel gets no points, but you can implicitly take, or steal, it. Even if you already have it.[plus][or]The strudel can be [b]RUSTLED[r].[plus][or]You can put it in the toaster after just taking it, too.[minus][cycling][else]The strudel is food you can put in the toaster.[end if]"
sled rut	--	strudel
Eclairs	"The clairs are food you can put in the toaster."
solve a loaves	"The solve-a-loaves are food you can put in the toaster."
start tarts	"The tarts are food you can put in the toaster."
Brownies	"The brownies are food you can put in the toaster."
Spec O Scope	"The Scope Copse gives a rough progress map."
old ice	"[if old ice is reflexed]You made the old ice coiled, already.[else][one of]The old ice is a Last Lousy Point. It's docile, which is fine, but how to make it more impressive?[plus][or]If it were more like a sculpture, maybe...[plus][or][b]COILED[r].[minus][cycling][end if]"
mended mini denim	"[one of]The mended mini denim can't quite be cut through by something like a dagger.[plus][or]You won't find anything sharp enough to cut the mended mini denim.[plus][or]You can, however, cheat to strip the mended mini denim away.[plus][or]The mended mini denim can be [b]MINED[r].[minus][cycling]"
repents serpent	"[one of]Until the serpent can be described differently, you won't move it.[plus][or]It's annoying, but if you could just make it more inert...[plus][or]From soliciting repents to [b]PRESENT[r].[minus][cycling]"
dreads adders	"[one of]You want to make the dreads adders less ferocious.[plus][or]Making them happy isn't your business, but you can still make them...[plus][or][b]SADDER[r].[minus][cycling]"
Snider Diners	"[one of]The snider diners have dry wit! They don't want to be interrupted.[plus][or]Physically assaulting the diners is out of the question, but maybe you can rain on their dinner.[plus][or]Literally. You can make the diners [b]RINSED[r].[minus][cycling]"
Tetris Sitter	"[if anodyne is touchable]St. Teri is still unwillingly under the influence of [else if itster is not moot][one of][The tetris sitter] seems absorbed in her [first custom style]IT-STER[r].[plus][or]Her happiness is a bit of a ruse. You may need to change her emotions, to help her back to being truly happy.[plus][or]She can become [b]TRISTE[r].[minus][cycling][else if player has top opt pot][one of]St. Teri may still want something, but little of what you have interests her.[plus][or]Changing the unripe ur-pine may give you something that fits nicely in the the top opt pot.[plus][or]Give the top opt pot to [the Tetris Sitter] once you have the crocus.[minus][cycling]"
itster	--	Tetris Sitter
anodyne	--	Tetris Sitter
sporties ripostes	"[one of]They are very witty, not drawn out.[plus][or]Almost like poetry.[plus][or]If they were less incisive, you might be able to ignore them.[plus][or]Make them [b]PROSIEST[r].[minus][cycling]"
denier nereid	"[one of]The denier nereid seems to get to close to you. You wish she could stay back.[plus][or]You can't pull her back, but she can be pulled back in general.[plus][or]She can be [b]REINED[r].[minus][cycling]"
bluster butlers	"[one of]The bluster butlers are a bit too noisy. Maybe you could quiet them down?[plus][or]They're good at the direct approach, but if they were indirect, maybe they could guard somewhere more valuable.[plus][or]What if you made the butlers [b]SUBTLER[r]?[minus][cycling]"
sweatier wait seer	"[one of]The wait-seer is certainly [b]SWEATIER[r] than you.[plus][or]The wait-seer also doesn't seem to be getting tired.[plus][or]So changing the wait-seer to someone who is, or gets, tired, could work.[plus][or][b]WEARIEST[r].[minus][cycling]"
ingrates	"[one of]The ingrates are the [b]ANGRIEST[r] you've ever seen.[plus][or]They're too mad to let you pass. The ingrates are not going to stop complaining, but maybe they could complain more passively.[plus][or]What if the ingrates became [b]ANGSTIER[r]?[minus][cycling]"
lois the hostile	"[lois-or-lot-hint]" [I can't link one to the other because the story will look for whichever is moot then say "oops" -- well, I could, but it'd be a lot for just one such twiddle.]
Hostile is He Lot	"[lois-or-lot-hint]"
alarming grailman	"[one of]It's [b]ALARMING[r] how above-average the grailman is, and how he won't settle for second-rate.[plus][or]How could you knock him down to average or below-average?[plus][or]Make him [b]MARGINAL[r].[minus][cycling]"
pirates	"[one of]The pirates are very sun-burnt, and they like it that way.[plus][or]The pirates make fun of your own pale skin.[plus][or]Why not make the pirates [b]PASTIER[r]?[minus][cycling]"
agnostic	"[if Obscurest Subsector is unvisited][agnostic]'s not important right now.[else if Dr Yow is in prison ropins][agnostic] makes stuff. You'll want to hook [him-her] up with Dr. Yow--release Dr. Yow.[else if agnostic is lonely][one of][agnostic-first] wants someone who can help [him-her] make stuff.[plus][or]Who might do that?[plus][or]Dr. Yow. ASK AGNOSTIC ABOUT DOCTOR.[minus][cycling][else if agnostic is reflexive and agnostic is in Obscurest Subsector][one of][agnostic-first] is [b]TENTATIVE[r] around Dr. Yow and can't figure [his-her] lectures.[plus][or]You need to make [him-her] [b]ATTENTIVE[r].[minus][cycling][else if agnostic does not have gizmo]You need to give [agnostic-first] something to build with. A tool.[else][agnostic-first]'s bot boat is more important.[end if]"
Reeds Ale	"[one of]Poor [el-la-full]! Having to dress like that. [he-she-c] either wants to be free or stop feeling silly.[plus][or]The Reed's Ale is a bit of a clue.[plus][or]There are two ways to help [el-la-full]. Each flips two letters in the other.[plus][or][b]RESEALED[r] or [b]RELEASED[r] both get rid of [el-la-full].[minus][cycling]"
Lars Eede	--	Reeds Ale
Elsa Erde	--	Reeds Ale
ego drains	"[one of]They're organised, but perhaps if they were hyperbole, they wouldn't be as effective.[plus][or]How could you make them over-the-top?[plus][or]Say, [b]GRANDIOSE[r]?[minus][cycling]"
mardier admirer	"[one of]The mardier admirer needs someone to emote to, hopefully more constructively than with you. To be ... engaged with.[plus][or]Why stop at just engaged?[plus][or][b]MARRIED[r].[minus][cycling]"
natives site van	"[one of]The natives babble about how they can't be suckered, and so forth, and yet they're almost too good for this place.[plus][or]You can do two things to vanquish the natives['] site van.[plus][or]The natives in the site van can become [b]VAINEST[r], or [b]NAIVEST[r].[minus][cycling]"
yurts	"[one of]The yurts look out of place, made of weird metals.[plus][or]You can corrupt them by making them...[plus][or][b]RUSTY[r].[minus][cycling]"
promise imposer	"[one of]The promise imposer needs taking down a notch from feeling they're the best.[plus][or]You can't take them down all the way, but maybe half.[plus][or]Make them [b]SEMIPRO[r].[minus][cycling]"
Nerd Aid	"The Nerd-Aid gives you a better idea of how to get out of the arid den."
weeds	"[one of]The weeds might be less effective if tied together.[plus][or]Or, more accurately, [b]SEWED[r].[minus][cycling]"
realist tailers	"[one of]The realist tailers do like to snipe. They are very high-energy. But you can make them higher-energy.[plus][or]Perhaps you could make the realist tailers be so cynical, it's not even worth showing how cynical they are.[plus][or]Make them [b]SALTIER[r].[minus][cycling]"
atheists	"[one of]The atheists are willing to explain everything very slowly to you. That's not good. You'd like them to be frustrated with you, to move on.[plus][or]How can you make them super-impatient?[plus][or]Make them [b]HASTIEST[r].[minus][cycling]"
Reading a Dinger	"[one of]It's a very spiffy book, that [i]Reading a Dinger[r].[plus][or]Maybe it would be less attractive if it got scuffed.[plus][or]If the pages somehow got [b]GRAINED[r].[minus][cycling]"
fluster self rut	"[one of]The fluster-self rut certainly gets you agitated![plus][or]Calm is called for. Maybe you can calm it and, then, yourself.[plus][or]Make the fluster-self rut [b]RESTFUL[r].[minus][cycling]"
Resident Trendies	"[one of]The resident trendies sure are with-it![plus][or]Maybe if you made the trendies less with-it, they'd be worse at guarding.[plus][or]To make them uncool...or uncoolest...[plus][or]make them [b]NERDIEST[r].[minus][cycling]"
bonker	"[one of]The bonker is working just great. How to gum it up?[plus][or]Busted...or...[plus][or][b]BROKEN[r].[minus][cycling]"
stinger	"[one of]The stinger doesn't need to be so active. How could it become calmer?[plus][or][plus][or][b]BROKEN[r].[minus][cycling]"
keycar	"[one of]The keycar looks in tip-top shape, but maybe you can change that.[plus][or]In particular, make it sound worse the right way, so it clearly needs repairs.[plus][or]Make it [b]CREAKY[r].[minus][cycling]"
bogus-rousted	"[one of]The Dourest Detours have left you out of energy, and you need a boost so it returns.[plus][or]You need to get [b]ROUSTED[r].[minus][cycling]"
seismal samiels	"[one of]Make the seismal samiels totally disjointed.[plus][or]The samiels can become [b]AIMLESS[r].[minus][cycling]"
bogus-dandier	"[one of]The drained dreadin['] and the arid den leave you feeling down. There must be a way to feel better. That will help you think positively and not feel stuck.[plus][or]Feel cheerier, happier, heartier...[plus][or][b]DANDIER[r].[minus][cycling]"
drained dreadin	--	bogus-dandier
repeat button	"[b]REPEAT[r] plays back what you recorded with the retape button."
retape button	"[b]RETAPE[r] gives something for the repeat button to replay."
Dr Yow	"[unless Dr Yow has been wordy][one of]Dr. Yow is silent, but you can change that.[plus][or]Take a look at [his-her] name.[plus][or]You can make [him-her] [b]WORDY[r].[plus][or]If you have the raves saver, you can then [b]PUSH RETAPE[r].[minus][cycling][else if Dr Yow is in prison ropins]You need to bring a friend along to rescue Dr. Yow.[else if Dr Yow has not been rowdy][one of]Dr. Yow can be something besides wordy, too.[plus][or]You can make Dr. Yow be exciting.[plus][or]Dr. Yow can be [b]ROWDY[r].[minus][cycling][else]Dr. Yow will stay around to impart [his-her] knowledge for a bit.[end if]"
ragged dagger	"[one of]The dagger isn't as useful as it could be.[plus][or]Have you found a machine that might sharpen the dagger?[plus][or][if Outer Route is unvisited]There's a room west of the Scope Copse, past the pirates.[else]The Outer Route.[end if][plus][or]The [deviser] in the Outer Route can repair the dagger.[minus][cycling]"
raves saver	"[one of]The raves saver is, well, a tape recorder.[plus][or][b]REPEAT[r] is the [b]PLAY[r] button.[plus][or][b]RETAPE[r] is the [b]RECORD[r] button.[plus][or]Combining [b]RETAPE[r] and [b]REPEAT[r] can bring a sound from one end of this region's map to another.[minus][cycling]"
gizmo	"[if agnostic has gizmo][agnostic-first] has the gizmo. [he-she-c] can use it better than you.[else][one of]You have this gizmo. Have you met anyone who could use it?[plus][or][agnostic] [hereish of Actionless Coastlines].[plus][or][ag-yow-lect], but now [he-she] needs a tool.[plus][or]Give [agnostic-first] the gizmo [n-o] [he-she]'s inspired by a science lecture.[minus][cycling][end if]"
ID Tag	"[if Obscurest Subsector is unvisited]Hm, you need to find Dr. Yow, the name on the tag. [he-she-c]'s in the very east.[else]Hm, the ID tag says Dr. Yow. This is [his-her] duck.[end if]"
fissure	"[one of]The fissure can, surprisingly, become animated.[plus][or]Make the fissure [b]FUSSIER[r].[plus][or]But you need something that will fuss back at the fissure. Like a free animal or something.[minus][cycling]"
prison ropins	"The prison ropins are held together by the luck node, so you may want to see about that, instead."
luck node	"[one of]The luck node binds the prison ropins, and you can't really open them with the luck node attacked.[plus][or]You could say the prison ropins are stuck in place.[plus][or]Or you could say that Dr. Yow is fenced in. No, not quite fenced.[plus][or]Dr. Yow is locked in. Dr. Yow needs to be...[plus][or][b]UNLOCKED[r]. But you can't just say it. You need some preparation.[minus][cycling]"
atblock	"[one of][agnostic-first] can do a bit better, but this LLP is not critical for the game.[plus][or][agnostic-first] is tentative. Not able to focus.[plus][or]Or pay full attention.[plus][or]Make [agnostic-first] [b]ATTENTIVE[r].[minus][cycling]"
lone duck	"[if lone duck is in shaven havens][one of]You need to bring it back to its owner.[plus][or]In the Obscurest Subsector.[plus][or]It won't follow you, though.[plus][or]If you have the Raves Saver, you can record Dr. Yow while [he-she]'s wordy.[plus][or]This will make the duck follow back to Dr. Yow.[minus][cycling][else][one of]The duck can open the lock.[plus][or]How? It is a lone duck.[plus][or]The lone duck can make the gaol [b]UNLOCKED[r].[minus][cycling][end if]"
diverse deviser	"[if deviser is reflexive][one of]The diverse deviser isn't quite up to where it should be. It needs a bump up from you.[plus][or]Make it [b]REVISED[r].[minus][cycling][else][one of]The rapier repair machine looks like it could use something to work on.[plus][or]Have you seen anything that looks like a rapier and needs repair?[plus][or][dagger-details].[plus][or]Put the dagger in the machine.[plus][or]The gizmo may help [ag-if-seen] with a construction project.[minus][cycling][end if]"
Thearchy Hatchery	"The Thearchy Hatchery is just sort of there, for a clue. You don't need to do anything with it."
Maturation Natatorium	"The maturation natatorium is just sort of there, for a clue. You don't need to do anything with it."
bot boat	"Two parts of a bot boat are broken. The blaster and turbos."
blaster	"[one of]The blaster isn't quite as solid as it could be.[plus][or]Maybe you could make the blaster [b]STABLER[r]?[minus][cycling]"
turbos	"[one of]The turbos aren't quite as solid as they could be.[plus][or]Maybe you could make the turbos [b]ROBUST[r]?[minus][cycling]"
weirder red wire	"[one of]The weirder red wire is organized wrong. Perhaps it can be reorganized, redone, rejigged, redesigned...[plus][or][b]REWIRED[r].[minus][cycling]"
earnest eastern neaters	"[one of]The [neaters] are too far away How could they become closer?[plus][or]Maybe they could be closEST?[plus][or]The [neaters] can become [b]NEAREST[r].[minus][cycling]"
Rodney	"[one of]You need to wipe out a few other guys, first, but when you do Rodney will fall.[plus][or]Get him out of here, or make him sound less authoritative.[plus][or][b]YONDER[r], or the alternate solution...[plus][or][b]DRONEY[r], not really a recognized word, but why not.[minus][cycling]"
Andres	"[one of]Andres seems untied by anything mental or physical.[plus][or][b]SNARED[r].[minus][cycling]"
Andrew	"[one of]Andrew probably is clueless of the risks of his venture.[plus][or]He should be [b]WARNED[r].[minus][cycling]"
Archie	"[one of]Archie appears quite flexible, contorting himself without any pain.[plus][or]Not if he gets [b]ACHIER[r].[minus][cycling]"
Barney	"[one of]Barney seems far too close.[plus][or]Move Barney [b]NEARBY[r].[minus][cycling]"
Blake	"[one of]Blake looks full of purpose and resolve.[plus][or]Not if he gets [b]BLEAK[r].[minus][cycling]"
Bredo	"[one of]Bredo seems very interested in this whole stick-up.[plus][or]Unless he gets [b]BORED[r].[minus][cycling]"
Cedrick	"[one of]Cedrick looks like he's never had any sort of injury.[plus][or]Make him [b]CRICKED[r].[minus][cycling]"
Daryl	"[one of]Daryl's very fit, eh? Not an ounce of fat?[plus][or]Make him [b]LARDY[r].[minus][cycling]"
Demitri	"[one of]Demitri seems fearless.[plus][or]Make him [b]TIMIDER[r].[minus][cycling]"
Dewey	"[one of]Dewey is a meaty, substantial fellow.[plus][or][']Til Dewey gets [b]WEEDY[r].[minus][cycling]"
Edwin	"[one of]Edwin's crest is a bottle of wine inside one of those slashed red circles. No drinking![plus][or]If he were [b]WINED[r].[minus][cycling]"
Eldon	"[one of]Eldon radiates youth![plus][or]Not if he's [b]OLDEN[r].[minus][cycling]"
Ernest	"[one of]Ernest is one of the more relaxed people you've seen.[plus][or]Make him tenser.[minus][cycling]"
Geno	"[one of]Geno's just sort of here, but he doesn't have to be.[plus][or]Could be [b]GONE[r].[minus][cycling]"
Goldy	"[one of]Goldy seems ruthless and mercenary.[plus][or]Make Goldy more [b]GODLY[r].[minus][cycling]"
Leander	"[one of]Leander looks too dumb to do anything but guard you.[plus][or]Not if he's [b]LEARNED[r].[minus][cycling]"
Marcel	"[one of]Marcel seems agitated, looking for a fight.[plus][or]Make Marcel [b]CALMER[r].[minus][cycling]"
Marlon	"[one of]Marlon seems extraordinary and above-average. Cut him down to size.[plus][or]Make him [b]NORMAL[r].[minus][cycling]"
Preston	"[one of]Preston seems the best defended and protected.[plus][or]Make him the [b]PRONEST[r].[minus][cycling]"
Reggie	"[one of]You can't be sure, but the obnoxious smell of aftershave seems to come from Reggie.[plus][or]It'd be even more obnoxious if he were [b]EGGIER[r].[minus][cycling]"
Royce	"[one of]Royce seems unabashed and not shy.[plus][or]Make Royce [b]COYER[r].[minus][cycling]"
Shane	"[one of]Shane's skin has a healthy sun-kissed glow.[plus][or]Not if he's [b]ASHEN[r].[minus][cycling]"
Terrance	"[one of]Terrance seems stuck to his task.[plus][or]What if you could make him more [b]RECREANT[r]?[minus][cycling]"
Tyson	"[one of]Tyson seems quite cheery about this whole adventure, like it's fun. Make him frowny.[plus][or]Or [b]STONY[r].[minus][cycling]"
Wade	"[one of]Wade seems very confident, unintimidated.[plus][or]He can be [b]AWED[r].[minus][cycling]"
recital article	"[one of]The recital article is sturdy, but you can make it crumble.[plus][or]Because the towers area focuses on adjectives, comparative adjectives play a big part, including ones ending in -ier.[plus][or]Make the recital article [b]TALCIER[r].[minus][cycling]"
unripe ur pine	"[one of]The unripe ur-pine is too big for you.[plus][or]Any way to make it smaller?[plus][or]Maybe [b]PUNIER[r]?[minus][cycling]"
nastier stainer retinas	"[one of]The nastier stainer retinas seem very focused on their job.[plus][or]If you could make the retinas jumpier, they might leave. No, not quite jumpier.[plus][or]Make the retinas [b]ANTSIER[r].[minus][cycling]"
succor crocus	--	top opt pot
Ornate Atoner Renato	"[if Mislit Limits is unvisited]You don't need to worry about Renato's gift until the very end[else if crocus is off-stage]You may find something behind the unripe ur-pine to put in the top opt pot[else if player has crocus]The crocus can be given to someone else[else]You've taken care of Ornate Atoner Renato's gift[end if]."
accurst leap	"[fin-pal-clue]."
clear catsup	"[fin-pal-clue]."
pest accrual	"[fin-pal-clue]."
c-p	"[fin-pal-clue]."
pearl cactus	"[fin-pal-clue]."
accu plaster	"[fin-pal-clue]."
capsule cart	"[fin-pal-clue]."
talc spa cure	"[fin-pal-clue]."
Last Acre Cup	"[fin-pal-clue]."
Curst Palace	"[one of]The Curst Palace is eleven letters, and the settler doesn't help much.[plus][or]St. Teri might, [sitter-ok].[plus][or]You seem to need a superlative to restore the palace.[plus][or]Make the palace wonderful again.[plus][or]Or, [b]SPECTACULAR[r].[minus][cycling]"

to say lois-or-lot-hint: say "[one of]Boy, for being potentially religious, [the the-hostile] sure is [b]HOSTILE[r]. But they shouldn't be. God is love in most religions.[plus][or]Maybe helping [relig-mf] could help you.[plus][or]Make [relig-mf] the [b]HOLIEST[r] you've seen.[minus][cycling]"

to say ag-yow-lect:
	say "[if yow is moot]You already helped [him-her] appreciate Dr. Yow's lecture[else][he-she-c] may need a lecture first[end if]"

to say n-o:
	say "[if atblock is reflexed]now[else]once[end if]";

to say dagger-details: say "[if player has ragged dagger]That ragged dagger you got from [gradient][else]Something is still hidden in [gradient][end if]"

to say ag-if-seen: say "[if agnostic is off-stage]someone somewhere[else]the agnostic[end if]"

to say fin-pal-clue: say "You may get a hint what the Curst Palace can become from [the noun]."

to say sitter-ok: say "[if anodyne is moot]though her advice seems cryptic[else]but you'd have to get through to her first[end if]"

table of otters hintobjs
hint-entry	advice-entry	parallel-entry	spoil-entry
bleary barley	"[one of]Hm, to get rid of the bleary barley, you can only use weak words.[plus][or]What are some of the weakest words in the English language?[plus][or]What also hasn't been covered in other areas?[plus][or]Adverbs.[plus][or]This gets you the last two letters, probably. LY.[plus][or]The barley is [b]BARELY[r] there.[minus][cycling]"	--	"the barley can appear [b]BARELY[r]"
cinders	"[one of]The cinders can be used for two things.[plus][or]You can take them and use them to hint through one thing with one passive verb.[plus][or]You can [b]DISCERN[r] (no nouns,) but that won't get you full points.[plus][or]You can get rid of the cinders--not by dropping them.[plus][or][b]RESCIND[r].[minus][cycling]"
asyllabic lilac bays	"[one of]The lilac bays need a word that will nurture them. It's useless in regular conversation, but for whatever reason, the lilac bays like it.[plus][or][b]BASICALLY[r].[minus][cycling]"
Ed Riley	"[one of]A steward won't let you go eastward--but he is too emphatically denying he is a [b]YIELDER[r].[plus][or]The settler logically knocks this one out, but also consider his booming voice. You want the opposite of that.[plus][or][b]REEDILY[r].[minus][cycling]"	--	"Ed Riley can speak [b]REEDILY[r]"
deli rye	"Ed Riley won't share, but the rye can share a hint with you if you scan it."
Gretta	"Gretta has an important item for you once you [if parleys splayer players are not moot]dispose of the [pla-ma]s[else]finish chatting[end if]."
parleys splayer players	"[if players are reflexed]You need to find ways to deal with the [pla-ma]s['] arguments, since you made them argue more [b]SPARELY[r][else][one of]The [pla-ma]s['] parleys are all over the place. Perhaps you can make them less ubiquitous.[plus][or]They cound argue less frequently, or less rapidly, or more...[plus][or]...[b]SPARELY[r].[minus][cycling]"	--	"the [pla-ma]s can talk [b]SPARELY[r]"
yer all a yell'r	"[one of]The simplistic song's solution should not be too bad.[plus][or]Especially since you can guess what the last two letters can be.[plus][or]An expression of surprise and disgust that doubles as an adverb works quite well here. Do these people actually like this sort of music? Well, instead of actually...[plus][or][b]REALLY[r].[minus][cycling]"
Cut Ya All Cult Laya	"[one of]A meaningless word will cut [the laya] down. It's one people use to win an argument.[plus][or][b]ACTUALLY[r].[minus][cycling]"
sly imp	"[one of][if one-imp-down]You need to take the imp down another peg[else]The imp certainly does things three different ways[end if].[plus][or]You may need [if one-imp-down]yet [end if]another adverb.[plus][or][if one-imp-down]Take it out for good by making it[else]It can be made to[end if] move less gracefully and more [rand-otters-east-ly].[minus][cycling]"	--	"[rand-otters-east-ly]"
whiners	"[one of][if one-whine-down]They've lost a bit of steam, but they need to lose a bit more[else]The whiners have a lot of energy and exercise it many different ways[end if].[plus][or]You can soften them up a bit[if one-whine-down] more[end if].[plus][or]They'll [if one-whine-down]give up on[else]be less interested in[end if] annoying you if they start acting more [rand-otters-east-ly].[minus][cycling]"	--	"[rand-otters-east-ly]"
Mr Lee	"[if ghoul hat is not moot]Try to help Mr. Lee with that ghoul hat. Or ask hints about the hat.[else if gore ogre is in Bran Barn]Try to get rid of the Gore Ogre.[else]You've helped Mr. Lee all you can."
ghoul hat	"[one of]Mr. Lee's '[b]HOLA, THUG[r]' greeting is not very nice. He sees red and doesn't trust you.[plus][or]Mr. Lee's upset with you. But one word, useless on its own, can turn it around.[plus][or]The first one had better be a good one.[plus][or]No L-Y, so no adverb.[plus][or][b]ALTHOUGH[r].[minus][cycling]"	--	"you can say [b]ALTHOUGH[r]" [bold-ok]
Gore Ogre	"[if ghoul hat is not moot]Deal with the ghoul hat first.[else][one of]The gore ogre doesn't seem violent, but maybe there's a conjunction that works on it.[plus][or]Maybe something that can outsmart the Gore Ogre and claim you're right.[plus][or][b]ERGO[r].[minus][cycling]"	--	"you can say [b]ERGO[r]"
Vow Here	"[one of]You don't need to deal with the vow here, but since it appears in an area where you've used conjunctions, you need one more.[plus][or]Listening to the vow here may help a bit.[plus][or]You can say [b]HOWEVER[r].[minus][cycling]"	--	"you can say [b]HOWEVER[r]"
atmo moat	"[one of]The moat seems to get in your way, but you sense it could be compacted.[plus][or]It's also an atmo-moat, though you see less red when you think of it that way.[plus][or]You can shrink the moat to an [b]ATOM[r], [if power-back is false]but you need to have your powers back, first[else]which is possible with your powers back[end if].[minus][cycling]"	--	"you can make an [b]ATOM[r]"
le mer	--	sea cube
sea cube	"[one of]The sea cube in the Loop Pool can be talked to.[plus][or]The sea gets bored if you talk to it. First words count. But they need to be useless on their own.[plus][or]The [b]SEA CUBE[r] draws you to it.[plus][or][b]BECAUSE[r].[minus][cycling]"	--	"you can say [b]BECAUSE[r]"
eels	"[one of]The eels need convincing, too. What will happen, otherwise?[plus][or]Again, first words count. But they need to be useless on their own.[plus][or]Tell them [b]ELSE[r].[plus][or][b]BECAUSE[r].[minus][cycling]"	--	"you can say [b]ELSE[r]"
allot atoll	"The allot atoll [if eels are reflexed]was just there to get you your reward[else]in is not helpful on its own, but you'll get there if you help the eels[end if]. You don't need to do anything to it."
Sullenness Us	"[one of]The sullenness needs something to call exception to its gloom.[plus][or]Everything is futile. There's no way out except...[plus][or][b]UNLESS[r].[minus][cycling]"
motleyer	"[one of]The [imp]'s motleyness gets in your face, sort of.[plus][or]If you could push the motleyness back, that would work.[plus][or]The [imp] can be made to move [b]REMOTELY[r].[minus][cycling]"
butlery	"[one of]The [imp]'s butlery air is unflappable in its present form.[plus][or]You could make the imp a bit more direct.[plus][or]The [imp] can be made to act [b]BRUTELY[r].[minus][cycling]"
legendary	"[one of]The [imp] seems too legendary. It's good at what it does, unflappable.[plus][or]Perhaps you could make the imp upset with its work.[plus][or]The [imp] can be made to behave [b]ENRAGEDLY[r].[minus][cycling]"
callosity	"[one of]The callosity can become less oppressive if it is less noisy.[plus][or]A synonym for quiet can be converted to an adverb, but you need -ally, not -ly.[plus][or][b]STOICALLY[r].[minus][cycling]"
tallyhoing	"[one of]Tallyhoing shows enthusiasm, so maybe you can reduce enthusiasm.[plus][or]Maybe you could even get the whiners to dislike what they are doing.[plus][or]Have them talk [b]LOATHINGLY[r].[minus][cycling]"
jollity	"[one of]The jollity actually requires minimal switching. It is uninterrupted, smooth, consistent.[plus][or]You need an adjective to break up the smoothness.[plus][or][b]JOLTILY[r].[minus][cycling]"
owls	"[one of]You only have one move to tackle the owls.[plus][or]They are too fast now.[plus][or]Make them [b]SLOW[r]. This hints what else to do here.[minus][cycling]"	--	"you can make the owls [b]SLOW[r]"
satyr	"[one of]The satyr seems set on blood and guts, fighting for the sake of it.[plus][or]Make him less violent?[plus][or]A bit [b]ARTSY[r]?[minus][cycling]"	--	"you can make the satyr [b]ARTSY[r]"
badger	"[one of]The badger is embarrassed to be naked.[plus][or]How could it be clothed?[plus][or]Or [b]GARBED[r]?[minus][cycling]"	--	"you can make the badger [b]GARBED[r]"
leopard	"[one of]The leopard is orangish and jumpsuited, with its paws bound together by some invisible handcuffs.[plus][or]Like the leopard's in jail. Well, it sort of is.[plus][or]But the leopard's been well behaved. Can you get them out early?[plus][or]Yup. If they're [b]PAROLED[r].[minus][cycling]"	--	"you can make the leopard [b]PAROLED[r]"
ocelots	"[one of]Those clip on shades aren't very suave on the ocelots.[plus][or]You're not going to find any shades for the ocelots.[plus][or]But you can make the ocelots cooler.[plus][or]Or, better, make the ocelots the [b]COOLEST[r].[minus][cycling]"	--	"you can make the ocelots [b]COOLEST[r]"
raptor	"[one of]You need to be quick here. The raptor can be changed to something much less vicious.[plus][or]The raptor has rather odd bright coloring, doesn't it? Like a tropical bird?[plus][or]Make the raptor a [b]PARROT[r].[minus][cycling]"	--	"you can make the raptor a [b]PARROT[r]"
nails	"[one of]The nails are arranged in a circular pattern, spiraling out.[plus][or]What's an animal whose shell is like that?[plus][or][b]A SNAIL[r].[minus][cycling]"	--	"you can make a [b]SNAIL[r]"
pines	"[one of]The pines are shaped like a long bird's bill or something.[plus][or]If you listen, you hear bickering.[plus][or][b]SNIPE[r].[minus][cycling]"	--	"you can make a [b]SNIPE[r]"
corona	"[one of]The corona is black and whitish, easy to hide in the dark.[plus][or][b]RACOON[r].[minus][cycling]"	--	"you can make a [b]RACOON[r]"
thrones	"[one of]Sit on the thrones and they'll sting you.[plus][or]What animals sting?[plus][or][b]HORNETS[r].[minus][cycling]"	--	"you can make [b]HORNETS[r]"
aside-llp	"[one of][e-n-m] are ideas aides, and they are in your way. You can disturb them temporarily for a bonus point.[plus][or]You can't work on [e-n-m]'s names but on their title, ideas aides.[plus][or]You can move them [b]ASIDE[r]. It doesn't work, but you get a bonus point and another puzzle.[minus][cycling]"
holy nest	"[one of]The holy nest isn't critical, but two of the letters in it look familiar.[plus][or][e-n-m] aren't very moral, so maybe you can poke them about that for a bit.[plus][or][b]HONESTLY[r].[minus][cycling]"
Elmer	--	Merle
Merle	"[if parrot is in Reclusion Inclosure]The parrot can help you deal with Elmer and Merle[else]You can't fully deal with [e-n-m] until you have a potential ally, [e-m-bonus][end if]."
snail	"The snail will help you when the time comes."
snipe	"The snipe will help you when the time comes."
hornets	"It will help you when the time comes."
racoon	"It will help you when the time comes."
parrot	"[if reclusion inclosure is not visited]The parrot will follow you around, though it ultimately can't help you in its current form.[else][one of]The parrot is scared of [e-n-m], as they're a lot bigger.[plus][or]Maybe if the parrot got bigger. Wait, it was![plus][or]You can change it back to a [b]RAPTOR[r] to help you get past another fearsome beast.[minus][cycling][end if]"	--	"you can re-make a [b]RAPTOR[r]"
sober robes	"[e-n-m] can't be naked, and I felt like trawling for a cheap anagram. Win-win! (Oh. The robes aren't important to the game.)"
medals	"[if medals-shiny < 2][medal-help].[else][one of]The medals are thanks for your smarts and quick thinking.[plus][or]The medals are more powerful together than apart.[plus][or][b]IQ[r] and [b]LUCKY[r] mean something.[plus][or]You can use them to go [b]QUICKLY[r], but the question is, where?[plus][or][medals-do].[minus][cycling][end if]"	--	"the medals [if nounsolve < 3 or adjsolve < 3][need-refurb][else]can make you go [b]QUICKLY[r][but-in-inclosure][end if]"
jumpsuit	--	leopard
SlopInc	"They aren't the hippest, are they? Change the ocelots to make them cooler."
Look Kool	"You can't do much but admire them."
Edictal Citadel	"The Edictal Citadel is where Elvira's hiding out. You need to get [if Rancho Archon Anchor is visited]in[else]back[end if] there and be prepared."
weltish whistle	"[if whistle is reflexed][b]PLAY[r] the whistle by Elvira to win.[else][one of]The whistle can summon animals when you need to, but you haven't had the practice yet.[plus][or]That'll be a big fight, though, so you need to prepare earlier.[plus][or]Examining the whistle gives a clue--who made it, etc. So does playing it, as if someone yelped.[plus][or]You need to play it [b]DEEPLY[r].[minus][cycling][end if]"	--	"you can play the whistle [b]DEEPLY[r]"
hydra	"[if parrot is off-stage]You'd need to be pretty big to defeat the hydra. Or have a pretty big ally. But you haven't found one, yet.[else][one of]If only you had a bigger animal as an ally, to beat the hydra.[plus][or]One that almost attacked you.[plus][or]Remember what the parrot was?[plus][or]The parrot was a [b]RAPTOR[r].[plus][or]Don't summon the raptor before the Reclusion Inclosure.[minus][cycling][end if]"
Elvira	"[if current quip is final-quip]Just [play-whistle] to defeat her.[else if nounsolve is 0 and adjsolve is 0]You'll need animal allies to face Elvira, the charismatic conversationalist.[else if medals-shiny < 2]You'll need more animal allies to face Elvira, the charismatic conversationalist.[else][one of]You have enough animals to overwhelm--and ignore the charms of--Elvira, the charismatic conversationalist.[plus][or]First, you need to [b]BLOW THE WHISTLE[r] to summon them.[plus][or]You have one more thing that can help.[plus][or]Remember how you helped Gretta?[plus][or]The medals can make you--and your allies--go [b]QUICKLY[r].[minus][cycling][end if]"	--	"you can just [play-whistle]"

to say rand-otters-east-ly:
	let mysc be entry 1 of shrine-imp-items;
	if player is in Clarthead Cathedral:
		now mysc is entry 1 of cathedral-items;
	repeat through table of otters anagrams:
		if mysc is the-from entry:
			say "[right-word entry in upper case]";
			continue the action;
	say "BUG--[if player is in Clarthead Cathedral]loathingly or tersely[else]angrily or brutely[end if]";

to say e-m-bonus:
	if holy nest is off-stage:
		say "but you can get a couple bonus points for bugging them";
	else if holy nest is moot:
		say "and you got the bonus points for annoying them";
	else:
		say "though you can get another bonus point for tweaking them"

to say medal-help:
	say "The medals look less than perfect. ";
	if nounsolve is 0 and adjsolve is 0:
		say "Maybe you can find someone, or something, to help. You should [if player is in Lamer Realm or player is in Perverse Preserve]see what you can do here[else if player is in Shiner Shrine or player is in Clarthead Cathedral]go north or south[else]explore north or south of Burnt Brunt[end if]";
	else if nounsolve >= 3:
		say "You've done good work in the preserve[if nounsolve is 3](helping the [random flippable animal in Lamer Realm] is optional now,)[else],[end if] but maybe you can go [if Lamer Realm is unvisited]north[else]to the Lamer Realm[end if] to do more";
	else if adjsolve >= 3:
		say "You've done good work in the Lamer Realm, but maybe you can go [if Lamer Realm is unvisited]north[else]to the preserve[end if] to do more";
	else if nounsolve is 0 or adjsolve is 0:
		say "You've done something in the [if nounsolve is 0]Lamer Realm[else]preserve[end if], but not enough. And then there's [if nounsolve is 0]south[else]north[end if] of Burnt Brunt, too";
	else:
		say "You've done work in the Lamer Realm and preserve, but not enough"

to say medals-do:
	say "[if Reclusion Inclosure is unvisited]The medals are only fully useful west of the Disowned Downside[else if merle is not moot]You can't really use the medals until [e-n-m] are gone[else]The medals let you go [b]QUICKLY[r] before going west of the Reclusion Inclosure, which will help you deal with Elvira's initial attack[end if]"

to say need-refurb:
	say "need refurbishing. Maybe in the ";
	if nounsolve >= 3:
		say "[if Lamer Realm is visited]Lamer Realm[else]area north of Burnt Brunt[end if]";
	else if adjsolve >= 3:
		say "[if Perverse Preserve is visited]Perverse Preserve[else]area south of Burnt Brunt[end if]";
	else if Lamer Realm is unvisited and preserve is visited:
		say "Preserve or north of Burnt Brunt";
	else if Perverse Preserve is unvisited and Lamer Realm is visited:
		say "Lamer Realm or south of Burnt Brunt";
	else:
		say "areas north and south of Burnt Brunt";

to say but-in-inclosure:
	if player is not in Reclusion Inclosure:
		say ", but maybe not here";

to say play-whistle: say "[b]PLAY THE WHISTLE[r][if qbc_litany is table of elvira comments] after chatting (pick any options)[end if]"

table of others hintobjs
hint-entry	advice-entry	parallel-entry	spoil-entry
Curtis	"[if moss cap is off-stage][one of]Curtis will help you if you get him enough fruits. Actually, just four.[plus][or]Look around a bit and look at the scenery. A few things have just a few letters. The rest are an exercise.[plus][or]He is good at delegating but not conversation.[minus][cycling][else if player has moss cap]You won't get more than the moss cap from him. Now, what to do with it?[else]Curtis [up-to-l3].[end if]"
greenish sheering	"It's not passable [if player has moss cap]until you change the moss cap[else if player has compass]except to the north[else]without an item Curtis gives you once you have four fruits[end if]."
harmonicas	"[one of]If you try to play them, your playing is the pits, and the game stems you.[plus][or]What's a fruit that has pits and a stem?[plus][or]A cherry, but this is a much brighter red than usual.[plus][or][b]MARASCHINO[r].[minus][cycling]"
slime	"[one of]Hmm, the slime is green and knobbly and smells a bit like dishwashing detergent.[plus][or]What can green dishwashing detergent smell like?[plus][or][b]LIMES[r].[minus][cycling]"
spear	"[one of]The spear is particularly out of place in Rustic Citrus.[plus][or]The settler can clue the vowels for the spear.[plus][or]The spear's an odd light greenish. Hmm.[plus][or]The spear becomes [b]PEARS[r].[minus][cycling]."
pagers	"[one of]The pagers should be something more agrarian.[plus][or]They come in different colors: red, green and black, which looks more purple, really.[plus][or]The comment on seediness is a hint, too.[plus][or]They keep you on the communications vine.[plus][or][b]GRAPES[r].[minus][cycling]"
moss cap	"[one of]That moss cap is useless as-is. Curtis claimed it helped you tell directions, but it doesn't.[plus][or]Anything similarly-named that does?[plus][or]Perhaps a rose would make you feel less sore.[plus][or]You can make a [b]COMPASS[r].[minus][cycling]"
compass	"You don't need to do anything to get the compass to work for you[if swell wells is unvisited]. It lets you go north and leave Rustic Citrus[end if]."
ruts circuits	"Once you examine the ruts circuits, tougher-to-flip items will appear. The circuits are not useful on their own."
lumps	"[one of]Hmm, the lumps are purplish, maybe even a bit soft.[plus][or]You're trying to retrieve fruit, so that should be a clue.[plus][or]The settler will tell you where to place a vowel.[plus][or][b]PLUMS[r].[minus][cycling]"
sated stead	"[one of]The sated stead blends in with the brownish dirt. What is a brown fruit?[plus][or][b]DATES[r].[minus][cycling]"
mad train	"[one of]This is an odd one, but the mad train can become a fruit. The train is pod-like. It seems to be from some place far away.[plus][or]The settler knocks out the vowels.[plus][or]Dr. Nimata tells you the other thing.[plus][or][b]TAMARIND[r].[minus][cycling]"
briar screen	"[one of]What's a darkish red, bitter fruit?[plus][or]The settler helps a bit.[plus][or][b]CRANBERRIES[r].[minus][cycling]"
barren cries	"[one of]The barren cries are sour and bitter and tiny. What fruit is sour and bitter and tiny? Well, there are a lot, but...[plus][or]The barren cries can become [b]CRANBERRIES[r].[minus][cycling]"
peanut cola	"[one of]The peanut cola has a neat cupola on it.[plus][or]Tan and pinkish-orange.[plus][or][b]CANTALOUPE[r].[minus][cycling]"
eerie blurbs	"[one of]They're stained purplish.[plus][or]The settler will give you a few letters, and the rest may be clear--what fruit is that?[plus][or][b]BLUEBERRIES[r].[minus][cycling]"
omen prism	"[one of]You know the drill by now. The visions have similar names and can eliminate a few letters.[plus][or][b]PERSIMMON[r].[minus][cycling]"
magenta rope	"[one of]The megaton pear, mopeage rant, rampage note and magenta rope are all related.[plus][or]You have four things that anagram each other, so yes, there is a fruit they can become.[plus][or][b]POMEGRANATE[r].[minus][cycling]"
mopeage rant	--	magenta rope
rampage note	--	magenta rope
megaton pear	--	magenta rope
buried raft	"[one of]Philip Larkin would know what to do with the buried raft right away.[plus][or]You may or may not know what the fruit actually looks or tastes like, but, well, it's still a fruit, even if its name seems partially grainy...[plus][or]It's breadfruit.[minus][cycling]" [begin Filed Field hints]
barriers west	"[one of]Barriers West can be another fruit.[plus][or]They're reddish, with a seedy outside and leaves on top?[plus][or][b]STRAWBERRIES[r].[minus][cycling]"
barber sickle	"[one of]The barber sickle is dripping and dark. Its texture is like the pryer bars.[plus][or][b]BLACKBERRIES[r].[minus][cycling]"
mean trowel	"[one of]The mean trowel mentions three names if you [b]READ[r] it.[plus][or]There's no physical clue as to what the mean trowel is, so it's a bit tricky unless you just plow through all the fruits that might be.[plus][or][b]WATERMELON[r].[minus][cycling]"
pipe panel lie pen app	"[one of]If you read the lie pen app, you'll notice a semi-obscure odd science fact as a clue, as well as a silly cultural reference. But it is probably easier to follow the anagrams.[plus][or]You need only worry about [b]PIPE PANEL[r].[plus][or][b]PINEAPPLE[r]. The science reference is to how pineapple gelatin once seemed chemically impossible, and the cultural one is to SpongeBob SquarePants, who, as his theme song goes, lives in a pineapple.[minus][cycling]"
pryer bars	"[one of]If you know what drupelets are, the pryer bars may be a bit easier. If not, consider this edutainment.[plus][or]The bars are a bit reddish, which clues the fruit's color.[plus][or]The pryer bars can become a raspberry.[minus][cycling]"
drupelets	"They clue you as to what the pryer bars should be. If not, then maybe [this-game] will actually help you with your vocabulary! (I didn't know what they were before I Googled.)"
jagged spoon	"The spoon's weird shape clues you as to what the rapt figure should be."
rapt figure	"[one of]The jagged spoon the figure is holding is a clue.[plus][or]Plus, the figure is whitish and semi-reddish and yellowish.[plus][or][b]GRAPEFRUIT[r].[minus][cycling]"
green stain	"[one of]If you try to decipher the green stain, you see red, but it almost seems orange-ish, too.[plus][or]Small orange-ish fruits that are not oranges.[plus][or][plus][or][b]TANGERINES[r].[minus][cycling]" [begin Swell Wells hinting]
riot cap	"[one of]The riot cap's not a very tough color for a combat helmet. What fruit can it become?[plus][or][b]APRICOT[r].[minus][cycling]"
PSA Elp	"[one of]Reading the PSA [']Elp may set things straight.[plus][or]In particular, reading the PSA Elp will tell you where the P's are.[plus][or][b]APPLES[r].[minus][cycling]"
sorer bogey	"[one of]The sorer bogey makes your skin break out in--well, not pimples, they'll go away in a bit.[plus][or]Bumps, more like.[plus][or]Goosebumps.[plus][or][b]GOOSEBERRY[r].[minus][cycling]"
un mod mound	--	sorer bogey
stucco	"[one of]A message is written [b]ON STUCCO[r], in red. Plus it's for ScoutCon. Those are two clues right there.[plus][or][b]COCONUTS[r].[minus][cycling]"
Len Craig	"Len Craig wants to haggle. You need to poke around, see what fruits and things are in the clearing, and bargain accordingly." [Clangier Clearing hints]
i solve voiles	"[one of]Some fruits are behind [the voiles], though some think they're a vegetable.[plus][or]Green or black...[plus][or][b]OLIVES[r].[minus][cycling]"
auction caution	"[one of]The Auction Caution says you need to [b]PAY ASAP[r].[plus][or]What could you buy with that message?[plus][or][b]PAPAYAS[r].[minus][cycling]"
prices precis	"[one of]The prices precis has an error that makes you exclaim something.[plus][or]The mistake in the list won't drive you to profanity, but...[plus][or][b]CRIPES[r].[minus][cycling]"
lemons	"[one of]The price, as is, makes you frown.[plus][or]Maybe being depressing will depress prices.[plus][or]Get [b]SOLEMN[r].[minus][cycling]"
melon	"[one of]You need to see another, better, melon.[plus][or]Maybe you could tell Len that.[plus][or][b]LEN MO[r] or [b]MO LEN[r] will get something better from Len.[minus][cycling]"
nectarine	"[one of]The nectarine's not too old, but if it were, you might get it cheaper. Cheaperer.[plus][or]Len Craig suddenly starts using bad grammar describing the nectarine.[plus][or][b]ANCIENTER[r].[minus][cycling]"
peach	"[one of]The peach is currently too expensive, but there's a way to fix that.[plus][or]The settler knocks the peach out, logically, on cheat mode. Actually, just mentioning cheat mode may be a tremendous hint, here.[plus][or]How could the peach be described as less expensive?[plus][or][b]CHEAP[r].[minus][cycling]"
Ammo Gang	"[one of][b]AGMNO[r] are the five letters for the No Ammo Gang. You need to mingle with them.[plus][or]This word didn't fit anywhere in Routes, so it got dumped here.[plus][or][b]AMONG[r].[minus][cycling]"
quince	"[one of]How do you count in Italian, to name a price for the quince?[plus][or]Uno, duo, tre, quattro, ...[plus][or] ...[b]CINQUE[r].[minus][cycling]"
a banna	"[one of]A banna['] says Naa-Na-B.[plus][or]Non-cheat mode might help things to drop out more easily, but with six letters, it can't be that hard.[plus][or]You can make a [b]BANANA[r].[minus][cycling]" [Scape Space fruit hints]
orange	"[one of]You can't just take the orange directly.[plus][or]You probably need to get closer to it slowly.[plus][or][b]GO NEAR[r] to get the orange.[minus][cycling]"
a brr hub	"[one of]Burr, bah, you say if you examine/attack it.[plus][or]It seems to be making a weird mumbling.[plus][or][b]RHUBARB[r].[minus][cycling]"
Dr Severe	"[one of][b]RESERVED DESERVER[r] Dr. Severe is quite a mouthful, and the settler in cheat mode may be confusing.[plus][or]Dr. Severe could use a change in perspective.[plus][or]Perhaps if Dr. Severe got [b]REVERSED[r].[minus][cycling]"
augural arugula	"The augural arugula will help you [b]GURU[r] something."
miser ruble	"[one of]It's purplish.[plus][or]And to think that a change could happen on such-and-such street.[plus][or][b]MULBERRIES[r].[minus][cycling]"
nameless salesmen	"They used to be a puzzle in towers, and I didn't have the heart to get rid of them entirely, but fortunately they fit in the Clangier Clearing. They're not terribly useful."
singed design	"The singed design gives you a clue what the [if player has coin]coin[else if player has coins]coins[else if player has icon]icon[else if player has icons]icons[else if player has s-c]sonic coins[end if] can become." [begin very endgame item hints]
coin	"[one of]You ultimately need another coin, but perhaps it can be converted to something of intrinsic worth.[plus][or]Make the coin an [b]ICON[r]. Once you get another coin, you will make [b]ICONS[r] automatically.[minus][cycling]"
coins	"[one of]There are two things to do with the coins.[plus][or]The coins can become another thing, or they can change in quality.[plus][or]The thing coins can become is [b]ICONS[r].[plus][or]The coins can also become [b]SONIC[r].[minus][cycling]"
icon	"You've done what you can with the icon. You need to [if number of moot fruits < 8]get more fruits[else]return to Curtis[end if] to get another coin and make [b]ICONS[r]."
icons	"[one of]The icons are too inert.[plus][or]The icons can become [b]SONIC[r].[minus][cycling]"
Sagest Gate	"You need [if curtis-level < 2]more stuff from Curtis[else if player has s-i]something to put the sonic icons in[else]to change Curtis's coins into something[end if]. [if player has So Great Storage]You have the So-Great Storage[else if player has dollar]You need to trade the dollar for something[else if Scape Space is unvisited]Try looking below[else]You need to open the storage box [greedy-s] is guarding[end if]."
s-c	"[one of]The sonic coins aren't quite what you need. Nobody wants singing money.[plus][or]The coins can become [b]ICONS[r].[minus][cycling]"
s-i	"[if concisions are not reflexed][one of]There's something you can anagram with the sonic icons before their more practical purpose. It's a word with two of each letter. It's not critical, though. Also...[paragraph break][or][stopping][end if][if player has So Great Storage]You can put the icons in the lost slot.[else][one of]You need to put the sonic icons somewhere.[plus][or]If you've seen anything that doesn't accept money, that might help.[plus][or]The So-Great Storage doesn't accept money. You need the droll dollar from Curtis.[minus][cycling]"
concisions	"You shouldn't be able to see the concisions. If you do, well, you know what to do for a bonus point from the sonic icons, now."
So Great Storage	"[if player has dollar]You can trade the dollar for the So-Great Storage.[else if player has storage and lost slot is touchable]You can put something in the box's slot.[else]There's a way to open the So-Great Storage. Curtis's coins can be manipulated into something else that could open the storage.[end if]"
Art Erd	"[trader-clue]"
Dr Tera	"[trader-clue]"
droll dollar	"[one of]The droll dollar is probably not spendable in a reputable place.[plus][or]Where is a less reputable place to spend the dollar? Maybe a less reputable person?[plus][or]Give the dollar to [greedy-s] in the Scape Space.[minus][cycling]"
Lord Al	"[ollard-hint]"
Dr Lola	"[ollard-hint]"
tekno token	"The Tekno-Token is a sort of debit card to help you buy stuff after haggling in the Clangier Clearing."
lost slot	"[if player has s-i]You need to put the sonic icons in the slot to open the So-Great Storage[else if s-i are moot]You've used the slot already[else]You need to reform the coins Curtis gave you to put something in the lost slot[end if]."
halt lath	"[one of]You need another item to retract the halt lath.[plus][or][if player has So Great Storage]You need to put something in the So-Great Storage[else]You may need to bargain in the Scape Space below the Swell Wells[end if].[minus][cycling]"
passport	"The passport will get you through the gates in the Gates Stage, but you need to study it to enter the Valence Enclave safely. The viewer and searcher can help, as can the message if you go north and fail."
Valence Enclave	"You can't change the Valence Enclave, but you can enter it via the gates."
viewer	"[one of]You can't seem to focus on the viewer. Each time you see it is as the first unless you look at it the right way.[plus][or]There are two solutions. One is to see what to do with the viewer.[plus][or]The other is to see how not to be called a perp if you try to go north.[plus][or][b]REVIEW[r] the viewer, or...[plus][or]...[b]PREP[r] [if perp-check is false](after going north) [end if]so you are not a perp.[minus][cycling]"
searcher	"[one of]You can't seem to focus on the searcher. Each time you see it is as the first unless you look at it the right way.[plus][or]There are two solutions. One is to see what to do with the searcher.[plus][or]The other is to see how not to be called a perp if you try to go north.[plus][or][b]RESEARCH[r] the searcher, or...[plus][or]...[b]PREP[r] [if perp-check is false](after going north) [end if]so you are not a perp.[minus][cycling]"
fleeing feeling	"[one of]'[b]PERP[r]!' It catches you off-guard.[plus][or]You can [b]PREP[r].[minus][cycling]"

to say up-to-l3:
	if fruits-left is 0:
		say "has gotten all the fruits you could find";
	else if droll dollar is not off-stage:
		say "can only take everything you find, now";
	else if curtis-level is not curtis-award-level:
		say "has payment for you";
	else:
		say "needs more fruit before your next reward";

to say trader-clue: say "[one of][greedy-s] [if player has storage]was[else]is[end if] just there to barter for the storage. You need something of value[if player has coin or player has coins], more value than a coin or two[end if].[plus][or][if player has dollar]That dollar would make [greedy-s] happy[else if number of moot fruits < 12]Curtis's third gift, after [12 - number of moot fruits in words] more fruits, will be handy[else]You can go back to Curtis for an item that will please [greedy-s][end if].[minus][cycling]"

to say ollard-hint: say "[he-she-c] is worse than useless to society but only useless to you. Yay?"

table of demo dome hintobjs
hint-entry	advice-entry	parallel-entry	spoil-entry
Great Grate	"The Great Grate is immovable."
chic loner chronicle	"[dome-blab]"
shiest thesis	"[dome-blab]"
calendar	"[dome-blab]"
bolt case	"[dome-blab]"
obstacle	"[dome-blab]"
best cola	"[dome-blab]"
trifle filter	"[dome-blab]"
stand up dustpan	"[dome-blab]"
plastic scalp it	"[dome-blab]"
placer	"[dome-blab]"
duster	"[dome-blab]"
novella	"You can read the novella from pages 1 to 100."
saying ignsay	"[dome-blab]"
Spy Dial Display	"[dome-blab]"
Shall Halls	"[dome-blab]"
coder decor	"[dome-blab]"
techs chest	"[dome-blab]"
raised aiders	"[dome-blab]"
design deigns	"[dome-blab]"
disport tripods	"[dome-blab]"
larded ladder	"[dome-blab]"
talks stalk	"[dome-blab]"
spec space	"[dome-blab]"
parcels clasper	"[dome-blab]"
tester street	"[dome-blab]"
passe apses	"[dome-blab]"

to say dome-blab:
	say "This is just here for fun.";

volume skip hinting rules - not for release

[this is at the end so ott.py works]

a skip hinting rule for a thing (called th):
	if th is a fruit and th is off-stage, the rule succeeds; [fruits you reveal are covered in the objhinting rule]
	if th is a badbook, the rule succeeds; [ditto for bad books in Hacks Shack]

[notes on the skip hinting rules: they are for testing purposes only. Pickup lines are abstract, since we always hint Gretta and can't refer to the pickup lines individually, but we still want to see them. However, if we have a fruit or bad book, there's nothing where we need to see hints every turn..]

Roiling Tables ends here.

---- DOCUMENTATION ----
